"date","county","state","vehicle_primary_use","battery_electric_vehicles_bevs_","plug_in_hybrid_electric_vehicles_phevs_","electric_vehicle_ev_total","non_electric_vehicles","total_vehicles","percent_electric_vehicles"
"2017-01-31T00:00:00.000","Juneau","AK","Passenger","0","1","1","57","58","1.724137931034482758620689655"
"2017-01-31T00:00:00.000","Dale","AL","Passenger","0","1","1","68","69","1.449275362318840579710144928"
"2017-01-31T00:00:00.000","Lee","AL","Passenger","1","0","1","37","38","2.631578947368421052631578947"
"2017-01-31T00:00:00.000","Maricopa","AZ","Passenger","3","1","4","1921","1925","0.2077922077922077922077922078"
"2017-01-31T00:00:00.000","Pima","AZ","Passenger","0","2","2","454","456","0.4385964912280701754385964912"
"2017-01-31T00:00:00.000","Pinal","AZ","Passenger","2","1","3","260","263","1.140684410646387832699619772"
"2017-01-31T00:00:00.000","Yavapai","AZ","Passenger","1","0","1","82","83","1.204819277108433734939759036"
"2017-01-31T00:00:00.000","Alameda","CA","Passenger","6","1","7","391","398","1.758793969849246231155778894"
"2017-01-31T00:00:00.000","Contra Costa","CA","Passenger","1","0","1","701","702","0.1424501424501424501424501425"
"2017-01-31T00:00:00.000","Los Angeles","CA","Passenger","2","1","3","1470","1473","0.2036659877800407331975560081"
"2017-01-31T00:00:00.000","Marin","CA","Passenger","1","0","1","56","57","1.754385964912280701754385965"
"2017-01-31T00:00:00.000","Monterey","CA","Passenger","0","1","1","233","234","0.4273504273504273504273504274"
"2017-01-31T00:00:00.000","Orange","CA","Passenger","2","1","3","697","700","0.4285714285714285714285714286"
"2017-01-31T00:00:00.000","Riverside","CA","Passenger","0","1","1","873","874","0.1144164759725400457665903890"
"2017-01-31T00:00:00.000","San Diego","CA","Passenger","4","2","6","2902","2908","0.2063273727647867950481430536"
"2017-01-31T00:00:00.000","San Mateo","CA","Passenger","0","1","1","178","179","0.5586592178770949720670391061"
"2017-01-31T00:00:00.000","Santa Barbara","CA","Passenger","0","1","1","130","131","0.7633587786259541984732824427"
"2017-01-31T00:00:00.000","Santa Clara","CA","Passenger","5","3","8","454","462","1.731601731601731601731601732"
"2017-01-31T00:00:00.000","Tulare","CA","Passenger","1","0","1","204","205","0.4878048780487804878048780488"
"2017-01-31T00:00:00.000","Ventura","CA","Passenger","0","2","2","395","397","0.5037783375314861460957178841"
"2017-01-31T00:00:00.000","El Paso","CO","Passenger","1","1","2","884","886","0.2257336343115124153498871332"
"2017-01-31T00:00:00.000","Larimer","CO","Passenger","0","1","1","101","102","0.9803921568627450980392156863"
"2017-01-31T00:00:00.000","New London","CT","Passenger","2","1","3","284","287","1.045296167247386759581881533"
"2017-01-31T00:00:00.000","District of Columbia","DC","Passenger","0","3","3","234","237","1.265822784810126582278481013"
"2017-01-31T00:00:00.000","Collier","FL","Passenger","0","1","1","21","22","4.545454545454545454545454545"
"2017-01-31T00:00:00.000","Duval","FL","Passenger","1","1","2","372","374","0.5347593582887700534759358289"
"2017-01-31T00:00:00.000","Manatee","FL","Passenger","1","0","1","58","59","1.694915254237288135593220339"
"2017-01-31T00:00:00.000","Marion","FL","Passenger","1","0","1","26","27","3.703703703703703703703703704"
"2017-01-31T00:00:00.000","Miami-Dade","FL","Passenger","0","1","1","138","139","0.7194244604316546762589928058"
"2017-01-31T00:00:00.000","Okaloosa","FL","Passenger","1","0","1","186","187","0.5347593582887700534759358289"
"2017-01-31T00:00:00.000","Orange","FL","Passenger","0","1","1","158","159","0.6289308176100628930817610063"
"2017-01-31T00:00:00.000","Polk","FL","Passenger","1","0","1","64","65","1.538461538461538461538461538"
"2017-01-31T00:00:00.000","St. Lucie","FL","Passenger","1","0","1","30","31","3.225806451612903225806451613"
"2017-01-31T00:00:00.000","Sumter","FL","Passenger","0","1","1","10","11","9.090909090909090909090909091"
"2017-01-31T00:00:00.000","Volusia","FL","Passenger","0","1","1","48","49","2.040816326530612244897959184"
"2017-01-31T00:00:00.000","Cobb","GA","Passenger","0","1","1","77","78","1.282051282051282051282051282"
"2017-01-31T00:00:00.000","DeKalb","GA","Passenger","1","0","1","90","91","1.098901098901098901098901099"
"2017-01-31T00:00:00.000","Fulton","GA","Passenger","1","2","3","135","138","2.173913043478260869565217391"
"2017-01-31T00:00:00.000","Gwinnett","GA","Passenger","0","1","1","93","94","1.063829787234042553191489362"
"2017-01-31T00:00:00.000","Muscogee","GA","Passenger","0","1","1","268","269","0.3717472118959107806691449814"
"2017-01-31T00:00:00.000","Honolulu","HI","Passenger","4","1","5","663","668","0.7485029940119760479041916168"
"2017-01-31T00:00:00.000","Maui","HI","Passenger","1","0","1","82","83","1.204819277108433734939759036"
"2017-01-31T00:00:00.000","Canyon","ID","Passenger","0","1","1","114","115","0.8695652173913043478260869565"
"2017-01-31T00:00:00.000","Latah","ID","Passenger","0","1","1","140","141","0.7092198581560283687943262411"
"2017-01-31T00:00:00.000","Madison","ID","Passenger","1","0","1","47","48","2.083333333333333333333333333"
"2017-01-31T00:00:00.000","Shoshone","ID","Passenger","0","1","1","99","100","1.00"
"2017-01-31T00:00:00.000","Lake","IL","Passenger","1","0","1","191","192","0.5208333333333333333333333333"
"2017-01-31T00:00:00.000","DeKalb","IN","Passenger","1","0","1","1","2","50.0"
"2017-01-31T00:00:00.000","Hamilton","IN","Passenger","1","0","1","73","74","1.351351351351351351351351351"
"2017-01-31T00:00:00.000","Hardin","KY","Passenger","0","1","1","128","129","0.7751937984496124031007751938"
"2017-01-31T00:00:00.000","Orleans","LA","Passenger","0","1","1","53","54","1.851851851851851851851851852"
"2017-01-31T00:00:00.000","Franklin","MA","Passenger","0","1","1","5","6","16.66666666666666666666666667"
"2017-01-31T00:00:00.000","Middlesex","MA","Passenger","1","0","1","160","161","0.6211180124223602484472049689"
"2017-01-31T00:00:00.000","Nantucket","MA","Passenger","1","0","1","2","3","33.33333333333333333333333333"
"2017-01-31T00:00:00.000","Norfolk","MA","Passenger","1","0","1","38","39","2.564102564102564102564102564"
"2017-01-31T00:00:00.000","Anne Arundel","MD","Passenger","0","1","1","517","518","0.1930501930501930501930501931"
"2017-01-31T00:00:00.000","Charles","MD","Passenger","0","1","1","89","90","1.111111111111111111111111111"
"2017-01-31T00:00:00.000","Howard","MD","Passenger","0","2","2","91","93","2.150537634408602150537634409"
"2017-01-31T00:00:00.000","Montgomery","MD","Passenger","1","1","2","314","316","0.6329113924050632911392405063"
"2017-01-31T00:00:00.000","St. Mary's","MD","Passenger","0","1","1","202","203","0.4926108374384236453201970443"
"2017-01-31T00:00:00.000","Wayne","MI","Passenger","0","2","2","79","81","2.469135802469135802469135802"
"2017-01-31T00:00:00.000","Dakota","MN","Passenger","0","1","1","44","45","2.222222222222222222222222222"
"2017-01-31T00:00:00.000","Jackson","MO","Passenger","1","0","1","73","74","1.351351351351351351351351351"
"2017-01-31T00:00:00.000","Cascade","MT","Passenger","0","1","1","59","60","1.666666666666666666666666667"
"2017-01-31T00:00:00.000","Gallatin","MT","Passenger","0","1","1","84","85","1.176470588235294117647058824"
"2017-01-31T00:00:00.000","Glacier","MT","Passenger","0","1","1","4","5","20.0"
"2017-01-31T00:00:00.000","Cumberland","NC","Passenger","1","0","1","650","651","0.1536098310291858678955453149"
"2017-01-31T00:00:00.000","Durham","NC","Passenger","0","1","1","38","39","2.564102564102564102564102564"
"2017-01-31T00:00:00.000","Guilford","NC","Passenger","1","0","1","34","35","2.857142857142857142857142857"
"2017-01-31T00:00:00.000","Harnett","NC","Passenger","1","0","1","280","281","0.3558718861209964412811387900"
"2017-01-31T00:00:00.000","Moore","NC","Passenger","0","1","1","210","211","0.4739336492890995260663507109"
"2017-01-31T00:00:00.000","Carroll","NH","Passenger","0","1","1","0","1","100"
"2017-01-31T00:00:00.000","Bergen","NJ","Passenger","0","2","2","34","36","5.555555555555555555555555556"
"2017-01-31T00:00:00.000","Essex","NJ","Passenger","1","0","1","15","16","6.2500"
"2017-01-31T00:00:00.000","Morris","NJ","Passenger","1","0","1","23","24","4.166666666666666666666666667"
"2017-01-31T00:00:00.000","Santa Fe","NM","Passenger","0","1","1","43","44","2.272727272727272727272727273"
"2017-01-31T00:00:00.000","Clark","NV","Passenger","1","4","5","919","924","0.5411255411255411255411255411"
"2017-01-31T00:00:00.000","Jefferson","NY","Passenger","1","1","2","251","253","0.7905138339920948616600790514"
"2017-01-31T00:00:00.000","Lewis","NY","Passenger","0","1","1","10","11","9.090909090909090909090909091"
"2017-01-31T00:00:00.000","Monroe","NY","Passenger","1","0","1","31","32","3.12500"
"2017-01-31T00:00:00.000","Saratoga","NY","Passenger","1","1","2","82","84","2.380952380952380952380952381"
"2017-01-31T00:00:00.000","Union","OH","Passenger","1","0","1","4","5","20.0"
"2017-01-31T00:00:00.000","Oklahoma","OK","Passenger","0","1","1","210","211","0.4739336492890995260663507109"
"2017-01-31T00:00:00.000","Clackamas","OR","Passenger","1","2","3","423","426","0.7042253521126760563380281690"
"2017-01-31T00:00:00.000","Deschutes","OR","Passenger","1","1","2","234","236","0.8474576271186440677966101695"
"2017-01-31T00:00:00.000","Douglas","OR","Passenger","0","1","1","90","91","1.098901098901098901098901099"
"2017-01-31T00:00:00.000","Hood River","OR","Passenger","1","0","1","42","43","2.325581395348837209302325581"
"2017-01-31T00:00:00.000","Lane","OR","Passenger","0","1","1","287","288","0.3472222222222222222222222222"
"2017-01-31T00:00:00.000","Marion","OR","Passenger","1","0","1","237","238","0.4201680672268907563025210084"
"2017-01-31T00:00:00.000","Multnomah","OR","Passenger","0","3","3","1269","1272","0.2358490566037735849056603774"
"2017-01-31T00:00:00.000","Allegheny","PA","Passenger","1","0","1","93","94","1.063829787234042553191489362"
"2017-01-31T00:00:00.000","Northampton","PA","Passenger","2","0","2","260","262","0.7633587786259541984732824427"
"2017-01-31T00:00:00.000","Newport","RI","Passenger","1","0","1","121","122","0.8196721311475409836065573770"
"2017-01-31T00:00:00.000","Hamilton","TN","Passenger","1","0","1","26","27","3.703703703703703703703703704"
"2017-01-31T00:00:00.000","Montgomery","TN","Passenger","1","0","1","306","307","0.3257328990228013029315960912"
"2017-01-31T00:00:00.000","Shelby","TN","Passenger","0","1","1","115","116","0.8620689655172413793103448276"
"2017-01-31T00:00:00.000","Bexar","TX","Passenger","3","3","6","1248","1254","0.4784688995215311004784688995"
"2017-01-31T00:00:00.000","Dallas","TX","Passenger","1","0","1","221","222","0.4504504504504504504504504505"
"2017-01-31T00:00:00.000","El Paso","TX","Passenger","0","1","1","600","601","0.1663893510815307820299500832"
"2017-01-31T00:00:00.000","Hidalgo","TX","Passenger","0","1","1","98","99","1.010101010101010101010101010"
"2017-01-31T00:00:00.000","Tarrant","TX","Passenger","0","2","2","332","334","0.5988023952095808383233532934"
"2017-01-31T00:00:00.000","Travis","TX","Passenger","0","1","1","213","214","0.4672897196261682242990654206"
"2017-01-31T00:00:00.000","Salt Lake","UT","Passenger","0","1","1","353","354","0.2824858757062146892655367232"
"2017-01-31T00:00:00.000","Utah","UT","Passenger","0","1","1","188","189","0.5291005291005291005291005291"
"2017-01-31T00:00:00.000","Arlington","VA","Passenger","1","1","2","180","182","1.098901098901098901098901099"
"2017-01-31T00:00:00.000","Fairfax","VA","Passenger","2","3","5","893","898","0.5567928730512249443207126949"
"2017-01-31T00:00:00.000","Loudoun","VA","Passenger","0","1","1","86","87","1.149425287356321839080459770"
"2017-01-31T00:00:00.000","Manassas","VA","Passenger","0","1","1","8","9","11.11111111111111111111111111"
"2017-01-31T00:00:00.000","Norfolk","VA","Passenger","1","1","2","306","308","0.6493506493506493506493506494"
"2017-01-31T00:00:00.000","Portsmouth","VA","Passenger","0","1","1","60","61","1.639344262295081967213114754"
"2017-01-31T00:00:00.000","Prince William","VA","Passenger","0","3","3","276","279","1.075268817204301075268817204"
"2017-01-31T00:00:00.000","Virginia Beach","VA","Passenger","2","1","3","656","659","0.4552352048558421851289833080"
"2017-01-31T00:00:00.000","Adams","WA","Truck","0","0","0","5076","5076","0"
"2017-01-31T00:00:00.000","Adams","WA","Passenger","1","1","2","12176","12178","0.01642305797339464608310067335"
"2017-01-31T00:00:00.000","Asotin","WA","Truck","0","0","0","6491","6491","0"
"2017-01-31T00:00:00.000","Asotin","WA","Passenger","4","4","8","12322","12330","0.06488240064882400648824006488"
"2017-01-31T00:00:00.000","Benton","WA","Truck","0","0","0","39818","39818","0"
"2017-01-31T00:00:00.000","Benton","WA","Passenger","129","134","263","127866","128129","0.2052618845070202686355157693"
"2017-01-31T00:00:00.000","Chelan","WA","Passenger","54","28","82","51909","51991","0.1577196053163047450520282357"
"2017-01-31T00:00:00.000","Chelan","WA","Truck","0","0","0","21266","21266","0"
"2017-01-31T00:00:00.000","Clallam","WA","Truck","0","0","0","21046","21046","0"
"2017-01-31T00:00:00.000","Clallam","WA","Passenger","73","68","141","48003","48144","0.2928713858424725822532402792"
"2017-01-31T00:00:00.000","Clark","WA","Truck","0","0","0","77524","77524","0"
"2017-01-31T00:00:00.000","Clark","WA","Passenger","673","448","1121","297827","298948","0.3749816021515447502575698784"
"2017-01-31T00:00:00.000","Columbia","WA","Truck","0","0","0","1543","1543","0"
"2017-01-31T00:00:00.000","Columbia","WA","Passenger","0","1","1","2332","2333","0.04286326618088298328332618946"
"2017-01-31T00:00:00.000","Cowlitz","WA","Truck","0","0","0","27955","27955","0"
"2017-01-31T00:00:00.000","Cowlitz","WA","Passenger","51","52","103","69115","69218","0.1488052240746626600017336531"
"2017-01-31T00:00:00.000","Douglas","WA","Truck","0","0","0","11428","11428","0"
"2017-01-31T00:00:00.000","Douglas","WA","Passenger","29","19","48","26575","26623","0.1802952334447658040040566428"
"2017-01-31T00:00:00.000","Ferry","WA","Truck","0","0","0","3582","3582","0"
"2017-01-31T00:00:00.000","Ferry","WA","Passenger","2","1","3","4387","4390","0.06833712984054669703872437358"
"2017-01-31T00:00:00.000","Franklin","WA","Truck","0","0","0","17912","17912","0"
"2017-01-31T00:00:00.000","Franklin","WA","Passenger","27","43","70","55410","55480","0.1261715933669790915645277578"
"2017-01-31T00:00:00.000","Garfield","WA","Truck","0","0","0","941","941","0"
"2017-01-31T00:00:00.000","Garfield","WA","Passenger","0","0","0","1285","1285","0"
"2017-01-31T00:00:00.000","Grant","WA","Passenger","16","25","41","60400","60441","0.06783474793600370609354577191"
"2017-01-31T00:00:00.000","Grant","WA","Truck","0","0","0","25040","25040","0"
"2017-01-31T00:00:00.000","Grays Harbor","WA","Truck","0","0","0","19861","19861","0"
"2017-01-31T00:00:00.000","Grays Harbor","WA","Passenger","27","27","54","44307","44361","0.1217285453438831405964698722"
"2017-01-31T00:00:00.000","Island","WA","Truck","1","0","1","20514","20515","0.004874482086278332927126492810"
"2017-01-31T00:00:00.000","Island","WA","Passenger","103","125","228","59415","59643","0.3822745334741713193501332931"
"2017-01-31T00:00:00.000","Jefferson","WA","Passenger","87","56","143","23611","23754","0.6020038730319104150879851814"
"2017-01-31T00:00:00.000","Jefferson","WA","Truck","0","0","0","9470","9470","0"
"2017-01-31T00:00:00.000","King","WA","Passenger","8806","3989","12795","1387381","1400176","0.9138136919930065934568225709"
"2017-01-31T00:00:00.000","King","WA","Truck","8","1","9","191124","191133","0.004708763007957809483448698027"
"2017-01-31T00:00:00.000","Kitsap","WA","Passenger","556","275","831","172427","173258","0.4796315321659028731718015907"
"2017-01-31T00:00:00.000","Kitsap","WA","Truck","1","0","1","52398","52399","0.001908433367048989484532147560"
"2017-01-31T00:00:00.000","Kittitas","WA","Truck","0","0","0","13415","13415","0"
"2017-01-31T00:00:00.000","Kittitas","WA","Passenger","15","16","31","27164","27195","0.1139915425629711343997058283"
"2017-01-31T00:00:00.000","Klickitat","WA","Truck","0","0","0","7945","7945","0"
"2017-01-31T00:00:00.000","Klickitat","WA","Passenger","20","24","44","14795","14839","0.2965159377316530763528539659"
"2017-01-31T00:00:00.000","Lewis","WA","Passenger","43","41","84","54954","55038","0.1526218249209636978087866565"
"2017-01-31T00:00:00.000","Lewis","WA","Truck","0","0","0","24794","24794","0"
"2017-01-31T00:00:00.000","Lincoln","WA","Truck","0","0","0","4461","4461","0"
"2017-01-31T00:00:00.000","Lincoln","WA","Passenger","2","4","6","7543","7549","0.07948072592396343886607497682"
"2017-01-31T00:00:00.000","Mason","WA","Truck","0","0","0","19191","19191","0"
"2017-01-31T00:00:00.000","Mason","WA","Passenger","48","59","107","42813","42920","0.2493010251630941286113699907"
"2017-01-31T00:00:00.000","Okanogan","WA","Truck","0","0","0","16378","16378","0"
"2017-01-31T00:00:00.000","Okanogan","WA","Passenger","3","15","18","25814","25832","0.06968101579436358005574481264"
"2017-01-31T00:00:00.000","Pacific","WA","Passenger","5","7","12","15033","15045","0.07976071784646061814556331007"
"2017-01-31T00:00:00.000","Pacific","WA","Truck","0","0","0","7511","7511","0"
"2017-01-31T00:00:00.000","Pend Oreille","WA","Passenger","1","4","5","9348","9353","0.05345878327809259061263765637"
"2017-01-31T00:00:00.000","Pend Oreille","WA","Truck","0","0","0","5591","5591","0"
"2017-01-31T00:00:00.000","Pierce","WA","Truck","0","0","0","138793","138793","0"
"2017-01-31T00:00:00.000","Pierce","WA","Passenger","823","807","1630","528398","530028","0.3075309228946395284777407986"
"2017-01-31T00:00:00.000","San Juan","WA","Truck","0","0","0","5598","5598","0"
"2017-01-31T00:00:00.000","San Juan","WA","Passenger","84","32","116","13347","13463","0.8616207383198395602763128575"
"2017-01-31T00:00:00.000","Skagit","WA","Truck","1","0","1","31410","31411","0.003183598102575530864983604470"
"2017-01-31T00:00:00.000","Skagit","WA","Passenger","106","98","204","87448","87652","0.2327385570209464701318851823"
"2017-01-31T00:00:00.000","Skamania","WA","Passenger","7","7","14","8550","8564","0.1634750116767865483418963101"
"2017-01-31T00:00:00.000","Skamania","WA","Truck","0","0","0","3906","3906","0"
"2017-01-31T00:00:00.000","Snohomish","WA","Passenger","1549","886","2435","514986","517421","0.4706032418475477415876046778"
"2017-01-31T00:00:00.000","Snohomish","WA","Truck","1","0","1","122842","122843","0.0008140471984565665117263498938"
"2017-01-31T00:00:00.000","Spokane","WA","Passenger","222","230","452","296037","296489","0.1524508497785752591158525274"
"2017-01-31T00:00:00.000","Spokane","WA","Truck","1","1","2","90448","90450","0.002211166390270867882808181316"
"2017-01-31T00:00:00.000","Stevens","WA","Truck","0","0","0","18342","18342","0"
"2017-01-31T00:00:00.000","Stevens","WA","Passenger","6","23","29","31529","31558","0.09189428987895303884910323848"
"2017-01-31T00:00:00.000","Thurston","WA","Truck","0","0","0","53350","53350","0"
"2017-01-31T00:00:00.000","Thurston","WA","Passenger","336","320","656","184996","185652","0.3533492771421799926744662056"
"2017-01-31T00:00:00.000","Wahkiakum","WA","Truck","0","0","0","1624","1624","0"
"2017-01-31T00:00:00.000","Wahkiakum","WA","Passenger","0","1","1","2861","2862","0.03494060097833682739343116702"
"2017-01-31T00:00:00.000","Walla Walla","WA","Passenger","16","21","37","34878","34915","0.1059716454246026063296577402"
"2017-01-31T00:00:00.000","Walla Walla","WA","Truck","0","0","0","13170","13170","0"
"2017-01-31T00:00:00.000","Whatcom","WA","Passenger","385","159","544","141891","142435","0.3819285990100747709481517885"
"2017-01-31T00:00:00.000","Whatcom","WA","Truck","2","0","2","41343","41345","0.004837344297980408755593179345"
"2017-01-31T00:00:00.000","Whitman","WA","Truck","0","0","0","8406","8406","0"
"2017-01-31T00:00:00.000","Whitman","WA","Passenger","8","20","28","21947","21975","0.1274175199089874857792946530"
"2017-01-31T00:00:00.000","Yakima","WA","Passenger","36","53","89","159944","160033","0.05561352970949741615791742953"
"2017-01-31T00:00:00.000","Yakima","WA","Truck","0","0","0","57339","57339","0"
"2017-01-31T00:00:00.000","Brown","WI","Passenger","1","0","1","46","47","2.127659574468085106382978723"
"2017-01-31T00:00:00.000","Dane","WI","Passenger","1","0","1","191","192","0.5208333333333333333333333333"
"2017-01-31T00:00:00.000","Ozaukee","WI","Passenger","0","1","1","4","5","20.0"
"2017-01-31T00:00:00.000",,,"Passenger","2","0","2","282","284","0.7042253521126760563380281690"
"2017-02-28T00:00:00.000","Juneau","AK","Passenger","0","1","1","54","55","1.818181818181818181818181818"
"2017-02-28T00:00:00.000","Dale","AL","Passenger","0","1","1","66","67","1.492537313432835820895522388"
"2017-02-28T00:00:00.000","Lee","AL","Passenger","1","0","1","36","37","2.702702702702702702702702703"
"2017-02-28T00:00:00.000","Maricopa","AZ","Passenger","3","1","4","1801","1805","0.2216066481994459833795013850"
"2017-02-28T00:00:00.000","Pima","AZ","Passenger","0","2","2","427","429","0.4662004662004662004662004662"
"2017-02-28T00:00:00.000","Pinal","AZ","Passenger","2","1","3","241","244","1.229508196721311475409836066"
"2017-02-28T00:00:00.000","Alameda","CA","Passenger","3","1","4","382","386","1.036269430051813471502590674"
"2017-02-28T00:00:00.000","Contra Costa","CA","Passenger","1","0","1","673","674","0.1483679525222551928783382789"
"2017-02-28T00:00:00.000","Los Angeles","CA","Passenger","2","1","3","1374","1377","0.2178649237472766884531590414"
"2017-02-28T00:00:00.000","Marin","CA","Passenger","1","0","1","57","58","1.724137931034482758620689655"
"2017-02-28T00:00:00.000","Monterey","CA","Passenger","0","1","1","225","226","0.4424778761061946902654867257"
"2017-02-28T00:00:00.000","Orange","CA","Passenger","2","1","3","671","674","0.4451038575667655786350148368"
"2017-02-28T00:00:00.000","Riverside","CA","Passenger","0","1","1","828","829","0.1206272617611580217129071170"
"2017-02-28T00:00:00.000","San Diego","CA","Passenger","4","1","5","2827","2832","0.1765536723163841807909604520"
"2017-02-28T00:00:00.000","San Mateo","CA","Passenger","0","1","1","166","167","0.5988023952095808383233532934"
"2017-02-28T00:00:00.000","Santa Clara","CA","Passenger","5","3","8","418","426","1.877934272300469483568075117"
"2017-02-28T00:00:00.000","Tulare","CA","Passenger","1","0","1","201","202","0.4950495049504950495049504950"
"2017-02-28T00:00:00.000","Ventura","CA","Passenger","0","2","2","379","381","0.5249343832020997375328083990"
"2017-02-28T00:00:00.000","El Paso","CO","Passenger","1","1","2","844","846","0.2364066193853427895981087470"
"2017-02-28T00:00:00.000","Larimer","CO","Passenger","0","1","1","87","88","1.136363636363636363636363636"
"2017-02-28T00:00:00.000","New London","CT","Passenger","2","1","3","279","282","1.063829787234042553191489362"
"2017-02-28T00:00:00.000","District of Columbia","DC","Passenger","0","3","3","227","230","1.304347826086956521739130435"
"2017-02-28T00:00:00.000","Duval","FL","Passenger","1","1","2","364","366","0.5464480874316939890710382514"
"2017-02-28T00:00:00.000","Manatee","FL","Passenger","1","0","1","54","55","1.818181818181818181818181818"
"2017-02-28T00:00:00.000","Miami-Dade","FL","Passenger","0","1","1","134","135","0.7407407407407407407407407407"
"2017-02-28T00:00:00.000","Okaloosa","FL","Passenger","1","0","1","187","188","0.5319148936170212765957446809"
"2017-02-28T00:00:00.000","Orange","FL","Passenger","1","1","2","152","154","1.298701298701298701298701299"
"2017-02-28T00:00:00.000","Polk","FL","Passenger","1","0","1","65","66","1.515151515151515151515151515"
"2017-02-28T00:00:00.000","St. Lucie","FL","Passenger","1","0","1","28","29","3.448275862068965517241379310"
"2017-02-28T00:00:00.000","Sumter","FL","Passenger","0","1","1","10","11","9.090909090909090909090909091"
"2017-02-28T00:00:00.000","Volusia","FL","Passenger","0","1","1","46","47","2.127659574468085106382978723"
"2017-02-28T00:00:00.000","Cobb","GA","Passenger","0","1","1","75","76","1.315789473684210526315789474"
"2017-02-28T00:00:00.000","DeKalb","GA","Passenger","1","0","1","83","84","1.190476190476190476190476190"
"2017-02-28T00:00:00.000","Fulton","GA","Passenger","1","1","2","127","129","1.550387596899224806201550388"
"2017-02-28T00:00:00.000","Gwinnett","GA","Passenger","0","1","1","86","87","1.149425287356321839080459770"
"2017-02-28T00:00:00.000","Muscogee","GA","Passenger","0","1","1","259","260","0.3846153846153846153846153846"
"2017-02-28T00:00:00.000","Honolulu","HI","Passenger","4","1","5","626","631","0.7923930269413629160063391442"
"2017-02-28T00:00:00.000","Maui","HI","Passenger","1","0","1","71","72","1.388888888888888888888888889"
"2017-02-28T00:00:00.000","Canyon","ID","Passenger","0","1","1","104","105","0.9523809523809523809523809524"
"2017-02-28T00:00:00.000","Latah","ID","Passenger","0","1","1","129","130","0.7692307692307692307692307692"
"2017-02-28T00:00:00.000","Madison","ID","Passenger","1","0","1","43","44","2.272727272727272727272727273"
"2017-02-28T00:00:00.000","Shoshone","ID","Passenger","0","1","1","82","83","1.204819277108433734939759036"
"2017-02-28T00:00:00.000","DeKalb","IN","Passenger","1","0","1","1","2","50.0"
"2017-02-28T00:00:00.000","Hamilton","IN","Passenger","1","0","1","67","68","1.470588235294117647058823529"
"2017-02-28T00:00:00.000","Hardin","KY","Passenger","0","1","1","129","130","0.7692307692307692307692307692"
"2017-02-28T00:00:00.000","Orleans","LA","Passenger","0","1","1","52","53","1.886792452830188679245283019"
"2017-02-28T00:00:00.000","Franklin","MA","Passenger","0","1","1","4","5","20.0"
"2017-02-28T00:00:00.000","Middlesex","MA","Passenger","1","0","1","157","158","0.6329113924050632911392405063"
"2017-02-28T00:00:00.000","Nantucket","MA","Passenger","1","0","1","2","3","33.33333333333333333333333333"
"2017-02-28T00:00:00.000","Norfolk","MA","Passenger","1","0","1","35","36","2.777777777777777777777777778"
"2017-02-28T00:00:00.000","Anne Arundel","MD","Passenger","0","1","1","514","515","0.1941747572815533980582524272"
"2017-02-28T00:00:00.000","Charles","MD","Passenger","0","1","1","91","92","1.086956521739130434782608696"
"2017-02-28T00:00:00.000","Howard","MD","Passenger","0","2","2","89","91","2.197802197802197802197802198"
"2017-02-28T00:00:00.000","Montgomery","MD","Passenger","1","1","2","306","308","0.6493506493506493506493506494"
"2017-02-28T00:00:00.000","Wayne","MI","Passenger","0","2","2","71","73","2.739726027397260273972602740"
"2017-02-28T00:00:00.000","Dakota","MN","Passenger","0","1","1","39","40","2.500"
"2017-02-28T00:00:00.000","Jackson","MO","Passenger","1","0","1","69","70","1.428571428571428571428571429"
"2017-02-28T00:00:00.000","Cascade","MT","Passenger","0","1","1","56","57","1.754385964912280701754385965"
"2017-02-28T00:00:00.000","Gallatin","MT","Passenger","0","1","1","77","78","1.282051282051282051282051282"
"2017-02-28T00:00:00.000","Glacier","MT","Passenger","0","1","1","3","4","25.00"
"2017-02-28T00:00:00.000","Missoula","MT","Passenger","1","0","1","80","81","1.234567901234567901234567901"
"2017-02-28T00:00:00.000","Cumberland","NC","Passenger","1","0","1","639","640","0.1562500"
"2017-02-28T00:00:00.000","Durham","NC","Passenger","0","1","1","37","38","2.631578947368421052631578947"
"2017-02-28T00:00:00.000","Guilford","NC","Passenger","1","0","1","32","33","3.030303030303030303030303030"
"2017-02-28T00:00:00.000","Harnett","NC","Passenger","1","0","1","274","275","0.3636363636363636363636363636"
"2017-02-28T00:00:00.000","Moore","NC","Passenger","0","1","1","210","211","0.4739336492890995260663507109"
"2017-02-28T00:00:00.000","Carroll","NH","Passenger","0","1","1","0","1","100"
"2017-02-28T00:00:00.000","Bergen","NJ","Passenger","0","2","2","33","35","5.714285714285714285714285714"
"2017-02-28T00:00:00.000","Essex","NJ","Passenger","1","0","1","15","16","6.2500"
"2017-02-28T00:00:00.000","Morris","NJ","Passenger","1","0","1","22","23","4.347826086956521739130434783"
"2017-02-28T00:00:00.000","Santa Fe","NM","Passenger","0","1","1","43","44","2.272727272727272727272727273"
"2017-02-28T00:00:00.000","Clark","NV","Passenger","1","3","4","865","869","0.4602991944764096662830840046"
"2017-02-28T00:00:00.000","Jefferson","NY","Passenger","1","1","2","257","259","0.7722007722007722007722007722"
"2017-02-28T00:00:00.000","Lewis","NY","Passenger","0","1","1","10","11","9.090909090909090909090909091"
"2017-02-28T00:00:00.000","Monroe","NY","Passenger","1","0","1","29","30","3.333333333333333333333333333"
"2017-02-28T00:00:00.000","Nassau","NY","Passenger","0","1","1","38","39","2.564102564102564102564102564"
"2017-02-28T00:00:00.000","Saratoga","NY","Passenger","1","1","2","81","83","2.409638554216867469879518072"
"2017-02-28T00:00:00.000","Franklin","OH","Passenger","0","1","1","117","118","0.8474576271186440677966101695"
"2017-02-28T00:00:00.000","Oklahoma","OK","Passenger","0","1","1","185","186","0.5376344086021505376344086022"
"2017-02-28T00:00:00.000","Clackamas","OR","Passenger","1","2","3","358","361","0.8310249307479224376731301939"
"2017-02-28T00:00:00.000","Deschutes","OR","Passenger","1","0","1","199","200","0.500"
"2017-02-28T00:00:00.000","Douglas","OR","Passenger","0","1","1","79","80","1.2500"
"2017-02-28T00:00:00.000","Lane","OR","Passenger","0","1","1","254","255","0.3921568627450980392156862745"
"2017-02-28T00:00:00.000","Marion","OR","Passenger","1","0","1","200","201","0.4975124378109452736318407960"
"2017-02-28T00:00:00.000","Multnomah","OR","Passenger","0","3","3","1138","1141","0.2629272567922874671340929010"
"2017-02-28T00:00:00.000","Allegheny","PA","Passenger","1","0","1","89","90","1.111111111111111111111111111"
"2017-02-28T00:00:00.000","Northampton","PA","Passenger","2","0","2","232","234","0.8547008547008547008547008547"
"2017-02-28T00:00:00.000","Newport","RI","Passenger","1","0","1","119","120","0.8333333333333333333333333333"
"2017-02-28T00:00:00.000","Hamilton","TN","Passenger","1","0","1","25","26","3.846153846153846153846153846"
"2017-02-28T00:00:00.000","Montgomery","TN","Passenger","1","0","1","293","294","0.3401360544217687074829931973"
"2017-02-28T00:00:00.000","Shelby","TN","Passenger","0","1","1","109","110","0.9090909090909090909090909091"
"2017-02-28T00:00:00.000","Bexar","TX","Passenger","1","2","3","1150","1153","0.2601908065915004336513443192"
"2017-02-28T00:00:00.000","Dallas","TX","Passenger","1","0","1","202","203","0.4926108374384236453201970443"
"2017-02-28T00:00:00.000","Hidalgo","TX","Passenger","0","1","1","95","96","1.041666666666666666666666667"
"2017-02-28T00:00:00.000","Nueces","TX","Passenger","0","1","1","97","98","1.020408163265306122448979592"
"2017-02-28T00:00:00.000","Tarrant","TX","Passenger","0","2","2","303","305","0.6557377049180327868852459016"
"2017-02-28T00:00:00.000","Travis","TX","Passenger","0","1","1","198","199","0.5025125628140703517587939698"
"2017-02-28T00:00:00.000","Salt Lake","UT","Passenger","0","1","1","327","328","0.3048780487804878048780487805"
"2017-02-28T00:00:00.000","Utah","UT","Passenger","0","1","1","162","163","0.6134969325153374233128834356"
"2017-02-28T00:00:00.000","Arlington","VA","Passenger","1","1","2","174","176","1.136363636363636363636363636"
"2017-02-28T00:00:00.000","Fairfax","VA","Passenger","2","3","5","884","889","0.5624296962879640044994375703"
"2017-02-28T00:00:00.000","Manassas","VA","Passenger","0","1","1","8","9","11.11111111111111111111111111"
"2017-02-28T00:00:00.000","Norfolk","VA","Passenger","1","1","2","304","306","0.6535947712418300653594771242"
"2017-02-28T00:00:00.000","Portsmouth","VA","Passenger","0","1","1","61","62","1.612903225806451612903225806"
"2017-02-28T00:00:00.000","Prince William","VA","Passenger","0","3","3","271","274","1.094890510948905109489051095"
"2017-02-28T00:00:00.000","Virginia Beach","VA","Passenger","2","1","3","650","653","0.4594180704441041347626339969"
"2017-02-28T00:00:00.000","Adams","WA","Truck","0","0","0","5071","5071","0"
"2017-02-28T00:00:00.000","Adams","WA","Passenger","2","2","4","12127","12131","0.03297337400049460061000741901"
"2017-02-28T00:00:00.000","Asotin","WA","Passenger","4","4","8","12327","12335","0.06485610052695581678151601135"
"2017-02-28T00:00:00.000","Asotin","WA","Truck","0","0","0","6479","6479","0"
"2017-02-28T00:00:00.000","Benton","WA","Truck","0","0","0","39748","39748","0"
"2017-02-28T00:00:00.000","Benton","WA","Passenger","134","138","272","127658","127930","0.2126162745251309309778785273"
"2017-02-28T00:00:00.000","Chelan","WA","Truck","0","0","0","21254","21254","0"
"2017-02-28T00:00:00.000","Chelan","WA","Passenger","55","29","84","51765","51849","0.1620089104900769542324827866"
"2017-02-28T00:00:00.000","Clallam","WA","Passenger","76","68","144","47975","48119","0.2992580893202269373844011721"
"2017-02-28T00:00:00.000","Clallam","WA","Truck","0","0","0","21030","21030","0"
"2017-02-28T00:00:00.000","Clark","WA","Truck","0","0","0","77525","77525","0"
"2017-02-28T00:00:00.000","Clark","WA","Passenger","696","458","1154","297938","299092","0.3858344589624597113931499338"
"2017-02-28T00:00:00.000","Columbia","WA","Passenger","0","1","1","2338","2339","0.04275331338178708849935870030"
"2017-02-28T00:00:00.000","Columbia","WA","Truck","0","0","0","1528","1528","0"
"2017-02-28T00:00:00.000","Cowlitz","WA","Passenger","50","54","104","69059","69163","0.1503694171739224729985685988"
"2017-02-28T00:00:00.000","Cowlitz","WA","Truck","0","0","0","27878","27878","0"
"2017-02-28T00:00:00.000","Douglas","WA","Passenger","30","19","49","26542","26591","0.1842728742807716896694370276"
"2017-02-28T00:00:00.000","Douglas","WA","Truck","0","0","0","11389","11389","0"
"2017-02-28T00:00:00.000","Ferry","WA","Truck","0","0","0","3563","3563","0"
"2017-02-28T00:00:00.000","Ferry","WA","Passenger","2","1","3","4392","4395","0.06825938566552901023890784983"
"2017-02-28T00:00:00.000","Franklin","WA","Passenger","26","43","69","55226","55295","0.1247852427886789040600415951"
"2017-02-28T00:00:00.000","Franklin","WA","Truck","0","0","0","17907","17907","0"
"2017-02-28T00:00:00.000","Garfield","WA","Truck","0","0","0","934","934","0"
"2017-02-28T00:00:00.000","Garfield","WA","Passenger","0","0","0","1290","1290","0"
"2017-02-28T00:00:00.000","Grant","WA","Truck","0","0","0","24998","24998","0"
"2017-02-28T00:00:00.000","Grant","WA","Passenger","17","25","42","60208","60250","0.06970954356846473029045643154"
"2017-02-28T00:00:00.000","Grays Harbor","WA","Passenger","27","27","54","44244","44298","0.1219016659894351889475822836"
"2017-02-28T00:00:00.000","Grays Harbor","WA","Truck","0","0","0","19819","19819","0"
"2017-02-28T00:00:00.000","Island","WA","Passenger","100","128","228","59446","59674","0.3820759459731206220464523913"
"2017-02-28T00:00:00.000","Island","WA","Truck","0","0","0","20494","20494","0"
"2017-02-28T00:00:00.000","Jefferson","WA","Passenger","89","59","148","23605","23753","0.6230791899970530038310950196"
"2017-02-28T00:00:00.000","Jefferson","WA","Truck","0","0","0","9473","9473","0"
"2017-02-28T00:00:00.000","King","WA","Truck","8","1","9","190538","190547","0.004723244133993188032348974269"
"2017-02-28T00:00:00.000","King","WA","Passenger","9107","4086","13193","1385262","1398455","0.9433982502118409244487666747"
"2017-02-28T00:00:00.000","Kitsap","WA","Truck","1","0","1","52366","52367","0.001909599556972902782286554510"
"2017-02-28T00:00:00.000","Kitsap","WA","Passenger","562","294","856","172139","172995","0.4948119887858030578918465852"
"2017-02-28T00:00:00.000","Kittitas","WA","Passenger","15","15","30","27067","27097","0.1107133631029265232313540244"
"2017-02-28T00:00:00.000","Kittitas","WA","Truck","0","0","0","13387","13387","0"
"2017-02-28T00:00:00.000","Klickitat","WA","Passenger","20","24","44","14770","14814","0.2970163358984744160928851087"
"2017-02-28T00:00:00.000","Klickitat","WA","Truck","0","0","0","7937","7937","0"
"2017-02-28T00:00:00.000","Lewis","WA","Passenger","46","42","88","54963","55051","0.1598517738097400592178162068"
"2017-02-28T00:00:00.000","Lewis","WA","Truck","0","0","0","24786","24786","0"
"2017-02-28T00:00:00.000","Lincoln","WA","Passenger","2","4","6","7509","7515","0.07984031936127744510978043912"
"2017-02-28T00:00:00.000","Lincoln","WA","Truck","0","0","0","4462","4462","0"
"2017-02-28T00:00:00.000","Mason","WA","Passenger","48","62","110","42780","42890","0.2564700396362788528794590814"
"2017-02-28T00:00:00.000","Mason","WA","Truck","0","0","0","19198","19198","0"
"2017-02-28T00:00:00.000","Okanogan","WA","Passenger","3","15","18","25673","25691","0.07006344634307734225993538593"
"2017-02-28T00:00:00.000","Okanogan","WA","Truck","0","0","0","16304","16304","0"
"2017-02-28T00:00:00.000","Pacific","WA","Truck","0","0","0","7488","7488","0"
"2017-02-28T00:00:00.000","Pacific","WA","Passenger","6","7","13","14995","15008","0.08662046908315565031982942431"
"2017-02-28T00:00:00.000","Pend Oreille","WA","Truck","0","0","0","5569","5569","0"
"2017-02-28T00:00:00.000","Pend Oreille","WA","Passenger","1","4","5","9303","9308","0.05371723248818220885259991405"
"2017-02-28T00:00:00.000","Pierce","WA","Passenger","866","834","1700","526856","528556","0.3216310097700149085432763983"
"2017-02-28T00:00:00.000","Pierce","WA","Truck","0","0","0","138581","138581","0"
"2017-02-28T00:00:00.000","San Juan","WA","Passenger","88","32","120","13403","13523","0.8873770613029653183465207424"
"2017-02-28T00:00:00.000","San Juan","WA","Truck","0","0","0","5577","5577","0"
"2017-02-28T00:00:00.000","Skagit","WA","Passenger","113","102","215","87266","87481","0.2457676524045221248042432071"
"2017-02-28T00:00:00.000","Skagit","WA","Truck","1","0","1","31411","31412","0.003183496752833312110021647778"
"2017-02-28T00:00:00.000","Skamania","WA","Passenger","7","7","14","8544","8558","0.1635896237438653891096050479"
"2017-02-28T00:00:00.000","Skamania","WA","Truck","0","0","0","3887","3887","0"
"2017-02-28T00:00:00.000","Snohomish","WA","Passenger","1604","910","2514","514080","516594","0.4866490900010453083078781403"
"2017-02-28T00:00:00.000","Snohomish","WA","Truck","1","0","1","122522","122523","0.0008161732899129143099662920431"
"2017-02-28T00:00:00.000","Spokane","WA","Passenger","230","230","460","295033","295493","0.1556720463767331205815366185"
"2017-02-28T00:00:00.000","Spokane","WA","Truck","1","1","2","90261","90263","0.002215747316176063281743349988"
"2017-02-28T00:00:00.000","Stevens","WA","Truck","0","0","0","18332","18332","0"
"2017-02-28T00:00:00.000","Stevens","WA","Passenger","6","23","29","31320","31349","0.09250693802035152636447733580"
"2017-02-28T00:00:00.000","Thurston","WA","Passenger","353","330","683","184932","185615","0.3679659510276647900223581068"
"2017-02-28T00:00:00.000","Thurston","WA","Truck","0","0","0","53352","53352","0"
"2017-02-28T00:00:00.000","Wahkiakum","WA","Truck","0","0","0","1625","1625","0"
"2017-02-28T00:00:00.000","Wahkiakum","WA","Passenger","0","1","1","2843","2844","0.03516174402250351617440225035"
"2017-02-28T00:00:00.000","Walla Walla","WA","Truck","0","0","0","13163","13163","0"
"2017-02-28T00:00:00.000","Walla Walla","WA","Passenger","17","21","38","34795","34833","0.1090919530330433784055349812"
"2017-02-28T00:00:00.000","Whatcom","WA","Passenger","405","164","569","141894","142463","0.3994019499799948056688403305"
"2017-02-28T00:00:00.000","Whatcom","WA","Truck","2","0","2","41333","41335","0.004838514576025160275795330833"
"2017-02-28T00:00:00.000","Whitman","WA","Truck","0","0","0","8401","8401","0"
"2017-02-28T00:00:00.000","Whitman","WA","Passenger","8","19","27","21953","21980","0.1228389444949954504094631483"
"2017-02-28T00:00:00.000","Yakima","WA","Passenger","36","54","90","159141","159231","0.05652165721498954349341522693"
"2017-02-28T00:00:00.000","Yakima","WA","Truck","0","0","0","57225","57225","0"
"2017-02-28T00:00:00.000","Dane","WI","Passenger","1","0","1","167","168","0.5952380952380952380952380952"
"2017-02-28T00:00:00.000","Ozaukee","WI","Passenger","0","1","1","4","5","20.0"
"2017-02-28T00:00:00.000",,,"Passenger","2","0","2","275","277","0.7220216606498194945848375451"
"2017-03-31T00:00:00.000","Juneau","AK","Passenger","0","1","1","52","53","1.886792452830188679245283019"
"2017-03-31T00:00:00.000","Dale","AL","Passenger","0","1","1","66","67","1.492537313432835820895522388"
"2017-03-31T00:00:00.000","Lee","AL","Passenger","1","0","1","35","36","2.777777777777777777777777778"
"2017-03-31T00:00:00.000","Maricopa","AZ","Passenger","3","1","4","1765","1769","0.2261164499717354437535330695"
"2017-03-31T00:00:00.000","Pima","AZ","Passenger","0","2","2","433","435","0.4597701149425287356321839080"
"2017-03-31T00:00:00.000","Pinal","AZ","Passenger","2","1","3","240","243","1.234567901234567901234567901"
"2017-03-31T00:00:00.000","Alameda","CA","Passenger","3","1","4","378","382","1.047120418848167539267015707"
"2017-03-31T00:00:00.000","Los Angeles","CA","Passenger","2","1","3","1361","1364","0.2199413489736070381231671554"
"2017-03-31T00:00:00.000","Marin","CA","Passenger","1","0","1","57","58","1.724137931034482758620689655"
"2017-03-31T00:00:00.000","Monterey","CA","Passenger","0","1","1","220","221","0.4524886877828054298642533937"
"2017-03-31T00:00:00.000","Orange","CA","Passenger","2","1","3","654","657","0.4566210045662100456621004566"
"2017-03-31T00:00:00.000","Riverside","CA","Passenger","0","1","1","815","816","0.1225490196078431372549019608"
"2017-03-31T00:00:00.000","San Diego","CA","Passenger","5","1","6","2811","2817","0.2129925452609158679446219382"
"2017-03-31T00:00:00.000","San Mateo","CA","Passenger","0","1","1","158","159","0.6289308176100628930817610063"
"2017-03-31T00:00:00.000","Santa Clara","CA","Passenger","6","2","8","411","419","1.909307875894988066825775656"
"2017-03-31T00:00:00.000","Tulare","CA","Passenger","1","0","1","195","196","0.5102040816326530612244897959"
"2017-03-31T00:00:00.000","Ventura","CA","Passenger","0","2","2","378","380","0.5263157894736842105263157895"
"2017-03-31T00:00:00.000","El Paso","CO","Passenger","1","1","2","827","829","0.2412545235223160434258142340"
"2017-03-31T00:00:00.000","Larimer","CO","Passenger","0","1","1","84","85","1.176470588235294117647058824"
"2017-03-31T00:00:00.000","New London","CT","Passenger","1","1","2","276","278","0.7194244604316546762589928058"
"2017-03-31T00:00:00.000","District of Columbia","DC","Passenger","0","3","3","220","223","1.345291479820627802690582960"
"2017-03-31T00:00:00.000","Duval","FL","Passenger","1","1","2","363","365","0.5479452054794520547945205479"
"2017-03-31T00:00:00.000","Manatee","FL","Passenger","1","0","1","51","52","1.923076923076923076923076923"
"2017-03-31T00:00:00.000","Miami-Dade","FL","Passenger","0","1","1","132","133","0.7518796992481203007518796992"
"2017-03-31T00:00:00.000","Okaloosa","FL","Passenger","1","0","1","190","191","0.5235602094240837696335078534"
"2017-03-31T00:00:00.000","Orange","FL","Passenger","1","1","2","150","152","1.315789473684210526315789474"
"2017-03-31T00:00:00.000","Polk","FL","Passenger","1","0","1","66","67","1.492537313432835820895522388"
"2017-03-31T00:00:00.000","St. Lucie","FL","Passenger","1","0","1","28","29","3.448275862068965517241379310"
"2017-03-31T00:00:00.000","Sumter","FL","Passenger","0","1","1","10","11","9.090909090909090909090909091"
"2017-03-31T00:00:00.000","Volusia","FL","Passenger","0","1","1","45","46","2.173913043478260869565217391"
"2017-03-31T00:00:00.000","Cobb","GA","Passenger","0","1","1","74","75","1.333333333333333333333333333"
"2017-03-31T00:00:00.000","DeKalb","GA","Passenger","1","0","1","83","84","1.190476190476190476190476190"
"2017-03-31T00:00:00.000","Fulton","GA","Passenger","1","1","2","121","123","1.626016260162601626016260163"
"2017-03-31T00:00:00.000","Gwinnett","GA","Passenger","0","1","1","83","84","1.190476190476190476190476190"
"2017-03-31T00:00:00.000","Muscogee","GA","Passenger","0","1","1","256","257","0.3891050583657587548638132296"
"2017-03-31T00:00:00.000","Honolulu","HI","Passenger","5","1","6","612","618","0.9708737864077669902912621359"
"2017-03-31T00:00:00.000","Maui","HI","Passenger","1","0","1","71","72","1.388888888888888888888888889"
"2017-03-31T00:00:00.000","Canyon","ID","Passenger","0","1","1","100","101","0.9900990099009900990099009901"
"2017-03-31T00:00:00.000","Latah","ID","Passenger","0","1","1","119","120","0.8333333333333333333333333333"
"2017-03-31T00:00:00.000","Madison","ID","Passenger","1","0","1","43","44","2.272727272727272727272727273"
"2017-03-31T00:00:00.000","DeKalb","IN","Passenger","1","0","1","1","2","50.0"
"2017-03-31T00:00:00.000","Hamilton","IN","Passenger","1","0","1","64","65","1.538461538461538461538461538"
"2017-03-31T00:00:00.000","Hardin","KY","Passenger","0","1","1","127","128","0.7812500"
"2017-03-31T00:00:00.000","Orleans","LA","Passenger","0","1","1","51","52","1.923076923076923076923076923"
"2017-03-31T00:00:00.000","Franklin","MA","Passenger","0","1","1","4","5","20.0"
"2017-03-31T00:00:00.000","Middlesex","MA","Passenger","1","0","1","151","152","0.6578947368421052631578947368"
"2017-03-31T00:00:00.000","Nantucket","MA","Passenger","1","0","1","2","3","33.33333333333333333333333333"
"2017-03-31T00:00:00.000","Norfolk","MA","Passenger","1","0","1","35","36","2.777777777777777777777777778"
"2017-03-31T00:00:00.000","Anne Arundel","MD","Passenger","0","1","1","510","511","0.1956947162426614481409001957"
"2017-03-31T00:00:00.000","Charles","MD","Passenger","0","1","1","91","92","1.086956521739130434782608696"
"2017-03-31T00:00:00.000","Howard","MD","Passenger","0","2","2","90","92","2.173913043478260869565217391"
"2017-03-31T00:00:00.000","Montgomery","MD","Passenger","1","1","2","307","309","0.6472491909385113268608414239"
"2017-03-31T00:00:00.000","Wayne","MI","Passenger","0","1","1","72","73","1.369863013698630136986301370"
"2017-03-31T00:00:00.000","Dakota","MN","Passenger","0","1","1","39","40","2.500"
"2017-03-31T00:00:00.000","Jackson","MO","Passenger","1","0","1","66","67","1.492537313432835820895522388"
"2017-03-31T00:00:00.000","Cascade","MT","Passenger","0","1","1","57","58","1.724137931034482758620689655"
"2017-03-31T00:00:00.000","Gallatin","MT","Passenger","0","1","1","72","73","1.369863013698630136986301370"
"2017-03-31T00:00:00.000","Glacier","MT","Passenger","0","1","1","3","4","25.00"
"2017-03-31T00:00:00.000","Missoula","MT","Passenger","1","0","1","79","80","1.2500"
"2017-03-31T00:00:00.000","Cumberland","NC","Passenger","1","0","1","638","639","0.1564945226917057902973395931"
"2017-03-31T00:00:00.000","Guilford","NC","Passenger","1","0","1","31","32","3.12500"
"2017-03-31T00:00:00.000","Harnett","NC","Passenger","1","0","1","269","270","0.3703703703703703703703703704"
"2017-03-31T00:00:00.000","Moore","NC","Passenger","0","1","1","208","209","0.4784688995215311004784688995"
"2017-03-31T00:00:00.000","Carroll","NH","Passenger","0","1","1","0","1","100"
"2017-03-31T00:00:00.000","Bergen","NJ","Passenger","0","2","2","33","35","5.714285714285714285714285714"
"2017-03-31T00:00:00.000","Essex","NJ","Passenger","1","0","1","15","16","6.2500"
"2017-03-31T00:00:00.000","Morris","NJ","Passenger","1","0","1","22","23","4.347826086956521739130434783"
"2017-03-31T00:00:00.000","Santa Fe","NM","Passenger","0","1","1","44","45","2.222222222222222222222222222"
"2017-03-31T00:00:00.000","Clark","NV","Passenger","1","3","4","852","856","0.4672897196261682242990654206"
"2017-03-31T00:00:00.000","Jefferson","NY","Passenger","1","1","2","261","263","0.7604562737642585551330798479"
"2017-03-31T00:00:00.000","Lewis","NY","Passenger","0","1","1","10","11","9.090909090909090909090909091"
"2017-03-31T00:00:00.000","Monroe","NY","Passenger","1","0","1","30","31","3.225806451612903225806451613"
"2017-03-31T00:00:00.000","Nassau","NY","Passenger","0","1","1","39","40","2.500"
"2017-03-31T00:00:00.000","Saratoga","NY","Passenger","1","1","2","80","82","2.439024390243902439024390244"
"2017-03-31T00:00:00.000","Franklin","OH","Passenger","0","1","1","116","117","0.8547008547008547008547008547"
"2017-03-31T00:00:00.000","Oklahoma","OK","Passenger","0","1","1","166","167","0.5988023952095808383233532934"
"2017-03-31T00:00:00.000","Clackamas","OR","Passenger","1","2","3","336","339","0.8849557522123893805309734513"
"2017-03-31T00:00:00.000","Deschutes","OR","Passenger","1","0","1","198","199","0.5025125628140703517587939698"
"2017-03-31T00:00:00.000","Douglas","OR","Passenger","0","1","1","75","76","1.315789473684210526315789474"
"2017-03-31T00:00:00.000","Lane","OR","Passenger","0","1","1","253","254","0.3937007874015748031496062992"
"2017-03-31T00:00:00.000","Marion","OR","Passenger","1","0","1","192","193","0.5181347150259067357512953368"
"2017-03-31T00:00:00.000","Multnomah","OR","Passenger","0","3","3","1098","1101","0.2724795640326975476839237057"
"2017-03-31T00:00:00.000","Allegheny","PA","Passenger","1","0","1","88","89","1.123595505617977528089887640"
"2017-03-31T00:00:00.000","Montgomery","PA","Passenger","1","0","1","39","40","2.500"
"2017-03-31T00:00:00.000","Northampton","PA","Passenger","2","0","2","210","212","0.9433962264150943396226415094"
"2017-03-31T00:00:00.000","Newport","RI","Passenger","1","0","1","119","120","0.8333333333333333333333333333"
"2017-03-31T00:00:00.000","Hamilton","TN","Passenger","1","0","1","25","26","3.846153846153846153846153846"
"2017-03-31T00:00:00.000","Montgomery","TN","Passenger","1","0","1","286","287","0.3484320557491289198606271777"
"2017-03-31T00:00:00.000","Shelby","TN","Passenger","0","1","1","111","112","0.8928571428571428571428571429"
"2017-03-31T00:00:00.000","Bexar","TX","Passenger","1","2","3","1079","1082","0.2772643253234750462107208872"
"2017-03-31T00:00:00.000","Dallas","TX","Passenger","1","1","2","198","200","1.00"
"2017-03-31T00:00:00.000","Hidalgo","TX","Passenger","0","1","1","97","98","1.020408163265306122448979592"
"2017-03-31T00:00:00.000","Nueces","TX","Passenger","0","1","1","98","99","1.010101010101010101010101010"
"2017-03-31T00:00:00.000","Tarrant","TX","Passenger","0","2","2","285","287","0.6968641114982578397212543554"
"2017-03-31T00:00:00.000","Travis","TX","Passenger","0","1","1","192","193","0.5181347150259067357512953368"
"2017-03-31T00:00:00.000","Salt Lake","UT","Passenger","0","1","1","304","305","0.3278688524590163934426229508"
"2017-03-31T00:00:00.000","Utah","UT","Passenger","0","1","1","161","162","0.6172839506172839506172839506"
"2017-03-31T00:00:00.000","Albemarle","VA","Passenger","0","1","1","29","30","3.333333333333333333333333333"
"2017-03-31T00:00:00.000","Alexandria","VA","Passenger","1","0","1","183","184","0.5434782608695652173913043478"
"2017-03-31T00:00:00.000","Arlington","VA","Passenger","1","1","2","172","174","1.149425287356321839080459770"
"2017-03-31T00:00:00.000","Fairfax","VA","Passenger","2","3","5","874","879","0.5688282138794084186575654152"
"2017-03-31T00:00:00.000","Manassas","VA","Passenger","0","1","1","9","10","10.0"
"2017-03-31T00:00:00.000","Norfolk","VA","Passenger","1","1","2","305","307","0.6514657980456026058631921824"
"2017-03-31T00:00:00.000","Portsmouth","VA","Passenger","0","1","1","62","63","1.587301587301587301587301587"
"2017-03-31T00:00:00.000","Prince William","VA","Passenger","0","3","3","267","270","1.111111111111111111111111111"
"2017-03-31T00:00:00.000","Virginia Beach","VA","Passenger","2","1","3","650","653","0.4594180704441041347626339969"
"2017-03-31T00:00:00.000","Adams","WA","Truck","0","0","0","5071","5071","0"
"2017-03-31T00:00:00.000","Adams","WA","Passenger","2","4","6","12109","12115","0.04952538175815105241436236071"
"2017-03-31T00:00:00.000","Asotin","WA","Passenger","5","3","8","12338","12346","0.06479831524380366110481127491"
"2017-03-31T00:00:00.000","Asotin","WA","Truck","0","0","0","6515","6515","0"
"2017-03-31T00:00:00.000","Benton","WA","Passenger","141","144","285","127944","128229","0.2222586154458039912968205320"
"2017-03-31T00:00:00.000","Benton","WA","Truck","0","0","0","39854","39854","0"
"2017-03-31T00:00:00.000","Chelan","WA","Truck","0","0","0","21226","21226","0"
"2017-03-31T00:00:00.000","Chelan","WA","Passenger","55","30","85","51688","51773","0.1641782396229695014776041566"
"2017-03-31T00:00:00.000","Clallam","WA","Truck","0","0","0","21042","21042","0"
"2017-03-31T00:00:00.000","Clallam","WA","Passenger","79","70","149","48070","48219","0.3090068230365623509405006325"
"2017-03-31T00:00:00.000","Clark","WA","Truck","0","0","0","77575","77575","0"
"2017-03-31T00:00:00.000","Clark","WA","Passenger","721","478","1199","298274","299473","0.4003699832706120418201306963"
"2017-03-31T00:00:00.000","Columbia","WA","Truck","0","0","0","1529","1529","0"
"2017-03-31T00:00:00.000","Columbia","WA","Passenger","0","1","1","2356","2357","0.04242681374628765379719983029"
"2017-03-31T00:00:00.000","Cowlitz","WA","Passenger","52","56","108","69300","69408","0.1556016597510373443983402490"
"2017-03-31T00:00:00.000","Cowlitz","WA","Truck","0","0","0","27911","27911","0"
"2017-03-31T00:00:00.000","Douglas","WA","Truck","0","0","0","11440","11440","0"
"2017-03-31T00:00:00.000","Douglas","WA","Passenger","29","19","48","26588","26636","0.1802072383240726835861240426"
"2017-03-31T00:00:00.000","Ferry","WA","Truck","0","0","0","3555","3555","0"
"2017-03-31T00:00:00.000","Ferry","WA","Passenger","2","1","3","4387","4390","0.06833712984054669703872437358"
"2017-03-31T00:00:00.000","Franklin","WA","Truck","0","0","0","17957","17957","0"
"2017-03-31T00:00:00.000","Franklin","WA","Passenger","27","48","75","55315","55390","0.1354035024372630438707347897"
"2017-03-31T00:00:00.000","Garfield","WA","Truck","0","0","0","940","940","0"
"2017-03-31T00:00:00.000","Garfield","WA","Passenger","0","0","0","1283","1283","0"
"2017-03-31T00:00:00.000","Grant","WA","Passenger","18","25","43","60348","60391","0.07120266264840787534566408902"
"2017-03-31T00:00:00.000","Grant","WA","Truck","0","0","0","25048","25048","0"
"2017-03-31T00:00:00.000","Grays Harbor","WA","Truck","0","0","0","19866","19866","0"
"2017-03-31T00:00:00.000","Grays Harbor","WA","Passenger","28","30","58","44405","44463","0.1304455389874727301351685671"
"2017-03-31T00:00:00.000","Island","WA","Truck","0","0","0","20498","20498","0"
"2017-03-31T00:00:00.000","Island","WA","Passenger","107","135","242","59603","59845","0.4043779764391344306124154065"
"2017-03-31T00:00:00.000","Jefferson","WA","Passenger","95","61","156","23651","23807","0.6552694585626076364094594027"
"2017-03-31T00:00:00.000","Jefferson","WA","Truck","0","0","0","9448","9448","0"
"2017-03-31T00:00:00.000","King","WA","Passenger","9350","4164","13514","1382726","1396240","0.9678851773334097289864206727"
"2017-03-31T00:00:00.000","King","WA","Truck","8","1","9","189799","189808","0.004741633650847171878951361376"
"2017-03-31T00:00:00.000","Kitsap","WA","Passenger","582","303","885","172504","173389","0.5104130019782108438251561518"
"2017-03-31T00:00:00.000","Kitsap","WA","Truck","1","0","1","52334","52335","0.001910767173019967516958058661"
"2017-03-31T00:00:00.000","Kittitas","WA","Truck","0","0","0","13426","13426","0"
"2017-03-31T00:00:00.000","Kittitas","WA","Passenger","17","16","33","27120","27153","0.1215335322063860346922991935"
"2017-03-31T00:00:00.000","Klickitat","WA","Truck","0","0","0","7942","7942","0"
"2017-03-31T00:00:00.000","Klickitat","WA","Passenger","21","25","46","14775","14821","0.3103704203495040820457459011"
"2017-03-31T00:00:00.000","Lewis","WA","Truck","0","0","0","24819","24819","0"
"2017-03-31T00:00:00.000","Lewis","WA","Passenger","46","45","91","55088","55179","0.1649178129360807553598289204"
"2017-03-31T00:00:00.000","Lincoln","WA","Passenger","2","5","7","7505","7512","0.09318423855165069222577209798"
"2017-03-31T00:00:00.000","Lincoln","WA","Truck","0","0","0","4469","4469","0"
"2017-03-31T00:00:00.000","Mason","WA","Passenger","52","63","115","42928","43043","0.2671746857793369421276398021"
"2017-03-31T00:00:00.000","Mason","WA","Truck","0","0","0","19234","19234","0"
"2017-03-31T00:00:00.000","Okanogan","WA","Truck","0","0","0","16308","16308","0"
"2017-03-31T00:00:00.000","Okanogan","WA","Passenger","3","16","19","25640","25659","0.07404809228730659807474960053"
"2017-03-31T00:00:00.000","Pacific","WA","Truck","0","0","0","7482","7482","0"
"2017-03-31T00:00:00.000","Pacific","WA","Passenger","7","9","16","15078","15094","0.1060023850536637074334172519"
"2017-03-31T00:00:00.000","Pend Oreille","WA","Truck","0","0","0","5577","5577","0"
"2017-03-31T00:00:00.000","Pend Oreille","WA","Passenger","1","4","5","9308","9313","0.05368839256952646837753677655"
"2017-03-31T00:00:00.000","Pierce","WA","Truck","0","0","0","138203","138203","0"
"2017-03-31T00:00:00.000","Pierce","WA","Passenger","895","844","1739","526438","528177","0.3292456884718569721892471652"
"2017-03-31T00:00:00.000","San Juan","WA","Truck","0","0","0","5587","5587","0"
"2017-03-31T00:00:00.000","San Juan","WA","Passenger","88","35","123","13420","13543","0.9082182677397917743483718526"
"2017-03-31T00:00:00.000","Skagit","WA","Truck","1","0","1","31431","31432","0.003181471112242300839908373632"
"2017-03-31T00:00:00.000","Skagit","WA","Passenger","120","107","227","87518","87745","0.2587041996694968374266339962"
"2017-03-31T00:00:00.000","Skamania","WA","Passenger","8","8","16","8530","8546","0.1872220922068804118886028551"
"2017-03-31T00:00:00.000","Skamania","WA","Truck","0","0","0","3880","3880","0"
"2017-03-31T00:00:00.000","Snohomish","WA","Passenger","1665","936","2601","513386","515987","0.5040824671939409326203954751"
"2017-03-31T00:00:00.000","Snohomish","WA","Truck","1","0","1","122215","122216","0.0008182234731949990181318321660"
"2017-03-31T00:00:00.000","Spokane","WA","Passenger","237","234","471","295467","295938","0.1591549581331224783569531456"
"2017-03-31T00:00:00.000","Spokane","WA","Truck","1","1","2","90274","90276","0.002215428242279232575656874474"
"2017-03-31T00:00:00.000","Stevens","WA","Truck","0","0","0","18308","18308","0"
"2017-03-31T00:00:00.000","Stevens","WA","Passenger","6","22","28","31286","31314","0.08941687424155329884396755445"
"2017-03-31T00:00:00.000","Thurston","WA","Passenger","374","335","709","185450","186159","0.3808572242008175806702872276"
"2017-03-31T00:00:00.000","Thurston","WA","Truck","0","0","0","53307","53307","0"
"2017-03-31T00:00:00.000","Wahkiakum","WA","Passenger","0","2","2","2849","2851","0.07015082427218519817607856892"
"2017-03-31T00:00:00.000","Wahkiakum","WA","Truck","0","0","0","1635","1635","0"
"2017-03-31T00:00:00.000","Walla Walla","WA","Passenger","20","22","42","34834","34876","0.1204266544328478036472072485"
"2017-03-31T00:00:00.000","Walla Walla","WA","Truck","0","0","0","13187","13187","0"
"2017-03-31T00:00:00.000","Whatcom","WA","Passenger","421","174","595","142247","142842","0.4165441536802901107517396844"
"2017-03-31T00:00:00.000","Whatcom","WA","Truck","2","0","2","41399","41401","0.004830801188377092340764715828"
"2017-03-31T00:00:00.000","Whitman","WA","Truck","0","0","0","8391","8391","0"
"2017-03-31T00:00:00.000","Whitman","WA","Passenger","9","19","28","21952","21980","0.1273885350318471337579617834"
"2017-03-31T00:00:00.000","Yakima","WA","Passenger","36","54","90","159240","159330","0.05648653737525889662963660328"
"2017-03-31T00:00:00.000","Yakima","WA","Truck","0","0","0","57268","57268","0"
"2017-03-31T00:00:00.000","Dane","WI","Passenger","1","0","1","152","153","0.6535947712418300653594771242"
"2017-03-31T00:00:00.000","Ozaukee","WI","Passenger","0","1","1","3","4","25.00"
"2017-03-31T00:00:00.000",,,"Passenger","2","0","2","273","275","0.7272727272727272727272727273"
"2017-04-30T00:00:00.000","Juneau","AK","Passenger","0","1","1","52","53","1.886792452830188679245283019"
"2017-04-30T00:00:00.000","Dale","AL","Passenger","0","1","1","67","68","1.470588235294117647058823529"
"2017-04-30T00:00:00.000","Lee","AL","Passenger","1","0","1","35","36","2.777777777777777777777777778"
"2017-04-30T00:00:00.000","Maricopa","AZ","Passenger","3","1","4","1736","1740","0.2298850574712643678160919540"
"2017-04-30T00:00:00.000","Pima","AZ","Passenger","0","2","2","430","432","0.4629629629629629629629629630"
"2017-04-30T00:00:00.000","Pinal","AZ","Passenger","2","1","3","231","234","1.282051282051282051282051282"
"2017-04-30T00:00:00.000","Alameda","CA","Passenger","2","1","3","375","378","0.7936507936507936507936507937"
"2017-04-30T00:00:00.000","Los Angeles","CA","Passenger","2","1","3","1342","1345","0.2230483271375464684014869888"
"2017-04-30T00:00:00.000","Marin","CA","Passenger","1","0","1","58","59","1.694915254237288135593220339"
"2017-04-30T00:00:00.000","Monterey","CA","Passenger","0","1","1","211","212","0.4716981132075471698113207547"
"2017-04-30T00:00:00.000","Orange","CA","Passenger","2","1","3","641","644","0.4658385093167701863354037267"
"2017-04-30T00:00:00.000","Riverside","CA","Passenger","0","1","1","817","818","0.1222493887530562347188264059"
"2017-04-30T00:00:00.000","San Diego","CA","Passenger","5","1","6","2772","2778","0.2159827213822894168466522678"
"2017-04-30T00:00:00.000","San Mateo","CA","Passenger","0","1","1","159","160","0.62500"
"2017-04-30T00:00:00.000","Santa Clara","CA","Passenger","6","2","8","407","415","1.927710843373493975903614458"
"2017-04-30T00:00:00.000","Tulare","CA","Passenger","1","0","1","195","196","0.5102040816326530612244897959"
"2017-04-30T00:00:00.000","Ventura","CA","Passenger","0","1","1","364","365","0.2739726027397260273972602740"
"2017-04-30T00:00:00.000","El Paso","CO","Passenger","1","1","2","825","827","0.2418379685610640870616686820"
"2017-04-30T00:00:00.000","Larimer","CO","Passenger","0","1","1","81","82","1.219512195121951219512195122"
"2017-04-30T00:00:00.000","New London","CT","Passenger","1","1","2","271","273","0.7326007326007326007326007326"
"2017-04-30T00:00:00.000","District of Columbia","DC","Passenger","0","3","3","221","224","1.339285714285714285714285714"
"2017-04-30T00:00:00.000","Duval","FL","Passenger","1","1","2","368","370","0.5405405405405405405405405405"
"2017-04-30T00:00:00.000","Manatee","FL","Passenger","1","0","1","47","48","2.083333333333333333333333333"
"2017-04-30T00:00:00.000","Miami-Dade","FL","Passenger","0","1","1","133","134","0.7462686567164179104477611940"
"2017-04-30T00:00:00.000","Okaloosa","FL","Passenger","1","0","1","190","191","0.5235602094240837696335078534"
"2017-04-30T00:00:00.000","Orange","FL","Passenger","1","1","2","147","149","1.342281879194630872483221477"
"2017-04-30T00:00:00.000","Palm Beach","FL","Passenger","0","1","1","92","93","1.075268817204301075268817204"
"2017-04-30T00:00:00.000","Polk","FL","Passenger","1","0","1","67","68","1.470588235294117647058823529"
"2017-04-30T00:00:00.000","Santa Rosa","FL","Passenger","1","0","1","109","110","0.9090909090909090909090909091"
"2017-04-30T00:00:00.000","St. Lucie","FL","Passenger","1","0","1","29","30","3.333333333333333333333333333"
"2017-04-30T00:00:00.000","Sumter","FL","Passenger","0","1","1","10","11","9.090909090909090909090909091"
"2017-04-30T00:00:00.000","Volusia","FL","Passenger","0","1","1","46","47","2.127659574468085106382978723"
"2017-04-30T00:00:00.000","Cobb","GA","Passenger","0","1","1","72","73","1.369863013698630136986301370"
"2017-04-30T00:00:00.000","DeKalb","GA","Passenger","1","0","1","83","84","1.190476190476190476190476190"
"2017-04-30T00:00:00.000","Fulton","GA","Passenger","1","1","2","117","119","1.680672268907563025210084034"
"2017-04-30T00:00:00.000","Gwinnett","GA","Passenger","0","1","1","87","88","1.136363636363636363636363636"
"2017-04-30T00:00:00.000","Muscogee","GA","Passenger","0","1","1","250","251","0.3984063745019920318725099602"
"2017-04-30T00:00:00.000","Honolulu","HI","Passenger","5","1","6","598","604","0.9933774834437086092715231788"
"2017-04-30T00:00:00.000","Maui","HI","Passenger","1","0","1","72","73","1.369863013698630136986301370"
"2017-04-30T00:00:00.000","Canyon","ID","Passenger","0","1","1","98","99","1.010101010101010101010101010"
"2017-04-30T00:00:00.000","Latah","ID","Passenger","0","1","1","118","119","0.8403361344537815126050420168"
"2017-04-30T00:00:00.000","Madison","ID","Passenger","1","0","1","40","41","2.439024390243902439024390244"
"2017-04-30T00:00:00.000","DeKalb","IN","Passenger","1","0","1","1","2","50.0"
"2017-04-30T00:00:00.000","Hamilton","IN","Passenger","1","0","1","61","62","1.612903225806451612903225806"
"2017-04-30T00:00:00.000","Hardin","KY","Passenger","0","1","1","124","125","0.800"
"2017-04-30T00:00:00.000","Orleans","LA","Passenger","0","1","1","50","51","1.960784313725490196078431373"
"2017-04-30T00:00:00.000","Franklin","MA","Passenger","0","1","1","4","5","20.0"
"2017-04-30T00:00:00.000","Middlesex","MA","Passenger","1","0","1","147","148","0.6756756756756756756756756757"
"2017-04-30T00:00:00.000","Nantucket","MA","Passenger","1","0","1","2","3","33.33333333333333333333333333"
"2017-04-30T00:00:00.000","Norfolk","MA","Passenger","1","0","1","36","37","2.702702702702702702702702703"
"2017-04-30T00:00:00.000","Anne Arundel","MD","Passenger","0","1","1","508","509","0.1964636542239685658153241650"
"2017-04-30T00:00:00.000","Charles","MD","Passenger","0","1","1","90","91","1.098901098901098901098901099"
"2017-04-30T00:00:00.000","Howard","MD","Passenger","0","2","2","91","93","2.150537634408602150537634409"
"2017-04-30T00:00:00.000","Montgomery","MD","Passenger","1","1","2","309","311","0.6430868167202572347266881029"
"2017-04-30T00:00:00.000","Kent","MI","Passenger","0","1","1","36","37","2.702702702702702702702702703"
"2017-04-30T00:00:00.000","Wayne","MI","Passenger","0","1","1","70","71","1.408450704225352112676056338"
"2017-04-30T00:00:00.000","Dakota","MN","Passenger","0","1","1","38","39","2.564102564102564102564102564"
"2017-04-30T00:00:00.000","Jackson","MO","Passenger","1","0","1","66","67","1.492537313432835820895522388"
"2017-04-30T00:00:00.000","Cascade","MT","Passenger","0","1","1","58","59","1.694915254237288135593220339"
"2017-04-30T00:00:00.000","Gallatin","MT","Passenger","0","1","1","71","72","1.388888888888888888888888889"
"2017-04-30T00:00:00.000","Glacier","MT","Passenger","0","1","1","3","4","25.00"
"2017-04-30T00:00:00.000","Missoula","MT","Passenger","1","0","1","76","77","1.298701298701298701298701299"
"2017-04-30T00:00:00.000","Cumberland","NC","Passenger","1","0","1","628","629","0.1589825119236883942766295707"
"2017-04-30T00:00:00.000","Guilford","NC","Passenger","1","0","1","31","32","3.12500"
"2017-04-30T00:00:00.000","Harnett","NC","Passenger","1","0","1","267","268","0.3731343283582089552238805970"
"2017-04-30T00:00:00.000","Moore","NC","Passenger","0","1","1","204","205","0.4878048780487804878048780488"
"2017-04-30T00:00:00.000","Carroll","NH","Passenger","0","1","1","0","1","100"
"2017-04-30T00:00:00.000","Bergen","NJ","Passenger","0","2","2","33","35","5.714285714285714285714285714"
"2017-04-30T00:00:00.000","Essex","NJ","Passenger","1","0","1","15","16","6.2500"
"2017-04-30T00:00:00.000","Morris","NJ","Passenger","1","0","1","22","23","4.347826086956521739130434783"
"2017-04-30T00:00:00.000","Santa Fe","NM","Passenger","0","1","1","43","44","2.272727272727272727272727273"
"2017-04-30T00:00:00.000","Clark","NV","Passenger","1","3","4","843","847","0.4722550177095631641086186541"
"2017-04-30T00:00:00.000","Jefferson","NY","Passenger","1","1","2","256","258","0.7751937984496124031007751938"
"2017-04-30T00:00:00.000","Lewis","NY","Passenger","0","1","1","10","11","9.090909090909090909090909091"
"2017-04-30T00:00:00.000","Monroe","NY","Passenger","1","0","1","28","29","3.448275862068965517241379310"
"2017-04-30T00:00:00.000","Nassau","NY","Passenger","0","1","1","39","40","2.500"
"2017-04-30T00:00:00.000","Saratoga","NY","Passenger","1","1","2","77","79","2.531645569620253164556962025"
"2017-04-30T00:00:00.000","Franklin","OH","Passenger","0","1","1","127","128","0.7812500"
"2017-04-30T00:00:00.000","Clackamas","OR","Passenger","1","1","2","322","324","0.6172839506172839506172839506"
"2017-04-30T00:00:00.000","Deschutes","OR","Passenger","1","0","1","194","195","0.5128205128205128205128205128"
"2017-04-30T00:00:00.000","Douglas","OR","Passenger","0","1","1","74","75","1.333333333333333333333333333"
"2017-04-30T00:00:00.000","Lane","OR","Passenger","0","1","1","243","244","0.4098360655737704918032786885"
"2017-04-30T00:00:00.000","Marion","OR","Passenger","1","0","1","178","179","0.5586592178770949720670391061"
"2017-04-30T00:00:00.000","Multnomah","OR","Passenger","0","3","3","1056","1059","0.2832861189801699716713881020"
"2017-04-30T00:00:00.000","Allegheny","PA","Passenger","1","0","1","89","90","1.111111111111111111111111111"
"2017-04-30T00:00:00.000","Montgomery","PA","Passenger","1","0","1","38","39","2.564102564102564102564102564"
"2017-04-30T00:00:00.000","Northampton","PA","Passenger","2","0","2","193","195","1.025641025641025641025641026"
"2017-04-30T00:00:00.000","Newport","RI","Passenger","1","0","1","115","116","0.8620689655172413793103448276"
"2017-04-30T00:00:00.000","Hamilton","TN","Passenger","1","0","1","25","26","3.846153846153846153846153846"
"2017-04-30T00:00:00.000","Knox","TN","Passenger","1","0","1","39","40","2.500"
"2017-04-30T00:00:00.000","Montgomery","TN","Passenger","1","0","1","292","293","0.3412969283276450511945392491"
"2017-04-30T00:00:00.000","Shelby","TN","Passenger","0","1","1","110","111","0.9009009009009009009009009009"
"2017-04-30T00:00:00.000","Bexar","TX","Passenger","1","0","1","1018","1019","0.09813542688910696761530912659"
"2017-04-30T00:00:00.000","Dallas","TX","Passenger","0","1","1","188","189","0.5291005291005291005291005291"
"2017-04-30T00:00:00.000","Hidalgo","TX","Passenger","0","1","1","99","100","1.00"
"2017-04-30T00:00:00.000","Nueces","TX","Passenger","0","1","1","97","98","1.020408163265306122448979592"
"2017-04-30T00:00:00.000","Tarrant","TX","Passenger","0","2","2","269","271","0.7380073800738007380073800738"
"2017-04-30T00:00:00.000","Travis","TX","Passenger","0","1","1","194","195","0.5128205128205128205128205128"
"2017-04-30T00:00:00.000","Salt Lake","UT","Passenger","0","1","1","284","285","0.3508771929824561403508771930"
"2017-04-30T00:00:00.000","Utah","UT","Passenger","0","1","1","157","158","0.6329113924050632911392405063"
"2017-04-30T00:00:00.000","Albemarle","VA","Passenger","0","1","1","30","31","3.225806451612903225806451613"
"2017-04-30T00:00:00.000","Alexandria","VA","Passenger","1","0","1","179","180","0.5555555555555555555555555556"
"2017-04-30T00:00:00.000","Arlington","VA","Passenger","1","1","2","169","171","1.169590643274853801169590643"
"2017-04-30T00:00:00.000","Fairfax","VA","Passenger","2","3","5","866","871","0.5740528128587830080367393800"
"2017-04-30T00:00:00.000","Manassas","VA","Passenger","0","1","1","10","11","9.090909090909090909090909091"
"2017-04-30T00:00:00.000","Norfolk","VA","Passenger","1","1","2","301","303","0.6600660066006600660066006601"
"2017-04-30T00:00:00.000","Portsmouth","VA","Passenger","0","1","1","63","64","1.562500"
"2017-04-30T00:00:00.000","Prince William","VA","Passenger","0","3","3","267","270","1.111111111111111111111111111"
"2017-04-30T00:00:00.000","Virginia Beach","VA","Passenger","2","1","3","641","644","0.4658385093167701863354037267"
"2017-04-30T00:00:00.000","Adams","WA","Passenger","2","3","5","12130","12135","0.04120313143798928718582612279"
"2017-04-30T00:00:00.000","Adams","WA","Truck","0","0","0","5073","5073","0"
"2017-04-30T00:00:00.000","Asotin","WA","Truck","0","0","0","6508","6508","0"
"2017-04-30T00:00:00.000","Asotin","WA","Passenger","6","3","9","12345","12354","0.07285089849441476444876153473"
"2017-04-30T00:00:00.000","Benton","WA","Truck","0","0","0","39899","39899","0"
"2017-04-30T00:00:00.000","Benton","WA","Passenger","145","145","290","128089","128379","0.2258936430413073789326914838"
"2017-04-30T00:00:00.000","Chelan","WA","Truck","0","0","0","21214","21214","0"
"2017-04-30T00:00:00.000","Chelan","WA","Passenger","55","31","86","51703","51789","0.1660584293962038270675239916"
"2017-04-30T00:00:00.000","Clallam","WA","Passenger","83","72","155","48119","48274","0.3210838132327961221361395368"
"2017-04-30T00:00:00.000","Clallam","WA","Truck","0","0","0","20964","20964","0"
"2017-04-30T00:00:00.000","Clark","WA","Passenger","766","494","1260","298475","299735","0.4203713280064056583315261815"
"2017-04-30T00:00:00.000","Clark","WA","Truck","0","0","0","77562","77562","0"
"2017-04-30T00:00:00.000","Columbia","WA","Passenger","0","1","1","2359","2360","0.04237288135593220338983050847"
"2017-04-30T00:00:00.000","Columbia","WA","Truck","0","0","0","1536","1536","0"
"2017-04-30T00:00:00.000","Cowlitz","WA","Passenger","54","56","110","69321","69431","0.1584306721781336866817415852"
"2017-04-30T00:00:00.000","Cowlitz","WA","Truck","0","0","0","27862","27862","0"
"2017-04-30T00:00:00.000","Douglas","WA","Truck","0","0","0","11452","11452","0"
"2017-04-30T00:00:00.000","Douglas","WA","Passenger","31","21","52","26599","26651","0.1951146298450339574500018761"
"2017-04-30T00:00:00.000","Ferry","WA","Truck","0","0","0","3550","3550","0"
"2017-04-30T00:00:00.000","Ferry","WA","Passenger","2","1","3","4398","4401","0.06816632583503749147920927062"
"2017-04-30T00:00:00.000","Franklin","WA","Passenger","28","48","76","55355","55431","0.1371073947790947303855243456"
"2017-04-30T00:00:00.000","Franklin","WA","Truck","0","0","0","17993","17993","0"
"2017-04-30T00:00:00.000","Garfield","WA","Truck","0","0","0","938","938","0"
"2017-04-30T00:00:00.000","Garfield","WA","Passenger","0","0","0","1283","1283","0"
"2017-04-30T00:00:00.000","Grant","WA","Passenger","19","25","44","60508","60552","0.07266481701677896683841987052"
"2017-04-30T00:00:00.000","Grant","WA","Truck","0","0","0","25094","25094","0"
"2017-04-30T00:00:00.000","Grays Harbor","WA","Passenger","31","34","65","44462","44527","0.1459788442967188447458845195"
"2017-04-30T00:00:00.000","Grays Harbor","WA","Truck","0","0","0","19852","19852","0"
"2017-04-30T00:00:00.000","Island","WA","Passenger","112","134","246","59770","60016","0.4098906958144494801386296987"
"2017-04-30T00:00:00.000","Island","WA","Truck","0","0","0","20524","20524","0"
"2017-04-30T00:00:00.000","Jefferson","WA","Truck","0","0","0","9443","9443","0"
"2017-04-30T00:00:00.000","Jefferson","WA","Passenger","100","60","160","23747","23907","0.6692600493579286401472372109"
"2017-04-30T00:00:00.000","King","WA","Passenger","9616","4241","13857","1378545","1392402","0.9951867348653621583422028983"
"2017-04-30T00:00:00.000","King","WA","Truck","8","1","9","188979","188988","0.004762207124261857895739412026"
"2017-04-30T00:00:00.000","Kitsap","WA","Passenger","609","313","922","172686","173608","0.5310815169807842956545781300"
"2017-04-30T00:00:00.000","Kitsap","WA","Truck","1","0","1","52325","52326","0.001911095822344532354852272293"
"2017-04-30T00:00:00.000","Kittitas","WA","Passenger","21","17","38","27204","27242","0.1394904926216871008002349314"
"2017-04-30T00:00:00.000","Kittitas","WA","Truck","0","0","0","13481","13481","0"
"2017-04-30T00:00:00.000","Klickitat","WA","Truck","0","0","0","7955","7955","0"
"2017-04-30T00:00:00.000","Klickitat","WA","Passenger","23","25","48","14768","14816","0.3239740820734341252699784017"
"2017-04-30T00:00:00.000","Lewis","WA","Truck","0","0","0","24803","24803","0"
"2017-04-30T00:00:00.000","Lewis","WA","Passenger","49","44","93","55185","55278","0.1682405296863128188429393249"
"2017-04-30T00:00:00.000","Lincoln","WA","Truck","0","0","0","4464","4464","0"
"2017-04-30T00:00:00.000","Lincoln","WA","Passenger","2","5","7","7480","7487","0.09349539201282222519032990517"
"2017-04-30T00:00:00.000","Mason","WA","Passenger","54","62","116","42998","43114","0.2690541355476179431275223825"
"2017-04-30T00:00:00.000","Mason","WA","Truck","0","0","0","19245","19245","0"
"2017-04-30T00:00:00.000","Okanogan","WA","Passenger","3","16","19","25593","25612","0.07418397626112759643916913947"
"2017-04-30T00:00:00.000","Okanogan","WA","Truck","0","0","0","16259","16259","0"
"2017-04-30T00:00:00.000","Pacific","WA","Passenger","12","9","21","15079","15100","0.1390728476821192052980132450"
"2017-04-30T00:00:00.000","Pacific","WA","Truck","0","0","0","7466","7466","0"
"2017-04-30T00:00:00.000","Pend Oreille","WA","Truck","0","0","0","5580","5580","0"
"2017-04-30T00:00:00.000","Pend Oreille","WA","Passenger","2","4","6","9320","9326","0.06433626420759167917649581814"
"2017-04-30T00:00:00.000","Pierce","WA","Passenger","959","869","1828","525795","527623","0.3464594985434675895478400297"
"2017-04-30T00:00:00.000","Pierce","WA","Truck","0","0","0","137847","137847","0"
"2017-04-30T00:00:00.000","San Juan","WA","Passenger","98","36","134","13478","13612","0.9844255069056714663532177490"
"2017-04-30T00:00:00.000","San Juan","WA","Truck","0","0","0","5555","5555","0"
"2017-04-30T00:00:00.000","Skagit","WA","Passenger","128","113","241","87595","87836","0.2743749715378660230429436677"
"2017-04-30T00:00:00.000","Skagit","WA","Truck","1","0","1","31402","31403","0.003184409132885393115307454702"
"2017-04-30T00:00:00.000","Skamania","WA","Truck","0","0","0","3872","3872","0"
"2017-04-30T00:00:00.000","Skamania","WA","Passenger","9","8","17","8521","8538","0.1991098617943312251112672757"
"2017-04-30T00:00:00.000","Snohomish","WA","Truck","1","0","1","122022","122023","0.0008195176319218507986199323078"
"2017-04-30T00:00:00.000","Snohomish","WA","Passenger","1732","948","2680","512743","515423","0.5199612745259718716471713525"
"2017-04-30T00:00:00.000","Spokane","WA","Truck","1","1","2","90286","90288","0.002215133794081162502215133794"
"2017-04-30T00:00:00.000","Spokane","WA","Passenger","244","241","485","295758","296243","0.1637169485861269295814584648"
"2017-04-30T00:00:00.000","Stevens","WA","Passenger","8","24","32","31234","31266","0.1023475980298087379261817949"
"2017-04-30T00:00:00.000","Stevens","WA","Truck","0","0","0","18285","18285","0"
"2017-04-30T00:00:00.000","Thurston","WA","Truck","0","0","0","53265","53265","0"
"2017-04-30T00:00:00.000","Thurston","WA","Passenger","405","341","746","185743","186489","0.4000235938848940151966067704"
"2017-04-30T00:00:00.000","Wahkiakum","WA","Truck","0","0","0","1631","1631","0"
"2017-04-30T00:00:00.000","Wahkiakum","WA","Passenger","1","2","3","2847","2850","0.1052631578947368421052631579"
"2017-04-30T00:00:00.000","Walla Walla","WA","Truck","0","0","0","13177","13177","0"
"2017-04-30T00:00:00.000","Walla Walla","WA","Passenger","22","24","46","34840","34886","0.1318580519406065470389267901"
"2017-04-30T00:00:00.000","Whatcom","WA","Passenger","449","177","626","142470","143096","0.4374685525800860960474087326"
"2017-04-30T00:00:00.000","Whatcom","WA","Truck","2","0","2","41457","41459","0.004824043030463831737379097422"
"2017-04-30T00:00:00.000","Whitman","WA","Passenger","9","20","29","21979","22008","0.1317702653580516175936023264"
"2017-04-30T00:00:00.000","Whitman","WA","Truck","0","0","0","8381","8381","0"
"2017-04-30T00:00:00.000","Yakima","WA","Truck","0","0","0","57221","57221","0"
"2017-04-30T00:00:00.000","Yakima","WA","Passenger","41","58","99","159291","159390","0.06211180124223602484472049689"
"2017-04-30T00:00:00.000","Dane","WI","Passenger","1","0","1","137","138","0.7246376811594202898550724638"
"2017-04-30T00:00:00.000","Ozaukee","WI","Passenger","0","1","1","3","4","25.00"
"2017-04-30T00:00:00.000",,,"Passenger","2","0","2","270","272","0.7352941176470588235294117647"
"2017-05-31T00:00:00.000","Juneau","AK","Passenger","0","1","1","48","49","2.040816326530612244897959184"
"2017-05-31T00:00:00.000","Dale","AL","Passenger","0","1","1","66","67","1.492537313432835820895522388"
"2017-05-31T00:00:00.000","Lee","AL","Passenger","1","0","1","36","37","2.702702702702702702702702703"
"2017-05-31T00:00:00.000","Maricopa","AZ","Passenger","3","1","4","1718","1722","0.2322880371660859465737514518"
"2017-05-31T00:00:00.000","Pima","AZ","Passenger","0","2","2","432","434","0.4608294930875576036866359447"
"2017-05-31T00:00:00.000","Pinal","AZ","Passenger","2","1","3","230","233","1.287553648068669527896995708"
"2017-05-31T00:00:00.000","Alameda","CA","Passenger","1","1","2","368","370","0.5405405405405405405405405405"
"2017-05-31T00:00:00.000","Los Angeles","CA","Passenger","2","1","3","1319","1322","0.2269288956127080181543116490"
"2017-05-31T00:00:00.000","Marin","CA","Passenger","1","0","1","56","57","1.754385964912280701754385965"
"2017-05-31T00:00:00.000","Monterey","CA","Passenger","0","1","1","210","211","0.4739336492890995260663507109"
"2017-05-31T00:00:00.000","Orange","CA","Passenger","3","1","4","639","643","0.6220839813374805598755832037"
"2017-05-31T00:00:00.000","Riverside","CA","Passenger","0","1","1","807","808","0.1237623762376237623762376238"
"2017-05-31T00:00:00.000","San Diego","CA","Passenger","5","1","6","2751","2757","0.2176278563656147986942328618"
"2017-05-31T00:00:00.000","San Mateo","CA","Passenger","0","1","1","157","158","0.6329113924050632911392405063"
"2017-05-31T00:00:00.000","Santa Clara","CA","Passenger","5","2","7","398","405","1.728395061728395061728395062"
"2017-05-31T00:00:00.000","Tulare","CA","Passenger","1","0","1","193","194","0.5154639175257731958762886598"
"2017-05-31T00:00:00.000","Ventura","CA","Passenger","0","1","1","363","364","0.2747252747252747252747252747"
"2017-05-31T00:00:00.000","El Paso","CO","Passenger","2","1","3","812","815","0.3680981595092024539877300613"
"2017-05-31T00:00:00.000","Larimer","CO","Passenger","0","1","1","78","79","1.265822784810126582278481013"
"2017-05-31T00:00:00.000","New London","CT","Passenger","1","1","2","267","269","0.7434944237918215613382899628"
"2017-05-31T00:00:00.000","District of Columbia","DC","Passenger","0","3","3","217","220","1.363636363636363636363636364"
"2017-05-31T00:00:00.000","Kent","DE","Passenger","0","1","1","75","76","1.315789473684210526315789474"
"2017-05-31T00:00:00.000","New Castle","DE","Passenger","1","0","1","23","24","4.166666666666666666666666667"
"2017-05-31T00:00:00.000","Duval","FL","Passenger","1","1","2","369","371","0.5390835579514824797843665768"
"2017-05-31T00:00:00.000","Manatee","FL","Passenger","1","0","1","46","47","2.127659574468085106382978723"
"2017-05-31T00:00:00.000","Miami-Dade","FL","Passenger","0","1","1","131","132","0.7575757575757575757575757576"
"2017-05-31T00:00:00.000","Okaloosa","FL","Passenger","1","0","1","181","182","0.5494505494505494505494505495"
"2017-05-31T00:00:00.000","Orange","FL","Passenger","1","1","2","141","143","1.398601398601398601398601399"
"2017-05-31T00:00:00.000","Palm Beach","FL","Passenger","0","1","1","90","91","1.098901098901098901098901099"
"2017-05-31T00:00:00.000","Polk","FL","Passenger","1","0","1","66","67","1.492537313432835820895522388"
"2017-05-31T00:00:00.000","Santa Rosa","FL","Passenger","1","0","1","110","111","0.9009009009009009009009009009"
"2017-05-31T00:00:00.000","St. Lucie","FL","Passenger","1","0","1","29","30","3.333333333333333333333333333"
"2017-05-31T00:00:00.000","Sumter","FL","Passenger","0","1","1","10","11","9.090909090909090909090909091"
"2017-05-31T00:00:00.000","Volusia","FL","Passenger","0","1","1","44","45","2.222222222222222222222222222"
"2017-05-31T00:00:00.000","Camden","GA","Passenger","0","1","1","179","180","0.5555555555555555555555555556"
"2017-05-31T00:00:00.000","Cobb","GA","Passenger","0","1","1","72","73","1.369863013698630136986301370"
"2017-05-31T00:00:00.000","DeKalb","GA","Passenger","1","0","1","82","83","1.204819277108433734939759036"
"2017-05-31T00:00:00.000","Fulton","GA","Passenger","1","0","1","115","116","0.8620689655172413793103448276"
"2017-05-31T00:00:00.000","Gwinnett","GA","Passenger","0","1","1","86","87","1.149425287356321839080459770"
"2017-05-31T00:00:00.000","Muscogee","GA","Passenger","0","1","1","247","248","0.4032258064516129032258064516"
"2017-05-31T00:00:00.000","Honolulu","HI","Passenger","4","1","5","596","601","0.8319467554076539101497504160"
"2017-05-31T00:00:00.000","Maui","HI","Passenger","1","0","1","73","74","1.351351351351351351351351351"
"2017-05-31T00:00:00.000","Canyon","ID","Passenger","0","1","1","98","99","1.010101010101010101010101010"
"2017-05-31T00:00:00.000","Latah","ID","Passenger","0","1","1","108","109","0.9174311926605504587155963303"
"2017-05-31T00:00:00.000","Madison","ID","Passenger","1","0","1","40","41","2.439024390243902439024390244"
"2017-05-31T00:00:00.000","Twin Falls","ID","Passenger","0","1","1","22","23","4.347826086956521739130434783"
"2017-05-31T00:00:00.000","DeKalb","IN","Passenger","1","0","1","1","2","50.0"
"2017-05-31T00:00:00.000","Hamilton","IN","Passenger","1","0","1","62","63","1.587301587301587301587301587"
"2017-05-31T00:00:00.000","Hardin","KY","Passenger","0","1","1","123","124","0.8064516129032258064516129032"
"2017-05-31T00:00:00.000","Orleans","LA","Passenger","0","1","1","50","51","1.960784313725490196078431373"
"2017-05-31T00:00:00.000","Franklin","MA","Passenger","0","1","1","4","5","20.0"
"2017-05-31T00:00:00.000","Middlesex","MA","Passenger","1","0","1","145","146","0.6849315068493150684931506849"
"2017-05-31T00:00:00.000","Nantucket","MA","Passenger","1","0","1","2","3","33.33333333333333333333333333"
"2017-05-31T00:00:00.000","Norfolk","MA","Passenger","1","0","1","36","37","2.702702702702702702702702703"
"2017-05-31T00:00:00.000","Anne Arundel","MD","Passenger","0","1","1","509","510","0.1960784313725490196078431373"
"2017-05-31T00:00:00.000","Charles","MD","Passenger","0","1","1","89","90","1.111111111111111111111111111"
"2017-05-31T00:00:00.000","Howard","MD","Passenger","0","2","2","91","93","2.150537634408602150537634409"
"2017-05-31T00:00:00.000","Montgomery","MD","Passenger","1","1","2","305","307","0.6514657980456026058631921824"
"2017-05-31T00:00:00.000","Kent","MI","Passenger","0","1","1","34","35","2.857142857142857142857142857"
"2017-05-31T00:00:00.000","Wayne","MI","Passenger","0","1","1","68","69","1.449275362318840579710144928"
"2017-05-31T00:00:00.000","Dakota","MN","Passenger","0","1","1","38","39","2.564102564102564102564102564"
"2017-05-31T00:00:00.000","Ramsey","MN","Passenger","1","0","1","38","39","2.564102564102564102564102564"
"2017-05-31T00:00:00.000","Jackson","MO","Passenger","1","0","1","61","62","1.612903225806451612903225806"
"2017-05-31T00:00:00.000","Cascade","MT","Passenger","0","1","1","58","59","1.694915254237288135593220339"
"2017-05-31T00:00:00.000","Flathead","MT","Passenger","1","0","1","64","65","1.538461538461538461538461538"
"2017-05-31T00:00:00.000","Gallatin","MT","Passenger","0","1","1","67","68","1.470588235294117647058823529"
"2017-05-31T00:00:00.000","Glacier","MT","Passenger","0","1","1","3","4","25.00"
"2017-05-31T00:00:00.000","Missoula","MT","Passenger","1","0","1","72","73","1.369863013698630136986301370"
"2017-05-31T00:00:00.000","Cumberland","NC","Passenger","1","0","1","606","607","0.1647446457990115321252059308"
"2017-05-31T00:00:00.000","Harnett","NC","Passenger","1","0","1","273","274","0.3649635036496350364963503650"
"2017-05-31T00:00:00.000","Moore","NC","Passenger","0","1","1","200","201","0.4975124378109452736318407960"
"2017-05-31T00:00:00.000","Carroll","NH","Passenger","0","1","1","0","1","100"
"2017-05-31T00:00:00.000","Bergen","NJ","Passenger","0","2","2","32","34","5.882352941176470588235294118"
"2017-05-31T00:00:00.000","Essex","NJ","Passenger","1","0","1","14","15","6.666666666666666666666666667"
"2017-05-31T00:00:00.000","Morris","NJ","Passenger","1","0","1","24","25","4.00"
"2017-05-31T00:00:00.000","Santa Fe","NM","Passenger","0","1","1","45","46","2.173913043478260869565217391"
"2017-05-31T00:00:00.000","Clark","NV","Passenger","1","2","3","834","837","0.3584229390681003584229390681"
"2017-05-31T00:00:00.000","Jefferson","NY","Passenger","1","1","2","255","257","0.7782101167315175097276264591"
"2017-05-31T00:00:00.000","Monroe","NY","Passenger","1","0","1","27","28","3.571428571428571428571428571"
"2017-05-31T00:00:00.000","Nassau","NY","Passenger","0","1","1","38","39","2.564102564102564102564102564"
"2017-05-31T00:00:00.000","Saratoga","NY","Passenger","1","1","2","75","77","2.597402597402597402597402597"
"2017-05-31T00:00:00.000","Franklin","OH","Passenger","0","1","1","124","125","0.800"
"2017-05-31T00:00:00.000","Clackamas","OR","Passenger","1","1","2","303","305","0.6557377049180327868852459016"
"2017-05-31T00:00:00.000","Deschutes","OR","Passenger","1","0","1","190","191","0.5235602094240837696335078534"
"2017-05-31T00:00:00.000","Lane","OR","Passenger","0","1","1","239","240","0.4166666666666666666666666667"
"2017-05-31T00:00:00.000","Marion","OR","Passenger","1","0","1","170","171","0.5847953216374269005847953216"
"2017-05-31T00:00:00.000","Multnomah","OR","Passenger","1","3","4","1018","1022","0.3913894324853228962818003914"
"2017-05-31T00:00:00.000","Allegheny","PA","Passenger","1","0","1","89","90","1.111111111111111111111111111"
"2017-05-31T00:00:00.000","Montgomery","PA","Passenger","1","0","1","36","37","2.702702702702702702702702703"
"2017-05-31T00:00:00.000","Northampton","PA","Passenger","1","0","1","169","170","0.5882352941176470588235294118"
"2017-05-31T00:00:00.000","Newport","RI","Passenger","1","0","1","117","118","0.8474576271186440677966101695"
"2017-05-31T00:00:00.000","Hamilton","TN","Passenger","1","0","1","22","23","4.347826086956521739130434783"
"2017-05-31T00:00:00.000","Knox","TN","Passenger","1","0","1","38","39","2.564102564102564102564102564"
"2017-05-31T00:00:00.000","Montgomery","TN","Passenger","1","0","1","282","283","0.3533568904593639575971731449"
"2017-05-31T00:00:00.000","Shelby","TN","Passenger","0","1","1","110","111","0.9009009009009009009009009009"
"2017-05-31T00:00:00.000","Bexar","TX","Passenger","1","0","1","965","966","0.1035196687370600414078674948"
"2017-05-31T00:00:00.000","Dallas","TX","Passenger","0","1","1","178","179","0.5586592178770949720670391061"
"2017-05-31T00:00:00.000","Hidalgo","TX","Passenger","0","1","1","100","101","0.9900990099009900990099009901"
"2017-05-31T00:00:00.000","Nueces","TX","Passenger","0","1","1","97","98","1.020408163265306122448979592"
"2017-05-31T00:00:00.000","Travis","TX","Passenger","0","1","1","192","193","0.5181347150259067357512953368"
"2017-05-31T00:00:00.000","Salt Lake","UT","Passenger","0","1","1","270","271","0.3690036900369003690036900369"
"2017-05-31T00:00:00.000","Utah","UT","Passenger","0","1","1","156","157","0.6369426751592356687898089172"
"2017-05-31T00:00:00.000","Albemarle","VA","Passenger","0","1","1","30","31","3.225806451612903225806451613"
"2017-05-31T00:00:00.000","Alexandria","VA","Passenger","1","0","1","181","182","0.5494505494505494505494505495"
"2017-05-31T00:00:00.000","Arlington","VA","Passenger","1","1","2","170","172","1.162790697674418604651162791"
"2017-05-31T00:00:00.000","Fairfax","VA","Passenger","2","3","5","867","872","0.5733944954128440366972477064"
"2017-05-31T00:00:00.000","Manassas","VA","Passenger","0","1","1","9","10","10.0"
"2017-05-31T00:00:00.000","Norfolk","VA","Passenger","1","1","2","307","309","0.6472491909385113268608414239"
"2017-05-31T00:00:00.000","Portsmouth","VA","Passenger","0","1","1","63","64","1.562500"
"2017-05-31T00:00:00.000","Prince William","VA","Passenger","0","3","3","268","271","1.107011070110701107011070111"
"2017-05-31T00:00:00.000","Virginia Beach","VA","Passenger","2","1","3","653","656","0.4573170731707317073170731707"
"2017-05-31T00:00:00.000","Adams","WA","Passenger","2","3","5","12199","12204","0.04097017371353654539495247460"
"2017-05-31T00:00:00.000","Adams","WA","Truck","0","0","0","5080","5080","0"
"2017-05-31T00:00:00.000","Asotin","WA","Passenger","6","4","10","12379","12389","0.08071676487206392767777867463"
"2017-05-31T00:00:00.000","Asotin","WA","Truck","0","0","0","6495","6495","0"
"2017-05-31T00:00:00.000","Benton","WA","Passenger","148","147","295","128295","128590","0.2294113072556186328641418462"
"2017-05-31T00:00:00.000","Benton","WA","Truck","0","0","0","39982","39982","0"
"2017-05-31T00:00:00.000","Chelan","WA","Passenger","60","36","96","51885","51981","0.1846828648929416517573728862"
"2017-05-31T00:00:00.000","Chelan","WA","Truck","0","0","0","21256","21256","0"
"2017-05-31T00:00:00.000","Clallam","WA","Truck","0","0","0","20961","20961","0"
"2017-05-31T00:00:00.000","Clallam","WA","Passenger","87","79","166","48195","48361","0.3432517938007898926821198900"
"2017-05-31T00:00:00.000","Clark","WA","Passenger","786","516","1302","298788","300090","0.4338698390482855143456962911"
"2017-05-31T00:00:00.000","Clark","WA","Truck","0","0","0","77601","77601","0"
"2017-05-31T00:00:00.000","Columbia","WA","Passenger","0","1","1","2359","2360","0.04237288135593220338983050847"
"2017-05-31T00:00:00.000","Columbia","WA","Truck","0","0","0","1537","1537","0"
"2017-05-31T00:00:00.000","Cowlitz","WA","Passenger","56","58","114","69537","69651","0.1636731705216005513201533359"
"2017-05-31T00:00:00.000","Cowlitz","WA","Truck","0","0","0","27879","27879","0"
"2017-05-31T00:00:00.000","Douglas","WA","Passenger","32","23","55","26679","26734","0.2057305304107129498017505798"
"2017-05-31T00:00:00.000","Douglas","WA","Truck","0","0","0","11483","11483","0"
"2017-05-31T00:00:00.000","Ferry","WA","Truck","0","0","0","3545","3545","0"
"2017-05-31T00:00:00.000","Ferry","WA","Passenger","1","1","2","4410","4412","0.04533091568449682683590208522"
"2017-05-31T00:00:00.000","Franklin","WA","Truck","0","0","0","18090","18090","0"
"2017-05-31T00:00:00.000","Franklin","WA","Passenger","30","45","75","55466","55541","0.1350353792693685745665364325"
"2017-05-31T00:00:00.000","Garfield","WA","Truck","0","0","0","932","932","0"
"2017-05-31T00:00:00.000","Garfield","WA","Passenger","0","0","0","1288","1288","0"
"2017-05-31T00:00:00.000","Grant","WA","Truck","0","0","0","25225","25225","0"
"2017-05-31T00:00:00.000","Grant","WA","Passenger","21","29","50","60694","60744","0.08231265639404714868958251021"
"2017-05-31T00:00:00.000","Grays Harbor","WA","Truck","0","0","0","19899","19899","0"
"2017-05-31T00:00:00.000","Grays Harbor","WA","Passenger","33","34","67","44501","44568","0.1503320768264225453239992820"
"2017-05-31T00:00:00.000","Island","WA","Passenger","118","135","253","59920","60173","0.4204543566051218985259169395"
"2017-05-31T00:00:00.000","Island","WA","Truck","0","0","0","20529","20529","0"
"2017-05-31T00:00:00.000","Jefferson","WA","Passenger","106","63","169","23821","23990","0.7044601917465610671112963735"
"2017-05-31T00:00:00.000","Jefferson","WA","Truck","0","0","0","9441","9441","0"
"2017-05-31T00:00:00.000","King","WA","Truck","8","1","9","188308","188317","0.004779175539117551787677161382"
"2017-05-31T00:00:00.000","King","WA","Passenger","9886","4346","14232","1377101","1391333","1.022903934572097405869047884"
"2017-05-31T00:00:00.000","Kitsap","WA","Truck","1","0","1","52394","52395","0.001908579062887680122149060025"
"2017-05-31T00:00:00.000","Kitsap","WA","Passenger","628","317","945","172848","173793","0.5437503236609069410160363191"
"2017-05-31T00:00:00.000","Kittitas","WA","Truck","0","0","0","13534","13534","0"
"2017-05-31T00:00:00.000","Kittitas","WA","Passenger","23","17","40","27358","27398","0.1459960581064311263595882911"
"2017-05-31T00:00:00.000","Klickitat","WA","Passenger","23","26","49","14787","14836","0.3302777028848746292801294149"
"2017-05-31T00:00:00.000","Klickitat","WA","Truck","0","0","0","7969","7969","0"
"2017-05-31T00:00:00.000","Lewis","WA","Passenger","52","43","95","55355","55450","0.1713255184851217312894499549"
"2017-05-31T00:00:00.000","Lewis","WA","Truck","0","0","0","24827","24827","0"
"2017-05-31T00:00:00.000","Lincoln","WA","Passenger","2","6","8","7506","7514","0.1064679265371306893798243279"
"2017-05-31T00:00:00.000","Lincoln","WA","Truck","0","0","0","4459","4459","0"
"2017-05-31T00:00:00.000","Mason","WA","Passenger","56","65","121","43294","43415","0.2787055165265461246113094553"
"2017-05-31T00:00:00.000","Mason","WA","Truck","0","0","0","19268","19268","0"
"2017-05-31T00:00:00.000","Okanogan","WA","Passenger","3","16","19","25687","25706","0.07391270520501050338442386991"
"2017-05-31T00:00:00.000","Okanogan","WA","Truck","0","0","0","16218","16218","0"
"2017-05-31T00:00:00.000","Pacific","WA","Truck","0","0","0","7462","7462","0"
"2017-05-31T00:00:00.000","Pacific","WA","Passenger","13","8","21","15133","15154","0.1385772733271743434076811403"
"2017-05-31T00:00:00.000","Pend Oreille","WA","Truck","0","0","0","5558","5558","0"
"2017-05-31T00:00:00.000","Pend Oreille","WA","Passenger","3","4","7","9313","9320","0.07510729613733905579399141631"
"2017-05-31T00:00:00.000","Pierce","WA","Passenger","988","886","1874","525253","527127","0.3555120492784471294393950604"
"2017-05-31T00:00:00.000","Pierce","WA","Truck","0","0","0","137714","137714","0"
"2017-05-31T00:00:00.000","San Juan","WA","Truck","0","0","0","5545","5545","0"
"2017-05-31T00:00:00.000","San Juan","WA","Passenger","104","40","144","13496","13640","1.055718475073313782991202346"
"2017-05-31T00:00:00.000","Skagit","WA","Passenger","141","118","259","87851","88110","0.2939507433889456361366473726"
"2017-05-31T00:00:00.000","Skagit","WA","Truck","1","0","1","31395","31396","0.003185119123455217225124219646"
"2017-05-31T00:00:00.000","Skamania","WA","Passenger","9","7","16","8532","8548","0.1871782873186710341600374357"
"2017-05-31T00:00:00.000","Skamania","WA","Truck","0","0","0","3861","3861","0"
"2017-05-31T00:00:00.000","Snohomish","WA","Passenger","1771","954","2725","512597","515322","0.5287955880012885147538820388"
"2017-05-31T00:00:00.000","Snohomish","WA","Truck","1","0","1","121879","121880","0.0008204791598293403347554972104"
"2017-05-31T00:00:00.000","Spokane","WA","Passenger","255","244","499","296392","296891","0.1680751521602204175943359684"
"2017-05-31T00:00:00.000","Spokane","WA","Truck","1","0","1","90352","90353","0.001106770112779874492269210762"
"2017-05-31T00:00:00.000","Stevens","WA","Passenger","8","25","33","31330","31363","0.1052195261932850811465739885"
"2017-05-31T00:00:00.000","Stevens","WA","Truck","0","0","0","18251","18251","0"
"2017-05-31T00:00:00.000","Thurston","WA","Passenger","415","356","771","186071","186842","0.4126481198017576347930336862"
"2017-05-31T00:00:00.000","Thurston","WA","Truck","0","0","0","53253","53253","0"
"2017-05-31T00:00:00.000","Wahkiakum","WA","Passenger","1","2","3","2836","2839","0.1056710109193377949982388165"
"2017-05-31T00:00:00.000","Wahkiakum","WA","Truck","0","0","0","1643","1643","0"
"2017-05-31T00:00:00.000","Walla Walla","WA","Passenger","23","24","47","34869","34916","0.1346087753465459961049375644"
"2017-05-31T00:00:00.000","Walla Walla","WA","Truck","0","0","0","13189","13189","0"
"2017-05-31T00:00:00.000","Whatcom","WA","Truck","2","0","2","41526","41528","0.004816027740319784241957233674"
"2017-05-31T00:00:00.000","Whatcom","WA","Passenger","464","185","649","142696","143345","0.4527538456172172032508981827"
"2017-05-31T00:00:00.000","Whitman","WA","Passenger","10","21","31","22005","22036","0.1406788890905790524596115447"
"2017-05-31T00:00:00.000","Whitman","WA","Truck","0","0","0","8395","8395","0"
"2017-05-31T00:00:00.000","Yakima","WA","Truck","0","0","0","57282","57282","0"
"2017-05-31T00:00:00.000","Yakima","WA","Passenger","46","60","106","159379","159485","0.06646393077718907734269680534"
"2017-05-31T00:00:00.000","Dane","WI","Passenger","1","0","1","120","121","0.8264462809917355371900826446"
"2017-05-31T00:00:00.000","Ozaukee","WI","Passenger","0","1","1","3","4","25.00"
"2017-05-31T00:00:00.000",,,"Passenger","2","0","2","261","263","0.7604562737642585551330798479"
"2017-06-30T00:00:00.000","Juneau","AK","Passenger","0","1","1","44","45","2.222222222222222222222222222"
"2017-06-30T00:00:00.000","Dale","AL","Passenger","0","1","1","65","66","1.515151515151515151515151515"
"2017-06-30T00:00:00.000","Lee","AL","Passenger","1","0","1","36","37","2.702702702702702702702702703"
"2017-06-30T00:00:00.000","Maricopa","AZ","Passenger","3","1","4","1678","1682","0.2378121284185493460166468490"
"2017-06-30T00:00:00.000","Pima","AZ","Passenger","0","2","2","419","421","0.4750593824228028503562945368"
"2017-06-30T00:00:00.000","Pinal","AZ","Passenger","2","1","3","220","223","1.345291479820627802690582960"
"2017-06-30T00:00:00.000","Alameda","CA","Passenger","1","1","2","361","363","0.5509641873278236914600550964"
"2017-06-30T00:00:00.000","Los Angeles","CA","Passenger","2","1","3","1291","1294","0.2318392581143740340030911901"
"2017-06-30T00:00:00.000","Marin","CA","Passenger","1","0","1","57","58","1.724137931034482758620689655"
"2017-06-30T00:00:00.000","Monterey","CA","Passenger","0","1","1","207","208","0.4807692307692307692307692308"
"2017-06-30T00:00:00.000","Orange","CA","Passenger","3","1","4","622","626","0.6389776357827476038338658147"
"2017-06-30T00:00:00.000","Riverside","CA","Passenger","0","1","1","795","796","0.1256281407035175879396984925"
"2017-06-30T00:00:00.000","San Diego","CA","Passenger","5","1","6","2737","2743","0.2187386073641997812613926358"
"2017-06-30T00:00:00.000","San Mateo","CA","Passenger","0","1","1","151","152","0.6578947368421052631578947368"
"2017-06-30T00:00:00.000","Santa Clara","CA","Passenger","5","2","7","395","402","1.741293532338308457711442786"
"2017-06-30T00:00:00.000","Tulare","CA","Passenger","1","0","1","198","199","0.5025125628140703517587939698"
"2017-06-30T00:00:00.000","Tuolumne","CA","Passenger","0","1","1","12","13","7.692307692307692307692307692"
"2017-06-30T00:00:00.000","Ventura","CA","Passenger","0","1","1","358","359","0.2785515320334261838440111421"
"2017-06-30T00:00:00.000","El Paso","CO","Passenger","2","1","3","808","811","0.3699136868064118372379778052"
"2017-06-30T00:00:00.000","Larimer","CO","Passenger","0","1","1","76","77","1.298701298701298701298701299"
"2017-06-30T00:00:00.000","New London","CT","Passenger","1","1","2","268","270","0.7407407407407407407407407407"
"2017-06-30T00:00:00.000","District of Columbia","DC","Passenger","0","3","3","213","216","1.388888888888888888888888889"
"2017-06-30T00:00:00.000","Kent","DE","Passenger","0","1","1","72","73","1.369863013698630136986301370"
"2017-06-30T00:00:00.000","New Castle","DE","Passenger","1","0","1","24","25","4.00"
"2017-06-30T00:00:00.000","Duval","FL","Passenger","1","1","2","374","376","0.5319148936170212765957446809"
"2017-06-30T00:00:00.000","Manatee","FL","Passenger","1","0","1","45","46","2.173913043478260869565217391"
"2017-06-30T00:00:00.000","Miami-Dade","FL","Passenger","0","1","1","130","131","0.7633587786259541984732824427"
"2017-06-30T00:00:00.000","Okaloosa","FL","Passenger","1","0","1","179","180","0.5555555555555555555555555556"
"2017-06-30T00:00:00.000","Orange","FL","Passenger","1","1","2","131","133","1.503759398496240601503759398"
"2017-06-30T00:00:00.000","Palm Beach","FL","Passenger","0","1","1","90","91","1.098901098901098901098901099"
"2017-06-30T00:00:00.000","Polk","FL","Passenger","1","0","1","64","65","1.538461538461538461538461538"
"2017-06-30T00:00:00.000","Santa Rosa","FL","Passenger","1","0","1","114","115","0.8695652173913043478260869565"
"2017-06-30T00:00:00.000","St. Lucie","FL","Passenger","1","0","1","30","31","3.225806451612903225806451613"
"2017-06-30T00:00:00.000","Sumter","FL","Passenger","0","1","1","10","11","9.090909090909090909090909091"
"2017-06-30T00:00:00.000","Volusia","FL","Passenger","0","1","1","46","47","2.127659574468085106382978723"
"2017-06-30T00:00:00.000","Camden","GA","Passenger","0","1","1","181","182","0.5494505494505494505494505495"
"2017-06-30T00:00:00.000","Cobb","GA","Passenger","0","1","1","71","72","1.388888888888888888888888889"
"2017-06-30T00:00:00.000","DeKalb","GA","Passenger","1","0","1","84","85","1.176470588235294117647058824"
"2017-06-30T00:00:00.000","Fulton","GA","Passenger","1","0","1","113","114","0.8771929824561403508771929825"
"2017-06-30T00:00:00.000","Gwinnett","GA","Passenger","0","1","1","85","86","1.162790697674418604651162791"
"2017-06-30T00:00:00.000","Lumpkin","GA","Passenger","1","0","1","9","10","10.0"
"2017-06-30T00:00:00.000","Honolulu","HI","Passenger","4","1","5","587","592","0.8445945945945945945945945946"
"2017-06-30T00:00:00.000","Maui","HI","Passenger","1","0","1","69","70","1.428571428571428571428571429"
"2017-06-30T00:00:00.000","Canyon","ID","Passenger","0","1","1","96","97","1.030927835051546391752577320"
"2017-06-30T00:00:00.000","Latah","ID","Passenger","0","1","1","101","102","0.9803921568627450980392156863"
"2017-06-30T00:00:00.000","Madison","ID","Passenger","1","0","1","38","39","2.564102564102564102564102564"
"2017-06-30T00:00:00.000","Twin Falls","ID","Passenger","0","1","1","23","24","4.166666666666666666666666667"
"2017-06-30T00:00:00.000","Sangamon","IL","Passenger","1","0","1","11","12","8.333333333333333333333333333"
"2017-06-30T00:00:00.000","DeKalb","IN","Passenger","1","0","1","1","2","50.0"
"2017-06-30T00:00:00.000","Hamilton","IN","Passenger","1","0","1","58","59","1.694915254237288135593220339"
"2017-06-30T00:00:00.000","Hardin","KY","Passenger","0","1","1","123","124","0.8064516129032258064516129032"
"2017-06-30T00:00:00.000","Orleans","LA","Passenger","0","1","1","47","48","2.083333333333333333333333333"
"2017-06-30T00:00:00.000","Franklin","MA","Passenger","0","1","1","4","5","20.0"
"2017-06-30T00:00:00.000","Nantucket","MA","Passenger","1","0","1","2","3","33.33333333333333333333333333"
"2017-06-30T00:00:00.000","Norfolk","MA","Passenger","1","0","1","35","36","2.777777777777777777777777778"
"2017-06-30T00:00:00.000","Anne Arundel","MD","Passenger","0","1","1","506","507","0.1972386587771203155818540434"
"2017-06-30T00:00:00.000","Charles","MD","Passenger","0","1","1","88","89","1.123595505617977528089887640"
"2017-06-30T00:00:00.000","Howard","MD","Passenger","0","2","2","94","96","2.083333333333333333333333333"
"2017-06-30T00:00:00.000","Montgomery","MD","Passenger","1","1","2","308","310","0.6451612903225806451612903226"
"2017-06-30T00:00:00.000","Kent","MI","Passenger","0","1","1","36","37","2.702702702702702702702702703"
"2017-06-30T00:00:00.000","Wayne","MI","Passenger","0","1","1","69","70","1.428571428571428571428571429"
"2017-06-30T00:00:00.000","Dakota","MN","Passenger","0","1","1","35","36","2.777777777777777777777777778"
"2017-06-30T00:00:00.000","Ramsey","MN","Passenger","1","0","1","37","38","2.631578947368421052631578947"
"2017-06-30T00:00:00.000","Jackson","MO","Passenger","1","0","1","58","59","1.694915254237288135593220339"
"2017-06-30T00:00:00.000","Cascade","MT","Passenger","0","1","1","56","57","1.754385964912280701754385965"
"2017-06-30T00:00:00.000","Flathead","MT","Passenger","1","0","1","62","63","1.587301587301587301587301587"
"2017-06-30T00:00:00.000","Gallatin","MT","Passenger","0","1","1","66","67","1.492537313432835820895522388"
"2017-06-30T00:00:00.000","Glacier","MT","Passenger","0","1","1","3","4","25.00"
"2017-06-30T00:00:00.000","Missoula","MT","Passenger","1","0","1","70","71","1.408450704225352112676056338"
"2017-06-30T00:00:00.000","Cumberland","NC","Passenger","1","0","1","597","598","0.1672240802675585284280936455"
"2017-06-30T00:00:00.000","Harnett","NC","Passenger","1","0","1","269","270","0.3703703703703703703703703704"
"2017-06-30T00:00:00.000","Moore","NC","Passenger","0","1","1","197","198","0.5050505050505050505050505051"
"2017-06-30T00:00:00.000","Carroll","NH","Passenger","0","1","1","1","2","50.0"
"2017-06-30T00:00:00.000","Bergen","NJ","Passenger","0","2","2","32","34","5.882352941176470588235294118"
"2017-06-30T00:00:00.000","Essex","NJ","Passenger","1","0","1","13","14","7.142857142857142857142857143"
"2017-06-30T00:00:00.000","Morris","NJ","Passenger","1","0","1","24","25","4.00"
"2017-06-30T00:00:00.000","Santa Fe","NM","Passenger","0","1","1","45","46","2.173913043478260869565217391"
"2017-06-30T00:00:00.000","Clark","NV","Passenger","1","2","3","816","819","0.3663003663003663003663003663"
"2017-06-30T00:00:00.000","Washoe","NV","Passenger","1","0","1","128","129","0.7751937984496124031007751938"
"2017-06-30T00:00:00.000","Jefferson","NY","Passenger","1","1","2","253","255","0.7843137254901960784313725490"
"2017-06-30T00:00:00.000","Nassau","NY","Passenger","0","1","1","38","39","2.564102564102564102564102564"
"2017-06-30T00:00:00.000","Saratoga","NY","Passenger","1","1","2","77","79","2.531645569620253164556962025"
"2017-06-30T00:00:00.000","Franklin","OH","Passenger","0","1","1","123","124","0.8064516129032258064516129032"
"2017-06-30T00:00:00.000","Clackamas","OR","Passenger","0","1","1","289","290","0.3448275862068965517241379310"
"2017-06-30T00:00:00.000","Deschutes","OR","Passenger","1","0","1","190","191","0.5235602094240837696335078534"
"2017-06-30T00:00:00.000","Lane","OR","Passenger","0","1","1","232","233","0.4291845493562231759656652361"
"2017-06-30T00:00:00.000","Marion","OR","Passenger","1","0","1","162","163","0.6134969325153374233128834356"
"2017-06-30T00:00:00.000","Multnomah","OR","Passenger","1","3","4","984","988","0.4048582995951417004048582996"
"2017-06-30T00:00:00.000","Allegheny","PA","Passenger","1","0","1","89","90","1.111111111111111111111111111"
"2017-06-30T00:00:00.000","Montgomery","PA","Passenger","1","0","1","37","38","2.631578947368421052631578947"
"2017-06-30T00:00:00.000","Northampton","PA","Passenger","1","0","1","148","149","0.6711409395973154362416107383"
"2017-06-30T00:00:00.000","Newport","RI","Passenger","1","0","1","119","120","0.8333333333333333333333333333"
"2017-06-30T00:00:00.000","Hamilton","TN","Passenger","1","0","1","19","20","5.00"
"2017-06-30T00:00:00.000","Knox","TN","Passenger","1","0","1","37","38","2.631578947368421052631578947"
"2017-06-30T00:00:00.000","Montgomery","TN","Passenger","1","0","1","282","283","0.3533568904593639575971731449"
"2017-06-30T00:00:00.000","Shelby","TN","Passenger","0","1","1","111","112","0.8928571428571428571428571429"
"2017-06-30T00:00:00.000","Bexar","TX","Passenger","1","1","2","932","934","0.2141327623126338329764453961"
"2017-06-30T00:00:00.000","Dallas","TX","Passenger","0","1","1","177","178","0.5617977528089887640449438202"
"2017-06-30T00:00:00.000","Nueces","TX","Passenger","0","1","1","95","96","1.041666666666666666666666667"
"2017-06-30T00:00:00.000","Tarrant","TX","Passenger","1","0","1","246","247","0.4048582995951417004048582996"
"2017-06-30T00:00:00.000","Travis","TX","Passenger","0","1","1","190","191","0.5235602094240837696335078534"
"2017-06-30T00:00:00.000","Salt Lake","UT","Passenger","0","1","1","261","262","0.3816793893129770992366412214"
"2017-06-30T00:00:00.000","Utah","UT","Passenger","0","1","1","149","150","0.6666666666666666666666666667"
"2017-06-30T00:00:00.000","Albemarle","VA","Passenger","0","1","1","32","33","3.030303030303030303030303030"
"2017-06-30T00:00:00.000","Alexandria","VA","Passenger","1","0","1","184","185","0.5405405405405405405405405405"
"2017-06-30T00:00:00.000","Arlington","VA","Passenger","1","1","2","168","170","1.176470588235294117647058824"
"2017-06-30T00:00:00.000","Fairfax","VA","Passenger","2","3","5","865","870","0.5747126436781609195402298851"
"2017-06-30T00:00:00.000","Manassas","VA","Passenger","0","1","1","9","10","10.0"
"2017-06-30T00:00:00.000","Norfolk","VA","Passenger","1","1","2","316","318","0.6289308176100628930817610063"
"2017-06-30T00:00:00.000","Portsmouth","VA","Passenger","0","1","1","62","63","1.587301587301587301587301587"
"2017-06-30T00:00:00.000","Prince William","VA","Passenger","0","3","3","264","267","1.123595505617977528089887640"
"2017-06-30T00:00:00.000","Rockbridge","VA","Passenger","1","0","1","4","5","20.0"
"2017-06-30T00:00:00.000","Virginia Beach","VA","Passenger","2","1","3","648","651","0.4608294930875576036866359447"
"2017-06-30T00:00:00.000","Adams","WA","Passenger","2","3","5","12206","12211","0.04094668741298828924739988535"
"2017-06-30T00:00:00.000","Adams","WA","Truck","0","0","0","5106","5106","0"
"2017-06-30T00:00:00.000","Asotin","WA","Truck","0","0","0","6506","6506","0"
"2017-06-30T00:00:00.000","Asotin","WA","Passenger","6","4","10","12430","12440","0.08038585209003215434083601286"
"2017-06-30T00:00:00.000","Benton","WA","Passenger","152","148","300","128513","128813","0.2328957480999588550845023406"
"2017-06-30T00:00:00.000","Benton","WA","Truck","0","0","0","40064","40064","0"
"2017-06-30T00:00:00.000","Chelan","WA","Passenger","67","37","104","52056","52160","0.1993865030674846625766871166"
"2017-06-30T00:00:00.000","Chelan","WA","Truck","0","0","0","21312","21312","0"
"2017-06-30T00:00:00.000","Clallam","WA","Passenger","95","81","176","48361","48537","0.3626099676535426581782969693"
"2017-06-30T00:00:00.000","Clallam","WA","Truck","0","0","0","21018","21018","0"
"2017-06-30T00:00:00.000","Clark","WA","Truck","0","0","0","77652","77652","0"
"2017-06-30T00:00:00.000","Clark","WA","Passenger","814","532","1346","299526","300872","0.4473663218910367199340583371"
"2017-06-30T00:00:00.000","Columbia","WA","Truck","0","0","0","1531","1531","0"
"2017-06-30T00:00:00.000","Columbia","WA","Passenger","1","1","2","2353","2355","0.08492569002123142250530785563"
"2017-06-30T00:00:00.000","Cowlitz","WA","Truck","0","0","0","27921","27921","0"
"2017-06-30T00:00:00.000","Cowlitz","WA","Passenger","54","68","122","69654","69776","0.1748452189864709928915386379"
"2017-06-30T00:00:00.000","Douglas","WA","Truck","0","0","0","11526","11526","0"
"2017-06-30T00:00:00.000","Douglas","WA","Passenger","34","26","60","26712","26772","0.2241147467503361721201255043"
"2017-06-30T00:00:00.000","Ferry","WA","Passenger","1","1","2","4395","4397","0.04548555833522856493063452354"
"2017-06-30T00:00:00.000","Ferry","WA","Truck","0","0","0","3538","3538","0"
"2017-06-30T00:00:00.000","Franklin","WA","Truck","0","0","0","18121","18121","0"
"2017-06-30T00:00:00.000","Franklin","WA","Passenger","28","46","74","55624","55698","0.1328593486301123918273546626"
"2017-06-30T00:00:00.000","Garfield","WA","Truck","0","0","0","940","940","0"
"2017-06-30T00:00:00.000","Garfield","WA","Passenger","0","0","0","1296","1296","0"
"2017-06-30T00:00:00.000","Grant","WA","Passenger","21","31","52","60864","60916","0.08536345131000065664193315385"
"2017-06-30T00:00:00.000","Grant","WA","Truck","0","0","0","25224","25224","0"
"2017-06-30T00:00:00.000","Grays Harbor","WA","Truck","0","0","0","19890","19890","0"
"2017-06-30T00:00:00.000","Grays Harbor","WA","Passenger","37","35","72","44764","44836","0.1605852440003568560977785708"
"2017-06-30T00:00:00.000","Island","WA","Truck","0","0","0","20499","20499","0"
"2017-06-30T00:00:00.000","Island","WA","Passenger","123","142","265","60114","60379","0.4388943175607413173454346710"
"2017-06-30T00:00:00.000","Jefferson","WA","Passenger","107","65","172","23852","24024","0.7159507159507159507159507160"
"2017-06-30T00:00:00.000","Jefferson","WA","Truck","0","0","0","9425","9425","0"
"2017-06-30T00:00:00.000","King","WA","Passenger","10162","4409","14571","1375360","1389931","1.048325420470512565012220031"
"2017-06-30T00:00:00.000","King","WA","Truck","8","1","9","187785","187794","0.004792485382919582095274609412"
"2017-06-30T00:00:00.000","Kitsap","WA","Passenger","641","334","975","173377","174352","0.5592135450123887308433513811"
"2017-06-30T00:00:00.000","Kitsap","WA","Truck","1","0","1","52537","52538","0.001903384217138071491111195706"
"2017-06-30T00:00:00.000","Kittitas","WA","Truck","0","0","0","13561","13561","0"
"2017-06-30T00:00:00.000","Kittitas","WA","Passenger","22","17","39","27581","27620","0.1412020275162925416364952933"
"2017-06-30T00:00:00.000","Klickitat","WA","Truck","0","0","0","7972","7972","0"
"2017-06-30T00:00:00.000","Klickitat","WA","Passenger","25","26","51","14797","14848","0.3434806034482758620689655172"
"2017-06-30T00:00:00.000","Lewis","WA","Passenger","55","45","100","55536","55636","0.1797397368610252354590552879"
"2017-06-30T00:00:00.000","Lewis","WA","Truck","0","0","0","24842","24842","0"
"2017-06-30T00:00:00.000","Lincoln","WA","Passenger","2","6","8","7527","7535","0.1061712010617120106171201062"
"2017-06-30T00:00:00.000","Lincoln","WA","Truck","0","0","0","4429","4429","0"
"2017-06-30T00:00:00.000","Mason","WA","Truck","0","0","0","19276","19276","0"
"2017-06-30T00:00:00.000","Mason","WA","Passenger","61","67","128","43446","43574","0.2937531555514756506173406160"
"2017-06-30T00:00:00.000","Okanogan","WA","Truck","0","0","0","16208","16208","0"
"2017-06-30T00:00:00.000","Okanogan","WA","Passenger","4","17","21","25708","25729","0.08161996191068444168059388239"
"2017-06-30T00:00:00.000","Pacific","WA","Passenger","16","8","24","15138","15162","0.1582904629996042738425009893"
"2017-06-30T00:00:00.000","Pacific","WA","Truck","0","0","0","7470","7470","0"
"2017-06-30T00:00:00.000","Pend Oreille","WA","Passenger","4","4","8","9316","9324","0.08580008580008580008580008580"
"2017-06-30T00:00:00.000","Pend Oreille","WA","Truck","0","0","0","5568","5568","0"
"2017-06-30T00:00:00.000","Pierce","WA","Truck","0","0","0","137562","137562","0"
"2017-06-30T00:00:00.000","Pierce","WA","Passenger","1039","904","1943","524969","526912","0.3687522774201384671444188024"
"2017-06-30T00:00:00.000","San Juan","WA","Passenger","107","42","149","13550","13699","1.087670632892911891378932769"
"2017-06-30T00:00:00.000","San Juan","WA","Truck","0","0","0","5539","5539","0"
"2017-06-30T00:00:00.000","Skagit","WA","Truck","1","0","1","31464","31465","0.003178134435086604163356109963"
"2017-06-30T00:00:00.000","Skagit","WA","Passenger","150","118","268","88064","88332","0.3034008060499026400398496581"
"2017-06-30T00:00:00.000","Skamania","WA","Passenger","9","7","16","8567","8583","0.1864150064080158452755446813"
"2017-06-30T00:00:00.000","Skamania","WA","Truck","0","0","0","3890","3890","0"
"2017-06-30T00:00:00.000","Snohomish","WA","Passenger","1844","991","2835","513132","515967","0.5494537441347993185610707662"
"2017-06-30T00:00:00.000","Snohomish","WA","Truck","1","0","1","121901","121902","0.0008203310856261587176584469492"
"2017-06-30T00:00:00.000","Spokane","WA","Passenger","267","241","508","296813","297321","0.1708591051422536585037720174"
"2017-06-30T00:00:00.000","Spokane","WA","Truck","1","0","1","90647","90648","0.001103168299355749713176242168"
"2017-06-30T00:00:00.000","Stevens","WA","Passenger","9","25","34","31386","31420","0.1082113303628262253341820496"
"2017-06-30T00:00:00.000","Stevens","WA","Truck","0","0","0","18270","18270","0"
"2017-06-30T00:00:00.000","Thurston","WA","Truck","0","0","0","53306","53306","0"
"2017-06-30T00:00:00.000","Thurston","WA","Passenger","432","358","790","186649","187439","0.4214704517202930019899807404"
"2017-06-30T00:00:00.000","Wahkiakum","WA","Passenger","1","2","3","2831","2834","0.1058574453069865913902611150"
"2017-06-30T00:00:00.000","Wahkiakum","WA","Truck","0","0","0","1644","1644","0"
"2017-06-30T00:00:00.000","Walla Walla","WA","Passenger","25","26","51","34858","34909","0.1460941304534647225643816781"
"2017-06-30T00:00:00.000","Walla Walla","WA","Truck","0","0","0","13205","13205","0"
"2017-06-30T00:00:00.000","Whatcom","WA","Passenger","475","193","668","143071","143739","0.4647312142146529473559715874"
"2017-06-30T00:00:00.000","Whatcom","WA","Truck","2","0","2","41627","41629","0.004804343126186072209277186577"
"2017-06-30T00:00:00.000","Whitman","WA","Truck","0","0","0","8430","8430","0"
"2017-06-30T00:00:00.000","Whitman","WA","Passenger","10","21","31","22056","22087","0.1403540544211527142663104994"
"2017-06-30T00:00:00.000","Yakima","WA","Truck","0","0","0","57352","57352","0"
"2017-06-30T00:00:00.000","Yakima","WA","Passenger","50","62","112","159403","159515","0.07021283264896718176973952293"
"2017-06-30T00:00:00.000","Dane","WI","Passenger","1","0","1","102","103","0.9708737864077669902912621359"
"2017-06-30T00:00:00.000","Ozaukee","WI","Passenger","0","1","1","3","4","25.00"
"2017-06-30T00:00:00.000",,,"Passenger","3","0","3","254","257","1.167315175097276264591439689"
"2017-07-31T00:00:00.000","Juneau","AK","Passenger","0","1","1","44","45","2.222222222222222222222222222"
"2017-07-31T00:00:00.000","Dale","AL","Passenger","0","1","1","65","66","1.515151515151515151515151515"
"2017-07-31T00:00:00.000","Lee","AL","Passenger","1","0","1","36","37","2.702702702702702702702702703"
"2017-07-31T00:00:00.000","Maricopa","AZ","Passenger","3","1","4","1633","1637","0.2443494196701282834453268173"
"2017-07-31T00:00:00.000","Pima","AZ","Passenger","0","2","2","415","417","0.4796163069544364508393285372"
"2017-07-31T00:00:00.000","Pinal","AZ","Passenger","2","1","3","212","215","1.395348837209302325581395349"
"2017-07-31T00:00:00.000","Alameda","CA","Passenger","1","1","2","353","355","0.5633802816901408450704225352"
"2017-07-31T00:00:00.000","Los Angeles","CA","Passenger","2","1","3","1270","1273","0.2356637863315003927729772192"
"2017-07-31T00:00:00.000","Marin","CA","Passenger","1","0","1","56","57","1.754385964912280701754385965"
"2017-07-31T00:00:00.000","Monterey","CA","Passenger","0","2","2","200","202","0.9900990099009900990099009901"
"2017-07-31T00:00:00.000","Orange","CA","Passenger","3","1","4","621","625","0.6400"
"2017-07-31T00:00:00.000","Riverside","CA","Passenger","0","1","1","773","774","0.1291989664082687338501291990"
"2017-07-31T00:00:00.000","San Diego","CA","Passenger","6","2","8","2706","2714","0.2947678703021370670596904937"
"2017-07-31T00:00:00.000","San Mateo","CA","Passenger","0","1","1","150","151","0.6622516556291390728476821192"
"2017-07-31T00:00:00.000","Santa Clara","CA","Passenger","5","2","7","393","400","1.7500"
"2017-07-31T00:00:00.000","Tulare","CA","Passenger","1","0","1","195","196","0.5102040816326530612244897959"
"2017-07-31T00:00:00.000","Tuolumne","CA","Passenger","0","1","1","12","13","7.692307692307692307692307692"
"2017-07-31T00:00:00.000","El Paso","CO","Passenger","2","0","2","792","794","0.2518891687657430730478589421"
"2017-07-31T00:00:00.000","Larimer","CO","Passenger","0","1","1","73","74","1.351351351351351351351351351"
"2017-07-31T00:00:00.000","New London","CT","Passenger","1","1","2","268","270","0.7407407407407407407407407407"
"2017-07-31T00:00:00.000","District of Columbia","DC","Passenger","0","3","3","207","210","1.428571428571428571428571429"
"2017-07-31T00:00:00.000","Kent","DE","Passenger","0","1","1","70","71","1.408450704225352112676056338"
"2017-07-31T00:00:00.000","New Castle","DE","Passenger","1","0","1","24","25","4.00"
"2017-07-31T00:00:00.000","Duval","FL","Passenger","1","1","2","369","371","0.5390835579514824797843665768"
"2017-07-31T00:00:00.000","Manatee","FL","Passenger","1","0","1","41","42","2.380952380952380952380952381"
"2017-07-31T00:00:00.000","Miami-Dade","FL","Passenger","0","1","1","130","131","0.7633587786259541984732824427"
"2017-07-31T00:00:00.000","Okaloosa","FL","Passenger","1","0","1","180","181","0.5524861878453038674033149171"
"2017-07-31T00:00:00.000","Orange","FL","Passenger","1","1","2","128","130","1.538461538461538461538461538"
"2017-07-31T00:00:00.000","Palm Beach","FL","Passenger","0","1","1","88","89","1.123595505617977528089887640"
"2017-07-31T00:00:00.000","Polk","FL","Passenger","1","0","1","63","64","1.562500"
"2017-07-31T00:00:00.000","Santa Rosa","FL","Passenger","1","0","1","113","114","0.8771929824561403508771929825"
"2017-07-31T00:00:00.000","St. Lucie","FL","Passenger","1","0","1","29","30","3.333333333333333333333333333"
"2017-07-31T00:00:00.000","Sumter","FL","Passenger","0","1","1","10","11","9.090909090909090909090909091"
"2017-07-31T00:00:00.000","Volusia","FL","Passenger","0","1","1","44","45","2.222222222222222222222222222"
"2017-07-31T00:00:00.000","Camden","GA","Passenger","0","1","1","180","181","0.5524861878453038674033149171"
"2017-07-31T00:00:00.000","Cobb","GA","Passenger","0","1","1","71","72","1.388888888888888888888888889"
"2017-07-31T00:00:00.000","DeKalb","GA","Passenger","1","0","1","83","84","1.190476190476190476190476190"
"2017-07-31T00:00:00.000","Fulton","GA","Passenger","1","0","1","110","111","0.9009009009009009009009009009"
"2017-07-31T00:00:00.000","Gwinnett","GA","Passenger","0","1","1","84","85","1.176470588235294117647058824"
"2017-07-31T00:00:00.000","Lumpkin","GA","Passenger","1","0","1","9","10","10.0"
"2017-07-31T00:00:00.000","Honolulu","HI","Passenger","4","1","5","566","571","0.8756567425569176882661996497"
"2017-07-31T00:00:00.000","Maui","HI","Passenger","1","0","1","68","69","1.449275362318840579710144928"
"2017-07-31T00:00:00.000","Canyon","ID","Passenger","0","1","1","93","94","1.063829787234042553191489362"
"2017-07-31T00:00:00.000","Latah","ID","Passenger","0","1","1","95","96","1.041666666666666666666666667"
"2017-07-31T00:00:00.000","Madison","ID","Passenger","1","0","1","38","39","2.564102564102564102564102564"
"2017-07-31T00:00:00.000","Twin Falls","ID","Passenger","0","1","1","23","24","4.166666666666666666666666667"
"2017-07-31T00:00:00.000","Sangamon","IL","Passenger","1","0","1","11","12","8.333333333333333333333333333"
"2017-07-31T00:00:00.000","DeKalb","IN","Passenger","1","0","1","1","2","50.0"
"2017-07-31T00:00:00.000","Hamilton","IN","Passenger","1","0","1","58","59","1.694915254237288135593220339"
"2017-07-31T00:00:00.000","Hardin","KY","Passenger","0","1","1","123","124","0.8064516129032258064516129032"
"2017-07-31T00:00:00.000","Orleans","LA","Passenger","0","1","1","48","49","2.040816326530612244897959184"
"2017-07-31T00:00:00.000","Franklin","MA","Passenger","0","1","1","4","5","20.0"
"2017-07-31T00:00:00.000","Nantucket","MA","Passenger","1","0","1","2","3","33.33333333333333333333333333"
"2017-07-31T00:00:00.000","Norfolk","MA","Passenger","1","0","1","33","34","2.941176470588235294117647059"
"2017-07-31T00:00:00.000","Anne Arundel","MD","Passenger","0","1","1","508","509","0.1964636542239685658153241650"
"2017-07-31T00:00:00.000","Charles","MD","Passenger","0","1","1","86","87","1.149425287356321839080459770"
"2017-07-31T00:00:00.000","Frederick","MD","Passenger","0","1","1","82","83","1.204819277108433734939759036"
"2017-07-31T00:00:00.000","Howard","MD","Passenger","0","2","2","92","94","2.127659574468085106382978723"
"2017-07-31T00:00:00.000","Montgomery","MD","Passenger","1","1","2","309","311","0.6430868167202572347266881029"
"2017-07-31T00:00:00.000","Kent","MI","Passenger","0","1","1","36","37","2.702702702702702702702702703"
"2017-07-31T00:00:00.000","Wayne","MI","Passenger","0","1","1","69","70","1.428571428571428571428571429"
"2017-07-31T00:00:00.000","Dakota","MN","Passenger","0","1","1","34","35","2.857142857142857142857142857"
"2017-07-31T00:00:00.000","Ramsey","MN","Passenger","1","0","1","36","37","2.702702702702702702702702703"
"2017-07-31T00:00:00.000","Jackson","MO","Passenger","1","0","1","55","56","1.785714285714285714285714286"
"2017-07-31T00:00:00.000","Flathead","MT","Passenger","1","0","1","60","61","1.639344262295081967213114754"
"2017-07-31T00:00:00.000","Gallatin","MT","Passenger","0","1","1","67","68","1.470588235294117647058823529"
"2017-07-31T00:00:00.000","Glacier","MT","Passenger","0","1","1","3","4","25.00"
"2017-07-31T00:00:00.000","Missoula","MT","Passenger","1","0","1","70","71","1.408450704225352112676056338"
"2017-07-31T00:00:00.000","Moore","NC","Passenger","0","1","1","197","198","0.5050505050505050505050505051"
"2017-07-31T00:00:00.000","Carroll","NH","Passenger","0","1","1","1","2","50.0"
"2017-07-31T00:00:00.000","Bergen","NJ","Passenger","0","2","2","31","33","6.060606060606060606060606061"
"2017-07-31T00:00:00.000","Essex","NJ","Passenger","1","0","1","13","14","7.142857142857142857142857143"
"2017-07-31T00:00:00.000","Morris","NJ","Passenger","1","0","1","25","26","3.846153846153846153846153846"
"2017-07-31T00:00:00.000","Santa Fe","NM","Passenger","0","1","1","42","43","2.325581395348837209302325581"
"2017-07-31T00:00:00.000","Clark","NV","Passenger","1","2","3","798","801","0.3745318352059925093632958801"
"2017-07-31T00:00:00.000","Washoe","NV","Passenger","1","0","1","126","127","0.7874015748031496062992125984"
"2017-07-31T00:00:00.000","Jefferson","NY","Passenger","1","1","2","250","252","0.7936507936507936507936507937"
"2017-07-31T00:00:00.000","Nassau","NY","Passenger","1","1","2","38","40","5.00"
"2017-07-31T00:00:00.000","Saratoga","NY","Passenger","1","1","2","76","78","2.564102564102564102564102564"
"2017-07-31T00:00:00.000","Franklin","OH","Passenger","0","1","1","120","121","0.8264462809917355371900826446"
"2017-07-31T00:00:00.000","Deschutes","OR","Passenger","1","0","1","189","190","0.5263157894736842105263157895"
"2017-07-31T00:00:00.000","Lane","OR","Passenger","0","1","1","223","224","0.4464285714285714285714285714"
"2017-07-31T00:00:00.000","Marion","OR","Passenger","1","0","1","159","160","0.62500"
"2017-07-31T00:00:00.000","Multnomah","OR","Passenger","1","3","4","941","945","0.4232804232804232804232804233"
"2017-07-31T00:00:00.000","Allegheny","PA","Passenger","1","0","1","86","87","1.149425287356321839080459770"
"2017-07-31T00:00:00.000","Montgomery","PA","Passenger","1","0","1","36","37","2.702702702702702702702702703"
"2017-07-31T00:00:00.000","Newport","RI","Passenger","1","0","1","120","121","0.8264462809917355371900826446"
"2017-07-31T00:00:00.000","Hamilton","TN","Passenger","1","0","1","18","19","5.263157894736842105263157895"
"2017-07-31T00:00:00.000","Knox","TN","Passenger","1","0","1","37","38","2.631578947368421052631578947"
"2017-07-31T00:00:00.000","Montgomery","TN","Passenger","1","0","1","279","280","0.3571428571428571428571428571"
"2017-07-31T00:00:00.000","Shelby","TN","Passenger","0","1","1","111","112","0.8928571428571428571428571429"
"2017-07-31T00:00:00.000","Bexar","TX","Passenger","2","1","3","882","885","0.3389830508474576271186440678"
"2017-07-31T00:00:00.000","Dallas","TX","Passenger","0","1","1","172","173","0.5780346820809248554913294798"
"2017-07-31T00:00:00.000","Nueces","TX","Passenger","0","1","1","96","97","1.030927835051546391752577320"
"2017-07-31T00:00:00.000","Tarrant","TX","Passenger","1","0","1","236","237","0.4219409282700421940928270042"
"2017-07-31T00:00:00.000","Travis","TX","Passenger","0","1","1","188","189","0.5291005291005291005291005291"
"2017-07-31T00:00:00.000","Utah","UT","Passenger","0","1","1","146","147","0.6802721088435374149659863946"
"2017-07-31T00:00:00.000","Albemarle","VA","Passenger","0","1","1","32","33","3.030303030303030303030303030"
"2017-07-31T00:00:00.000","Alexandria","VA","Passenger","1","0","1","183","184","0.5434782608695652173913043478"
"2017-07-31T00:00:00.000","Arlington","VA","Passenger","1","1","2","168","170","1.176470588235294117647058824"
"2017-07-31T00:00:00.000","Fairfax","VA","Passenger","2","3","5","856","861","0.5807200929152148664343786295"
"2017-07-31T00:00:00.000","Manassas","VA","Passenger","0","1","1","9","10","10.0"
"2017-07-31T00:00:00.000","Norfolk","VA","Passenger","1","1","2","315","317","0.6309148264984227129337539432"
"2017-07-31T00:00:00.000","Portsmouth","VA","Passenger","0","1","1","59","60","1.666666666666666666666666667"
"2017-07-31T00:00:00.000","Prince William","VA","Passenger","0","3","3","264","267","1.123595505617977528089887640"
"2017-07-31T00:00:00.000","Rockbridge","VA","Passenger","1","0","1","4","5","20.0"
"2017-07-31T00:00:00.000","Virginia Beach","VA","Passenger","2","1","3","651","654","0.4587155963302752293577981651"
"2017-07-31T00:00:00.000","Adams","WA","Passenger","3","3","6","12187","12193","0.04920856228983843188714836382"
"2017-07-31T00:00:00.000","Adams","WA","Truck","0","0","0","5123","5123","0"
"2017-07-31T00:00:00.000","Asotin","WA","Passenger","8","5","13","12443","12456","0.1043673731535003211303789338"
"2017-07-31T00:00:00.000","Asotin","WA","Truck","0","0","0","6536","6536","0"
"2017-07-31T00:00:00.000","Benton","WA","Truck","0","0","0","40139","40139","0"
"2017-07-31T00:00:00.000","Benton","WA","Passenger","159","154","313","128667","128980","0.2426732826794851915025585362"
"2017-07-31T00:00:00.000","Chelan","WA","Truck","0","0","0","21339","21339","0"
"2017-07-31T00:00:00.000","Chelan","WA","Passenger","68","35","103","52147","52250","0.1971291866028708133971291866"
"2017-07-31T00:00:00.000","Clallam","WA","Passenger","99","82","181","48406","48587","0.3725276308477576306419412600"
"2017-07-31T00:00:00.000","Clallam","WA","Truck","0","0","0","21044","21044","0"
"2017-07-31T00:00:00.000","Clark","WA","Passenger","826","545","1371","299928","301299","0.4550297213067418079714834765"
"2017-07-31T00:00:00.000","Clark","WA","Truck","0","0","0","77742","77742","0"
"2017-07-31T00:00:00.000","Columbia","WA","Passenger","1","1","2","2350","2352","0.08503401360544217687074829932"
"2017-07-31T00:00:00.000","Columbia","WA","Truck","0","0","0","1533","1533","0"
"2017-07-31T00:00:00.000","Cowlitz","WA","Passenger","57","70","127","69773","69900","0.1816881258941344778254649499"
"2017-07-31T00:00:00.000","Cowlitz","WA","Truck","0","0","0","27963","27963","0"
"2017-07-31T00:00:00.000","Douglas","WA","Truck","0","0","0","11514","11514","0"
"2017-07-31T00:00:00.000","Douglas","WA","Passenger","35","26","61","26752","26813","0.2275015850520270018274717488"
"2017-07-31T00:00:00.000","Ferry","WA","Passenger","1","1","2","4401","4403","0.04542357483533954122189416307"
"2017-07-31T00:00:00.000","Ferry","WA","Truck","0","0","0","3527","3527","0"
"2017-07-31T00:00:00.000","Franklin","WA","Passenger","30","48","78","55740","55818","0.1397398688595076856927872729"
"2017-07-31T00:00:00.000","Franklin","WA","Truck","0","0","0","18174","18174","0"
"2017-07-31T00:00:00.000","Garfield","WA","Truck","0","0","0","926","926","0"
"2017-07-31T00:00:00.000","Garfield","WA","Passenger","0","0","0","1297","1297","0"
"2017-07-31T00:00:00.000","Grant","WA","Truck","0","0","0","25275","25275","0"
"2017-07-31T00:00:00.000","Grant","WA","Passenger","20","34","54","61026","61080","0.08840864440078585461689587426"
"2017-07-31T00:00:00.000","Grays Harbor","WA","Passenger","39","39","78","44836","44914","0.1736652268780335752771964198"
"2017-07-31T00:00:00.000","Grays Harbor","WA","Truck","0","0","0","19895","19895","0"
"2017-07-31T00:00:00.000","Island","WA","Passenger","129","147","276","60270","60546","0.4558517490833415915171935388"
"2017-07-31T00:00:00.000","Island","WA","Truck","0","0","0","20497","20497","0"
"2017-07-31T00:00:00.000","Jefferson","WA","Truck","0","0","0","9415","9415","0"
"2017-07-31T00:00:00.000","Jefferson","WA","Passenger","110","66","176","23896","24072","0.7311399135925556663343303423"
"2017-07-31T00:00:00.000","King","WA","Passenger","10427","4473","14900","1373283","1388183","1.073345517125623927104711699"
"2017-07-31T00:00:00.000","King","WA","Truck","8","1","9","187298","187307","0.004804945890970438905112996311"
"2017-07-31T00:00:00.000","Kitsap","WA","Truck","1","0","1","52528","52529","0.001903710331435968703002151193"
"2017-07-31T00:00:00.000","Kitsap","WA","Passenger","663","340","1003","173383","174386","0.5751608500682394228894521349"
"2017-07-31T00:00:00.000","Kittitas","WA","Passenger","25","19","44","27679","27723","0.1587129820005049958518197886"
"2017-07-31T00:00:00.000","Kittitas","WA","Truck","0","0","0","13582","13582","0"
"2017-07-31T00:00:00.000","Klickitat","WA","Passenger","25","26","51","14800","14851","0.3434112180997912598478216955"
"2017-07-31T00:00:00.000","Klickitat","WA","Truck","0","0","0","7954","7954","0"
"2017-07-31T00:00:00.000","Lewis","WA","Truck","0","0","0","24919","24919","0"
"2017-07-31T00:00:00.000","Lewis","WA","Passenger","56","46","102","55550","55652","0.1832818227556961115503485948"
"2017-07-31T00:00:00.000","Lincoln","WA","Truck","0","0","0","4445","4445","0"
"2017-07-31T00:00:00.000","Lincoln","WA","Passenger","3","6","9","7518","7527","0.1195695496213630928656835393"
"2017-07-31T00:00:00.000","Mason","WA","Passenger","63","71","134","43622","43756","0.3062437151476368955114727123"
"2017-07-31T00:00:00.000","Mason","WA","Truck","0","0","0","19265","19265","0"
"2017-07-31T00:00:00.000","Okanogan","WA","Passenger","4","18","22","25635","25657","0.08574657988073430252952410648"
"2017-07-31T00:00:00.000","Okanogan","WA","Truck","0","0","0","16230","16230","0"
"2017-07-31T00:00:00.000","Pacific","WA","Passenger","16","10","26","15190","15216","0.1708727655099894847528916930"
"2017-07-31T00:00:00.000","Pacific","WA","Truck","0","0","0","7494","7494","0"
"2017-07-31T00:00:00.000","Pend Oreille","WA","Passenger","4","4","8","9321","9329","0.08575410011791188766212884554"
"2017-07-31T00:00:00.000","Pend Oreille","WA","Truck","0","0","0","5576","5576","0"
"2017-07-31T00:00:00.000","Pierce","WA","Passenger","1090","921","2011","524579","526590","0.3818910347708843692436240719"
"2017-07-31T00:00:00.000","Pierce","WA","Truck","0","0","0","137399","137399","0"
"2017-07-31T00:00:00.000","San Juan","WA","Passenger","112","41","153","13562","13715","1.115566897557418884433102443"
"2017-07-31T00:00:00.000","San Juan","WA","Truck","0","0","0","5551","5551","0"
"2017-07-31T00:00:00.000","Skagit","WA","Truck","1","0","1","31492","31493","0.003175308798780681421268218334"
"2017-07-31T00:00:00.000","Skagit","WA","Passenger","153","119","272","88176","88448","0.3075253256150506512301013025"
"2017-07-31T00:00:00.000","Skamania","WA","Truck","0","0","0","3871","3871","0"
"2017-07-31T00:00:00.000","Skamania","WA","Passenger","9","7","16","8553","8569","0.1867195705449877465281829852"
"2017-07-31T00:00:00.000","Snohomish","WA","Truck","1","0","1","121784","121785","0.0008211191854497680338301104405"
"2017-07-31T00:00:00.000","Snohomish","WA","Passenger","1880","1012","2892","513221","516113","0.5603424056359750674755334588"
"2017-07-31T00:00:00.000","Spokane","WA","Passenger","280","246","526","296657","297183","0.1769953193823334443760242006"
"2017-07-31T00:00:00.000","Spokane","WA","Truck","1","0","1","90764","90765","0.001101746267834517710571255440"
"2017-07-31T00:00:00.000","Stevens","WA","Truck","0","0","0","18209","18209","0"
"2017-07-31T00:00:00.000","Stevens","WA","Passenger","9","25","34","31397","31431","0.1081734593235977219942095384"
"2017-07-31T00:00:00.000","Thurston","WA","Truck","0","0","0","53310","53310","0"
"2017-07-31T00:00:00.000","Thurston","WA","Passenger","459","372","831","187050","187881","0.4423012438724511792038577610"
"2017-07-31T00:00:00.000","Wahkiakum","WA","Truck","0","0","0","1659","1659","0"
"2017-07-31T00:00:00.000","Wahkiakum","WA","Passenger","1","2","3","2835","2838","0.1057082452431289640591966173"
"2017-07-31T00:00:00.000","Walla Walla","WA","Truck","0","0","0","13177","13177","0"
"2017-07-31T00:00:00.000","Walla Walla","WA","Passenger","27","26","53","34902","34955","0.1516235159490773852095551423"
"2017-07-31T00:00:00.000","Whatcom","WA","Passenger","491","196","687","143197","143884","0.4774679603013538683939840427"
"2017-07-31T00:00:00.000","Whatcom","WA","Truck","2","0","2","41669","41671","0.004799500851911401214273715534"
"2017-07-31T00:00:00.000","Whitman","WA","Truck","0","0","0","8427","8427","0"
"2017-07-31T00:00:00.000","Whitman","WA","Passenger","12","20","32","22124","22156","0.1444304025997472467954504423"
"2017-07-31T00:00:00.000","Yakima","WA","Truck","0","0","0","57468","57468","0"
"2017-07-31T00:00:00.000","Yakima","WA","Passenger","56","67","123","159655","159778","0.07698181226451701736158920502"
"2017-07-31T00:00:00.000","Dane","WI","Passenger","1","0","1","85","86","1.162790697674418604651162791"
"2017-07-31T00:00:00.000","Ozaukee","WI","Passenger","0","1","1","3","4","25.00"
"2017-07-31T00:00:00.000",,,"Passenger","3","0","3","248","251","1.195219123505976095617529880"
"2017-08-31T00:00:00.000","Juneau","AK","Passenger","0","1","1","42","43","2.325581395348837209302325581"
"2017-08-31T00:00:00.000","Dale","AL","Passenger","0","1","1","64","65","1.538461538461538461538461538"
"2017-08-31T00:00:00.000","Lee","AL","Passenger","1","0","1","36","37","2.702702702702702702702702703"
"2017-08-31T00:00:00.000","Maricopa","AZ","Passenger","3","1","4","1618","1622","0.2466091245376078914919852035"
"2017-08-31T00:00:00.000","Pima","AZ","Passenger","0","2","2","408","410","0.4878048780487804878048780488"
"2017-08-31T00:00:00.000","Pinal","AZ","Passenger","2","1","3","205","208","1.442307692307692307692307692"
"2017-08-31T00:00:00.000","Alameda","CA","Passenger","0","1","1","353","354","0.2824858757062146892655367232"
"2017-08-31T00:00:00.000","Los Angeles","CA","Passenger","2","2","4","1250","1254","0.3189792663476874003189792663"
"2017-08-31T00:00:00.000","Marin","CA","Passenger","1","0","1","56","57","1.754385964912280701754385965"
"2017-08-31T00:00:00.000","Monterey","CA","Passenger","0","2","2","196","198","1.010101010101010101010101010"
"2017-08-31T00:00:00.000","Orange","CA","Passenger","3","1","4","604","608","0.6578947368421052631578947368"
"2017-08-31T00:00:00.000","Riverside","CA","Passenger","0","2","2","755","757","0.2642007926023778071334214003"
"2017-08-31T00:00:00.000","Sacramento","CA","Passenger","1","0","1","342","343","0.2915451895043731778425655977"
"2017-08-31T00:00:00.000","San Diego","CA","Passenger","6","2","8","2673","2681","0.2983961208504289444237224916"
"2017-08-31T00:00:00.000","San Mateo","CA","Passenger","0","1","1","149","150","0.6666666666666666666666666667"
"2017-08-31T00:00:00.000","Santa Clara","CA","Passenger","5","2","7","387","394","1.776649746192893401015228426"
"2017-08-31T00:00:00.000","Tulare","CA","Passenger","1","0","1","198","199","0.5025125628140703517587939698"
"2017-08-31T00:00:00.000","Tuolumne","CA","Passenger","0","1","1","12","13","7.692307692307692307692307692"
"2017-08-31T00:00:00.000","El Paso","CO","Passenger","2","0","2","780","782","0.2557544757033248081841432225"
"2017-08-31T00:00:00.000","Larimer","CO","Passenger","0","1","1","73","74","1.351351351351351351351351351"
"2017-08-31T00:00:00.000","New London","CT","Passenger","1","1","2","270","272","0.7352941176470588235294117647"
"2017-08-31T00:00:00.000","District of Columbia","DC","Passenger","0","3","3","202","205","1.463414634146341463414634146"
"2017-08-31T00:00:00.000","Kent","DE","Passenger","0","1","1","69","70","1.428571428571428571428571429"
"2017-08-31T00:00:00.000","New Castle","DE","Passenger","1","0","1","23","24","4.166666666666666666666666667"
"2017-08-31T00:00:00.000","Duval","FL","Passenger","1","1","2","370","372","0.5376344086021505376344086022"
"2017-08-31T00:00:00.000","Manatee","FL","Passenger","1","0","1","40","41","2.439024390243902439024390244"
"2017-08-31T00:00:00.000","Miami-Dade","FL","Passenger","0","1","1","129","130","0.7692307692307692307692307692"
"2017-08-31T00:00:00.000","Okaloosa","FL","Passenger","1","0","1","181","182","0.5494505494505494505494505495"
"2017-08-31T00:00:00.000","Orange","FL","Passenger","1","1","2","141","143","1.398601398601398601398601399"
"2017-08-31T00:00:00.000","Palm Beach","FL","Passenger","0","1","1","90","91","1.098901098901098901098901099"
"2017-08-31T00:00:00.000","Polk","FL","Passenger","1","0","1","64","65","1.538461538461538461538461538"
"2017-08-31T00:00:00.000","Santa Rosa","FL","Passenger","1","0","1","111","112","0.8928571428571428571428571429"
"2017-08-31T00:00:00.000","St. Lucie","FL","Passenger","1","0","1","25","26","3.846153846153846153846153846"
"2017-08-31T00:00:00.000","Sumter","FL","Passenger","0","1","1","10","11","9.090909090909090909090909091"
"2017-08-31T00:00:00.000","Volusia","FL","Passenger","0","1","1","44","45","2.222222222222222222222222222"
"2017-08-31T00:00:00.000","Camden","GA","Passenger","0","1","1","181","182","0.5494505494505494505494505495"
"2017-08-31T00:00:00.000","Cobb","GA","Passenger","0","1","1","67","68","1.470588235294117647058823529"
"2017-08-31T00:00:00.000","Columbia","GA","Passenger","1","0","1","171","172","0.5813953488372093023255813953"
"2017-08-31T00:00:00.000","DeKalb","GA","Passenger","1","0","1","84","85","1.176470588235294117647058824"
"2017-08-31T00:00:00.000","Fulton","GA","Passenger","1","0","1","106","107","0.9345794392523364485981308411"
"2017-08-31T00:00:00.000","Gwinnett","GA","Passenger","0","1","1","87","88","1.136363636363636363636363636"
"2017-08-31T00:00:00.000","Lumpkin","GA","Passenger","1","0","1","9","10","10.0"
"2017-08-31T00:00:00.000","Honolulu","HI","Passenger","4","1","5","556","561","0.8912655971479500891265597148"
"2017-08-31T00:00:00.000","Maui","HI","Passenger","1","0","1","69","70","1.428571428571428571428571429"
"2017-08-31T00:00:00.000","Canyon","ID","Passenger","0","1","1","93","94","1.063829787234042553191489362"
"2017-08-31T00:00:00.000","Latah","ID","Passenger","0","1","1","90","91","1.098901098901098901098901099"
"2017-08-31T00:00:00.000","Madison","ID","Passenger","1","0","1","36","37","2.702702702702702702702702703"
"2017-08-31T00:00:00.000","Twin Falls","ID","Passenger","0","1","1","22","23","4.347826086956521739130434783"
"2017-08-31T00:00:00.000","Sangamon","IL","Passenger","1","0","1","11","12","8.333333333333333333333333333"
"2017-08-31T00:00:00.000","St. Clair","IL","Passenger","0","1","1","167","168","0.5952380952380952380952380952"
"2017-08-31T00:00:00.000","DeKalb","IN","Passenger","1","0","1","1","2","50.0"
"2017-08-31T00:00:00.000","Hamilton","IN","Passenger","1","0","1","59","60","1.666666666666666666666666667"
"2017-08-31T00:00:00.000","Hardin","KY","Passenger","0","1","1","124","125","0.800"
"2017-08-31T00:00:00.000","Orleans","LA","Passenger","0","1","1","45","46","2.173913043478260869565217391"
"2017-08-31T00:00:00.000","Franklin","MA","Passenger","0","1","1","4","5","20.0"
"2017-08-31T00:00:00.000","Nantucket","MA","Passenger","1","0","1","2","3","33.33333333333333333333333333"
"2017-08-31T00:00:00.000","Norfolk","MA","Passenger","1","0","1","34","35","2.857142857142857142857142857"
"2017-08-31T00:00:00.000","Anne Arundel","MD","Passenger","0","1","1","504","505","0.1980198019801980198019801980"
"2017-08-31T00:00:00.000","Charles","MD","Passenger","0","1","1","85","86","1.162790697674418604651162791"
"2017-08-31T00:00:00.000","Frederick","MD","Passenger","0","1","1","83","84","1.190476190476190476190476190"
"2017-08-31T00:00:00.000","Howard","MD","Passenger","0","2","2","89","91","2.197802197802197802197802198"
"2017-08-31T00:00:00.000","Montgomery","MD","Passenger","1","1","2","310","312","0.6410256410256410256410256410"
"2017-08-31T00:00:00.000","Kent","MI","Passenger","0","1","1","37","38","2.631578947368421052631578947"
"2017-08-31T00:00:00.000","Wayne","MI","Passenger","0","1","1","67","68","1.470588235294117647058823529"
"2017-08-31T00:00:00.000","Dakota","MN","Passenger","0","1","1","34","35","2.857142857142857142857142857"
"2017-08-31T00:00:00.000","Kanabec","MN","Passenger","1","0","1","0","1","100"
"2017-08-31T00:00:00.000","Ramsey","MN","Passenger","1","0","1","35","36","2.777777777777777777777777778"
"2017-08-31T00:00:00.000","Jackson","MO","Passenger","1","0","1","55","56","1.785714285714285714285714286"
"2017-08-31T00:00:00.000","Flathead","MT","Passenger","1","0","1","59","60","1.666666666666666666666666667"
"2017-08-31T00:00:00.000","Gallatin","MT","Passenger","0","1","1","69","70","1.428571428571428571428571429"
"2017-08-31T00:00:00.000","Glacier","MT","Passenger","0","1","1","3","4","25.00"
"2017-08-31T00:00:00.000","Missoula","MT","Passenger","1","0","1","68","69","1.449275362318840579710144928"
"2017-08-31T00:00:00.000","Moore","NC","Passenger","0","1","1","198","199","0.5025125628140703517587939698"
"2017-08-31T00:00:00.000","Carroll","NH","Passenger","0","1","1","1","2","50.0"
"2017-08-31T00:00:00.000","Bergen","NJ","Passenger","0","2","2","31","33","6.060606060606060606060606061"
"2017-08-31T00:00:00.000","Essex","NJ","Passenger","1","0","1","12","13","7.692307692307692307692307692"
"2017-08-31T00:00:00.000","Morris","NJ","Passenger","1","0","1","23","24","4.166666666666666666666666667"
"2017-08-31T00:00:00.000","Santa Fe","NM","Passenger","0","1","1","42","43","2.325581395348837209302325581"
"2017-08-31T00:00:00.000","Clark","NV","Passenger","1","2","3","781","784","0.3826530612244897959183673469"
"2017-08-31T00:00:00.000","Washoe","NV","Passenger","1","0","1","129","130","0.7692307692307692307692307692"
"2017-08-31T00:00:00.000","Jefferson","NY","Passenger","1","0","1","246","247","0.4048582995951417004048582996"
"2017-08-31T00:00:00.000","Nassau","NY","Passenger","1","1","2","38","40","5.00"
"2017-08-31T00:00:00.000","Saratoga","NY","Passenger","1","1","2","73","75","2.666666666666666666666666667"
"2017-08-31T00:00:00.000","Franklin","OH","Passenger","0","1","1","116","117","0.8547008547008547008547008547"
"2017-08-31T00:00:00.000","Deschutes","OR","Passenger","1","0","1","188","189","0.5291005291005291005291005291"
"2017-08-31T00:00:00.000","Lane","OR","Passenger","0","1","1","219","220","0.4545454545454545454545454545"
"2017-08-31T00:00:00.000","Multnomah","OR","Passenger","1","3","4","924","928","0.4310344827586206896551724138"
"2017-08-31T00:00:00.000","Allegheny","PA","Passenger","1","0","1","85","86","1.162790697674418604651162791"
"2017-08-31T00:00:00.000","Montgomery","PA","Passenger","1","0","1","37","38","2.631578947368421052631578947"
"2017-08-31T00:00:00.000","Northampton","PA","Passenger","0","1","1","98","99","1.010101010101010101010101010"
"2017-08-31T00:00:00.000","Newport","RI","Passenger","1","0","1","117","118","0.8474576271186440677966101695"
"2017-08-31T00:00:00.000","Richland","SC","Passenger","0","1","1","186","187","0.5347593582887700534759358289"
"2017-08-31T00:00:00.000","Hamilton","TN","Passenger","1","0","1","19","20","5.00"
"2017-08-31T00:00:00.000","Knox","TN","Passenger","1","0","1","37","38","2.631578947368421052631578947"
"2017-08-31T00:00:00.000","Montgomery","TN","Passenger","1","0","1","279","280","0.3571428571428571428571428571"
"2017-08-31T00:00:00.000","Shelby","TN","Passenger","0","1","1","106","107","0.9345794392523364485981308411"
"2017-08-31T00:00:00.000","Bexar","TX","Passenger","2","1","3","845","848","0.3537735849056603773584905660"
"2017-08-31T00:00:00.000","Dallas","TX","Passenger","0","1","1","173","174","0.5747126436781609195402298851"
"2017-08-31T00:00:00.000","Montgomery","TX","Passenger","1","0","1","57","58","1.724137931034482758620689655"
"2017-08-31T00:00:00.000","Nueces","TX","Passenger","0","1","1","94","95","1.052631578947368421052631579"
"2017-08-31T00:00:00.000","Tarrant","TX","Passenger","1","0","1","227","228","0.4385964912280701754385964912"
"2017-08-31T00:00:00.000","Travis","TX","Passenger","0","1","1","193","194","0.5154639175257731958762886598"
"2017-08-31T00:00:00.000","Utah","UT","Passenger","0","1","1","141","142","0.7042253521126760563380281690"
"2017-08-31T00:00:00.000","Albemarle","VA","Passenger","0","1","1","32","33","3.030303030303030303030303030"
"2017-08-31T00:00:00.000","Alexandria","VA","Passenger","1","0","1","176","177","0.5649717514124293785310734463"
"2017-08-31T00:00:00.000","Arlington","VA","Passenger","1","2","3","167","170","1.764705882352941176470588235"
"2017-08-31T00:00:00.000","Fairfax","VA","Passenger","2","3","5","847","852","0.5868544600938967136150234742"
"2017-08-31T00:00:00.000","Manassas","VA","Passenger","0","1","1","9","10","10.0"
"2017-08-31T00:00:00.000","Norfolk","VA","Passenger","1","1","2","316","318","0.6289308176100628930817610063"
"2017-08-31T00:00:00.000","Portsmouth","VA","Passenger","0","1","1","58","59","1.694915254237288135593220339"
"2017-08-31T00:00:00.000","Prince William","VA","Passenger","0","3","3","259","262","1.145038167938931297709923664"
"2017-08-31T00:00:00.000","Rockbridge","VA","Passenger","1","0","1","4","5","20.0"
"2017-08-31T00:00:00.000","Virginia Beach","VA","Passenger","2","1","3","643","646","0.4643962848297213622291021672"
"2017-08-31T00:00:00.000","Adams","WA","Truck","0","0","0","5097","5097","0"
"2017-08-31T00:00:00.000","Adams","WA","Passenger","3","3","6","12186","12192","0.04921259842519685039370078740"
"2017-08-31T00:00:00.000","Asotin","WA","Passenger","8","6","14","12448","12462","0.1123415182153747392071898572"
"2017-08-31T00:00:00.000","Asotin","WA","Truck","0","0","0","6519","6519","0"
"2017-08-31T00:00:00.000","Benton","WA","Truck","0","0","0","40177","40177","0"
"2017-08-31T00:00:00.000","Benton","WA","Passenger","166","154","320","129037","129357","0.2473774128960937560394876195"
"2017-08-31T00:00:00.000","Chelan","WA","Passenger","72","36","108","52320","52428","0.2059967956054016937514305333"
"2017-08-31T00:00:00.000","Chelan","WA","Truck","0","0","0","21373","21373","0"
"2017-08-31T00:00:00.000","Clallam","WA","Passenger","103","84","187","48534","48721","0.3838180661316475441801276657"
"2017-08-31T00:00:00.000","Clallam","WA","Truck","0","0","0","21059","21059","0"
"2017-08-31T00:00:00.000","Clark","WA","Passenger","840","558","1398","300723","302121","0.4627285094382714210531541998"
"2017-08-31T00:00:00.000","Clark","WA","Truck","0","0","0","77902","77902","0"
"2017-08-31T00:00:00.000","Columbia","WA","Passenger","1","1","2","2352","2354","0.08496176720475785896346644010"
"2017-08-31T00:00:00.000","Columbia","WA","Truck","0","0","0","1541","1541","0"
"2017-08-31T00:00:00.000","Cowlitz","WA","Passenger","56","71","127","70010","70137","0.1810741833839485578225473003"
"2017-08-31T00:00:00.000","Cowlitz","WA","Truck","0","0","0","28002","28002","0"
"2017-08-31T00:00:00.000","Douglas","WA","Passenger","35","27","62","26833","26895","0.2305261200966722439115077152"
"2017-08-31T00:00:00.000","Douglas","WA","Truck","0","0","0","11570","11570","0"
"2017-08-31T00:00:00.000","Ferry","WA","Truck","0","0","0","3533","3533","0"
"2017-08-31T00:00:00.000","Ferry","WA","Passenger","1","1","2","4397","4399","0.04546487838145032962036826551"
"2017-08-31T00:00:00.000","Franklin","WA","Passenger","32","49","81","55930","56011","0.1446144507328917534055810466"
"2017-08-31T00:00:00.000","Franklin","WA","Truck","0","0","0","18233","18233","0"
"2017-08-31T00:00:00.000","Garfield","WA","Truck","0","0","0","932","932","0"
"2017-08-31T00:00:00.000","Garfield","WA","Passenger","1","0","1","1302","1303","0.07674597083653108211818879509"
"2017-08-31T00:00:00.000","Grant","WA","Truck","0","0","0","25356","25356","0"
"2017-08-31T00:00:00.000","Grant","WA","Passenger","20","36","56","61218","61274","0.09139276038776642621666612266"
"2017-08-31T00:00:00.000","Grays Harbor","WA","Passenger","42","41","83","44949","45032","0.1843133771540238052940131462"
"2017-08-31T00:00:00.000","Grays Harbor","WA","Truck","0","0","0","19939","19939","0"
"2017-08-31T00:00:00.000","Island","WA","Passenger","135","155","290","60577","60867","0.4764486503359784448058882481"
"2017-08-31T00:00:00.000","Island","WA","Truck","0","0","0","20516","20516","0"
"2017-08-31T00:00:00.000","Jefferson","WA","Passenger","116","68","184","23957","24141","0.7621888074230562114245474504"
"2017-08-31T00:00:00.000","Jefferson","WA","Truck","0","0","0","9429","9429","0"
"2017-08-31T00:00:00.000","King","WA","Truck","7","1","8","186820","186828","0.004282013402701950457104930738"
"2017-08-31T00:00:00.000","King","WA","Passenger","10648","4565","15213","1372343","1387556","1.096388181810319727636217926"
"2017-08-31T00:00:00.000","Kitsap","WA","Truck","1","0","1","52579","52580","0.001901863826550019018638265500"
"2017-08-31T00:00:00.000","Kitsap","WA","Passenger","682","353","1035","173823","174858","0.5919088631918470987887314278"
"2017-08-31T00:00:00.000","Kittitas","WA","Passenger","28","21","49","27891","27940","0.1753758052970651395848246242"
"2017-08-31T00:00:00.000","Kittitas","WA","Truck","0","0","0","13611","13611","0"
"2017-08-31T00:00:00.000","Klickitat","WA","Passenger","24","26","50","14779","14829","0.3371771528761211140333131027"
"2017-08-31T00:00:00.000","Klickitat","WA","Truck","0","0","0","7971","7971","0"
"2017-08-31T00:00:00.000","Lewis","WA","Truck","0","0","0","25017","25017","0"
"2017-08-31T00:00:00.000","Lewis","WA","Passenger","59","48","107","55789","55896","0.1914269357377987691426935738"
"2017-08-31T00:00:00.000","Lincoln","WA","Passenger","3","6","9","7570","7579","0.1187491753529489378545982320"
"2017-08-31T00:00:00.000","Lincoln","WA","Truck","0","0","0","4458","4458","0"
"2017-08-31T00:00:00.000","Mason","WA","Passenger","69","73","142","43910","44052","0.3223463179878325615182057568"
"2017-08-31T00:00:00.000","Mason","WA","Truck","0","0","0","19339","19339","0"
"2017-08-31T00:00:00.000","Okanogan","WA","Passenger","5","18","23","25673","25696","0.08950809464508094645080946451"
"2017-08-31T00:00:00.000","Okanogan","WA","Truck","0","0","0","16248","16248","0"
"2017-08-31T00:00:00.000","Pacific","WA","Truck","0","0","0","7514","7514","0"
"2017-08-31T00:00:00.000","Pacific","WA","Passenger","17","10","27","15241","15268","0.1768404506156667539952842547"
"2017-08-31T00:00:00.000","Pend Oreille","WA","Truck","0","0","0","5546","5546","0"
"2017-08-31T00:00:00.000","Pend Oreille","WA","Passenger","4","4","8","9357","9365","0.08542445274959957287773625200"
"2017-08-31T00:00:00.000","Pierce","WA","Passenger","1136","933","2069","524878","526947","0.3926391079178740935995460644"
"2017-08-31T00:00:00.000","Pierce","WA","Truck","0","0","0","137259","137259","0"
"2017-08-31T00:00:00.000","San Juan","WA","Passenger","113","41","154","13644","13798","1.116103783156979272358312799"
"2017-08-31T00:00:00.000","San Juan","WA","Truck","0","0","0","5553","5553","0"
"2017-08-31T00:00:00.000","Skagit","WA","Passenger","153","127","280","88466","88746","0.3155071777882946837040542672"
"2017-08-31T00:00:00.000","Skagit","WA","Truck","1","0","1","31522","31523","0.003172286901627383180534847572"
"2017-08-31T00:00:00.000","Skamania","WA","Passenger","11","7","18","8571","8589","0.2095703807195249738037024101"
"2017-08-31T00:00:00.000","Skamania","WA","Truck","0","0","0","3874","3874","0"
"2017-08-31T00:00:00.000","Snohomish","WA","Truck","1","0","1","121681","121682","0.0008218142371098436909321017077"
"2017-08-31T00:00:00.000","Snohomish","WA","Passenger","1928","1034","2962","513649","516611","0.5733520966452514561246276212"
"2017-08-31T00:00:00.000","Spokane","WA","Truck","1","0","1","91016","91017","0.001098695848028390300713053605"
"2017-08-31T00:00:00.000","Spokane","WA","Passenger","292","252","544","297411","297955","0.1825779060596398785051433941"
"2017-08-31T00:00:00.000","Stevens","WA","Passenger","10","24","34","31516","31550","0.1077654516640253565768621236"
"2017-08-31T00:00:00.000","Stevens","WA","Truck","0","0","0","18214","18214","0"
"2017-08-31T00:00:00.000","Thurston","WA","Passenger","468","382","850","187754","188604","0.4506797310767534092596127336"
"2017-08-31T00:00:00.000","Thurston","WA","Truck","0","0","0","53442","53442","0"
"2017-08-31T00:00:00.000","Wahkiakum","WA","Passenger","2","2","4","2832","2836","0.1410437235543018335684062059"
"2017-08-31T00:00:00.000","Wahkiakum","WA","Truck","0","0","0","1655","1655","0"
"2017-08-31T00:00:00.000","Walla Walla","WA","Passenger","27","27","54","34996","35050","0.1540656205420827389443651926"
"2017-08-31T00:00:00.000","Walla Walla","WA","Truck","0","0","0","13188","13188","0"
"2017-08-31T00:00:00.000","Whatcom","WA","Passenger","502","198","700","143564","144264","0.4852215382909111074141851051"
"2017-08-31T00:00:00.000","Whatcom","WA","Truck","2","0","2","41773","41775","0.004787552363853979652902453621"
"2017-08-31T00:00:00.000","Whitman","WA","Passenger","11","23","34","22145","22179","0.1532981649307903873033049281"
"2017-08-31T00:00:00.000","Whitman","WA","Truck","0","0","0","8453","8453","0"
"2017-08-31T00:00:00.000","Yakima","WA","Passenger","62","72","134","160152","160286","0.08360056399186454213094094306"
"2017-08-31T00:00:00.000","Yakima","WA","Truck","0","0","0","57642","57642","0"
"2017-08-31T00:00:00.000","Ozaukee","WI","Passenger","0","1","1","3","4","25.00"
"2017-08-31T00:00:00.000",,,"Passenger","3","0","3","244","247","1.214574898785425101214574899"
"2017-09-30T00:00:00.000","Juneau","AK","Passenger","0","1","1","44","45","2.222222222222222222222222222"
"2017-09-30T00:00:00.000","Dale","AL","Passenger","0","1","1","64","65","1.538461538461538461538461538"
"2017-09-30T00:00:00.000","Lee","AL","Passenger","1","0","1","34","35","2.857142857142857142857142857"
"2017-09-30T00:00:00.000","Maricopa","AZ","Passenger","3","1","4","1575","1579","0.2533248891703609879670677644"
"2017-09-30T00:00:00.000","Pima","AZ","Passenger","0","1","1","408","409","0.2444987775061124694376528117"
"2017-09-30T00:00:00.000","Pinal","AZ","Passenger","2","0","2","205","207","0.9661835748792270531400966184"
"2017-09-30T00:00:00.000","Alameda","CA","Passenger","0","1","1","346","347","0.2881844380403458213256484150"
"2017-09-30T00:00:00.000","Contra Costa","CA","Passenger","0","1","1","525","526","0.1901140684410646387832699620"
"2017-09-30T00:00:00.000","Los Angeles","CA","Passenger","4","2","6","1234","1240","0.4838709677419354838709677419"
"2017-09-30T00:00:00.000","Marin","CA","Passenger","1","0","1","57","58","1.724137931034482758620689655"
"2017-09-30T00:00:00.000","Monterey","CA","Passenger","0","2","2","196","198","1.010101010101010101010101010"
"2017-09-30T00:00:00.000","Orange","CA","Passenger","3","1","4","601","605","0.6611570247933884297520661157"
"2017-09-30T00:00:00.000","Riverside","CA","Passenger","0","2","2","737","739","0.2706359945872801082543978349"
"2017-09-30T00:00:00.000","Sacramento","CA","Passenger","1","0","1","328","329","0.3039513677811550151975683891"
"2017-09-30T00:00:00.000","San Diego","CA","Passenger","6","2","8","2653","2661","0.3006388575723412251033446073"
"2017-09-30T00:00:00.000","San Mateo","CA","Passenger","0","1","1","146","147","0.6802721088435374149659863946"
"2017-09-30T00:00:00.000","Santa Clara","CA","Passenger","5","2","7","382","389","1.799485861182519280205655527"
"2017-09-30T00:00:00.000","Tulare","CA","Passenger","1","0","1","198","199","0.5025125628140703517587939698"
"2017-09-30T00:00:00.000","Tuolumne","CA","Passenger","0","1","1","12","13","7.692307692307692307692307692"
"2017-09-30T00:00:00.000","El Paso","CO","Passenger","2","0","2","777","779","0.2567394094993581514762516046"
"2017-09-30T00:00:00.000","Larimer","CO","Passenger","0","1","1","70","71","1.408450704225352112676056338"
"2017-09-30T00:00:00.000","New London","CT","Passenger","1","1","2","266","268","0.7462686567164179104477611940"
"2017-09-30T00:00:00.000","District of Columbia","DC","Passenger","0","3","3","200","203","1.477832512315270935960591133"
"2017-09-30T00:00:00.000","Kent","DE","Passenger","0","1","1","70","71","1.408450704225352112676056338"
"2017-09-30T00:00:00.000","New Castle","DE","Passenger","1","0","1","23","24","4.166666666666666666666666667"
"2017-09-30T00:00:00.000","Clay","FL","Passenger","0","1","1","111","112","0.8928571428571428571428571429"
"2017-09-30T00:00:00.000","Duval","FL","Passenger","1","1","2","361","363","0.5509641873278236914600550964"
"2017-09-30T00:00:00.000","Manatee","FL","Passenger","1","0","1","40","41","2.439024390243902439024390244"
"2017-09-30T00:00:00.000","Miami-Dade","FL","Passenger","0","1","1","124","125","0.800"
"2017-09-30T00:00:00.000","Okaloosa","FL","Passenger","1","0","1","183","184","0.5434782608695652173913043478"
"2017-09-30T00:00:00.000","Orange","FL","Passenger","1","1","2","141","143","1.398601398601398601398601399"
"2017-09-30T00:00:00.000","Palm Beach","FL","Passenger","0","1","1","88","89","1.123595505617977528089887640"
"2017-09-30T00:00:00.000","Polk","FL","Passenger","1","0","1","62","63","1.587301587301587301587301587"
"2017-09-30T00:00:00.000","Santa Rosa","FL","Passenger","1","0","1","110","111","0.9009009009009009009009009009"
"2017-09-30T00:00:00.000","St. Lucie","FL","Passenger","1","0","1","24","25","4.00"
"2017-09-30T00:00:00.000","Sumter","FL","Passenger","0","1","1","10","11","9.090909090909090909090909091"
"2017-09-30T00:00:00.000","Volusia","FL","Passenger","0","1","1","41","42","2.380952380952380952380952381"
"2017-09-30T00:00:00.000","Camden","GA","Passenger","0","1","1","177","178","0.5617977528089887640449438202"
"2017-09-30T00:00:00.000","Cobb","GA","Passenger","0","1","1","62","63","1.587301587301587301587301587"
"2017-09-30T00:00:00.000","Columbia","GA","Passenger","1","0","1","169","170","0.5882352941176470588235294118"
"2017-09-30T00:00:00.000","DeKalb","GA","Passenger","1","0","1","81","82","1.219512195121951219512195122"
"2017-09-30T00:00:00.000","Fulton","GA","Passenger","1","0","1","107","108","0.9259259259259259259259259259"
"2017-09-30T00:00:00.000","Gwinnett","GA","Passenger","0","1","1","87","88","1.136363636363636363636363636"
"2017-09-30T00:00:00.000","Liberty","GA","Passenger","1","0","1","157","158","0.6329113924050632911392405063"
"2017-09-30T00:00:00.000","Lumpkin","GA","Passenger","1","0","1","9","10","10.0"
"2017-09-30T00:00:00.000","Honolulu","HI","Passenger","3","1","4","556","560","0.7142857142857142857142857143"
"2017-09-30T00:00:00.000","Maui","HI","Passenger","1","0","1","70","71","1.408450704225352112676056338"
"2017-09-30T00:00:00.000","Canyon","ID","Passenger","0","1","1","88","89","1.123595505617977528089887640"
"2017-09-30T00:00:00.000","Latah","ID","Passenger","0","1","1","89","90","1.111111111111111111111111111"
"2017-09-30T00:00:00.000","Madison","ID","Passenger","1","0","1","36","37","2.702702702702702702702702703"
"2017-09-30T00:00:00.000","Twin Falls","ID","Passenger","0","1","1","22","23","4.347826086956521739130434783"
"2017-09-30T00:00:00.000","Sangamon","IL","Passenger","1","0","1","11","12","8.333333333333333333333333333"
"2017-09-30T00:00:00.000","St. Clair","IL","Passenger","0","1","1","164","165","0.6060606060606060606060606061"
"2017-09-30T00:00:00.000","DeKalb","IN","Passenger","1","0","1","1","2","50.0"
"2017-09-30T00:00:00.000","Hamilton","IN","Passenger","1","0","1","59","60","1.666666666666666666666666667"
"2017-09-30T00:00:00.000","Hardin","KY","Passenger","0","1","1","119","120","0.8333333333333333333333333333"
"2017-09-30T00:00:00.000","Orleans","LA","Passenger","0","1","1","46","47","2.127659574468085106382978723"
"2017-09-30T00:00:00.000","Franklin","MA","Passenger","0","1","1","4","5","20.0"
"2017-09-30T00:00:00.000","Nantucket","MA","Passenger","1","0","1","2","3","33.33333333333333333333333333"
"2017-09-30T00:00:00.000","Norfolk","MA","Passenger","1","0","1","34","35","2.857142857142857142857142857"
"2017-09-30T00:00:00.000","Anne Arundel","MD","Passenger","0","1","1","501","502","0.1992031872509960159362549801"
"2017-09-30T00:00:00.000","Charles","MD","Passenger","0","1","1","84","85","1.176470588235294117647058824"
"2017-09-30T00:00:00.000","Frederick","MD","Passenger","0","1","1","84","85","1.176470588235294117647058824"
"2017-09-30T00:00:00.000","Howard","MD","Passenger","0","2","2","88","90","2.222222222222222222222222222"
"2017-09-30T00:00:00.000","Montgomery","MD","Passenger","1","1","2","309","311","0.6430868167202572347266881029"
"2017-09-30T00:00:00.000","Kent","MI","Passenger","0","1","1","35","36","2.777777777777777777777777778"
"2017-09-30T00:00:00.000","Wayne","MI","Passenger","0","1","1","67","68","1.470588235294117647058823529"
"2017-09-30T00:00:00.000","Dakota","MN","Passenger","0","1","1","34","35","2.857142857142857142857142857"
"2017-09-30T00:00:00.000","Kanabec","MN","Passenger","1","0","1","0","1","100"
"2017-09-30T00:00:00.000","Ramsey","MN","Passenger","1","0","1","36","37","2.702702702702702702702702703"
"2017-09-30T00:00:00.000","Flathead","MT","Passenger","1","0","1","56","57","1.754385964912280701754385965"
"2017-09-30T00:00:00.000","Gallatin","MT","Passenger","0","1","1","65","66","1.515151515151515151515151515"
"2017-09-30T00:00:00.000","Glacier","MT","Passenger","0","1","1","3","4","25.00"
"2017-09-30T00:00:00.000","Missoula","MT","Passenger","1","0","1","68","69","1.449275362318840579710144928"
"2017-09-30T00:00:00.000","Moore","NC","Passenger","0","1","1","200","201","0.4975124378109452736318407960"
"2017-09-30T00:00:00.000","Carroll","NH","Passenger","0","1","1","1","2","50.0"
"2017-09-30T00:00:00.000","Essex","NJ","Passenger","1","0","1","12","13","7.692307692307692307692307692"
"2017-09-30T00:00:00.000","Morris","NJ","Passenger","1","0","1","22","23","4.347826086956521739130434783"
"2017-09-30T00:00:00.000","Santa Fe","NM","Passenger","0","1","1","41","42","2.380952380952380952380952381"
"2017-09-30T00:00:00.000","Clark","NV","Passenger","1","2","3","761","764","0.3926701570680628272251308901"
"2017-09-30T00:00:00.000","Washoe","NV","Passenger","1","0","1","126","127","0.7874015748031496062992125984"
"2017-09-30T00:00:00.000","Jefferson","NY","Passenger","1","0","1","244","245","0.4081632653061224489795918367"
"2017-09-30T00:00:00.000","Nassau","NY","Passenger","1","1","2","38","40","5.00"
"2017-09-30T00:00:00.000","Saratoga","NY","Passenger","1","1","2","73","75","2.666666666666666666666666667"
"2017-09-30T00:00:00.000","Franklin","OH","Passenger","0","1","1","113","114","0.8771929824561403508771929825"
"2017-09-30T00:00:00.000","Oklahoma","OK","Passenger","0","1","1","126","127","0.7874015748031496062992125984"
"2017-09-30T00:00:00.000","Deschutes","OR","Passenger","1","0","1","186","187","0.5347593582887700534759358289"
"2017-09-30T00:00:00.000","Lane","OR","Passenger","0","1","1","214","215","0.4651162790697674418604651163"
"2017-09-30T00:00:00.000","Multnomah","OR","Passenger","1","3","4","911","915","0.4371584699453551912568306011"
"2017-09-30T00:00:00.000","Allegheny","PA","Passenger","1","0","1","83","84","1.190476190476190476190476190"
"2017-09-30T00:00:00.000","Montgomery","PA","Passenger","1","0","1","34","35","2.857142857142857142857142857"
"2017-09-30T00:00:00.000","Northampton","PA","Passenger","0","1","1","84","85","1.176470588235294117647058824"
"2017-09-30T00:00:00.000","Newport","RI","Passenger","1","0","1","116","117","0.8547008547008547008547008547"
"2017-09-30T00:00:00.000","Richland","SC","Passenger","0","1","1","183","184","0.5434782608695652173913043478"
"2017-09-30T00:00:00.000","Hamilton","TN","Passenger","1","0","1","20","21","4.761904761904761904761904762"
"2017-09-30T00:00:00.000","Knox","TN","Passenger","1","0","1","38","39","2.564102564102564102564102564"
"2017-09-30T00:00:00.000","Montgomery","TN","Passenger","1","0","1","274","275","0.3636363636363636363636363636"
"2017-09-30T00:00:00.000","Shelby","TN","Passenger","0","1","1","109","110","0.9090909090909090909090909091"
"2017-09-30T00:00:00.000","Bexar","TX","Passenger","2","1","3","830","833","0.3601440576230492196878751501"
"2017-09-30T00:00:00.000","Dallas","TX","Passenger","0","1","1","171","172","0.5813953488372093023255813953"
"2017-09-30T00:00:00.000","El Paso","TX","Passenger","1","0","1","552","553","0.1808318264014466546112115732"
"2017-09-30T00:00:00.000","Montgomery","TX","Passenger","1","0","1","57","58","1.724137931034482758620689655"
"2017-09-30T00:00:00.000","Nueces","TX","Passenger","0","1","1","93","94","1.063829787234042553191489362"
"2017-09-30T00:00:00.000","Tarrant","TX","Passenger","1","0","1","228","229","0.4366812227074235807860262009"
"2017-09-30T00:00:00.000","Travis","TX","Passenger","0","1","1","189","190","0.5263157894736842105263157895"
"2017-09-30T00:00:00.000","Utah","UT","Passenger","0","1","1","139","140","0.7142857142857142857142857143"
"2017-09-30T00:00:00.000","Albemarle","VA","Passenger","0","1","1","32","33","3.030303030303030303030303030"
"2017-09-30T00:00:00.000","Alexandria","VA","Passenger","1","0","1","170","171","0.5847953216374269005847953216"
"2017-09-30T00:00:00.000","Arlington","VA","Passenger","1","2","3","164","167","1.796407185628742514970059880"
"2017-09-30T00:00:00.000","Fairfax","VA","Passenger","2","3","5","851","856","0.5841121495327102803738317757"
"2017-09-30T00:00:00.000","Manassas","VA","Passenger","0","1","1","9","10","10.0"
"2017-09-30T00:00:00.000","Norfolk","VA","Passenger","1","1","2","315","317","0.6309148264984227129337539432"
"2017-09-30T00:00:00.000","Portsmouth","VA","Passenger","0","1","1","59","60","1.666666666666666666666666667"
"2017-09-30T00:00:00.000","Prince William","VA","Passenger","0","3","3","260","263","1.140684410646387832699619772"
"2017-09-30T00:00:00.000","Rockbridge","VA","Passenger","1","0","1","3","4","25.00"
"2017-09-30T00:00:00.000","Virginia Beach","VA","Passenger","2","1","3","654","657","0.4566210045662100456621004566"
"2017-09-30T00:00:00.000","Adams","WA","Passenger","3","3","6","12266","12272","0.04889178617992177314211212516"
"2017-09-30T00:00:00.000","Adams","WA","Truck","0","0","0","5122","5122","0"
"2017-09-30T00:00:00.000","Asotin","WA","Passenger","7","6","13","12467","12480","0.1041666666666666666666666667"
"2017-09-30T00:00:00.000","Asotin","WA","Truck","0","0","0","6512","6512","0"
"2017-09-30T00:00:00.000","Benton","WA","Passenger","169","157","326","129254","129580","0.2515820342645469979935175181"
"2017-09-30T00:00:00.000","Benton","WA","Truck","0","0","0","40285","40285","0"
"2017-09-30T00:00:00.000","Chelan","WA","Truck","0","0","0","21424","21424","0"
"2017-09-30T00:00:00.000","Chelan","WA","Passenger","75","37","112","52513","52625","0.2128266033254156769596199525"
"2017-09-30T00:00:00.000","Clallam","WA","Truck","0","0","0","21086","21086","0"
"2017-09-30T00:00:00.000","Clallam","WA","Passenger","102","88","190","48599","48789","0.3894320441083031011088565045"
"2017-09-30T00:00:00.000","Clark","WA","Truck","0","0","0","77875","77875","0"
"2017-09-30T00:00:00.000","Clark","WA","Passenger","865","573","1438","301346","302784","0.4749260198689494821390826464"
"2017-09-30T00:00:00.000","Columbia","WA","Passenger","1","1","2","2378","2380","0.08403361344537815126050420168"
"2017-09-30T00:00:00.000","Columbia","WA","Truck","0","0","0","1557","1557","0"
"2017-09-30T00:00:00.000","Cowlitz","WA","Truck","0","0","0","28053","28053","0"
"2017-09-30T00:00:00.000","Cowlitz","WA","Passenger","61","73","134","70265","70399","0.1903436128354095938862767937"
"2017-09-30T00:00:00.000","Douglas","WA","Passenger","35","29","64","26924","26988","0.2371424336742255817400326071"
"2017-09-30T00:00:00.000","Douglas","WA","Truck","0","0","0","11592","11592","0"
"2017-09-30T00:00:00.000","Ferry","WA","Truck","0","0","0","3538","3538","0"
"2017-09-30T00:00:00.000","Ferry","WA","Passenger","1","1","2","4381","4383","0.04563084645220168834131873146"
"2017-09-30T00:00:00.000","Franklin","WA","Passenger","36","49","85","56182","56267","0.1510654557733662715268274477"
"2017-09-30T00:00:00.000","Franklin","WA","Truck","0","0","0","18247","18247","0"
"2017-09-30T00:00:00.000","Garfield","WA","Passenger","1","0","1","1295","1296","0.07716049382716049382716049383"
"2017-09-30T00:00:00.000","Garfield","WA","Truck","0","0","0","940","940","0"
"2017-09-30T00:00:00.000","Grant","WA","Passenger","21","37","58","61482","61540","0.09424764380890477738056548586"
"2017-09-30T00:00:00.000","Grant","WA","Truck","0","0","0","25428","25428","0"
"2017-09-30T00:00:00.000","Grays Harbor","WA","Truck","0","0","0","19981","19981","0"
"2017-09-30T00:00:00.000","Grays Harbor","WA","Passenger","44","43","87","45113","45200","0.1924778761061946902654867257"
"2017-09-30T00:00:00.000","Island","WA","Truck","0","0","0","20561","20561","0"
"2017-09-30T00:00:00.000","Island","WA","Passenger","141","155","296","60846","61142","0.4841189362467698145301102352"
"2017-09-30T00:00:00.000","Jefferson","WA","Passenger","120","69","189","24011","24200","0.7809917355371900826446280992"
"2017-09-30T00:00:00.000","Jefferson","WA","Truck","0","0","0","9421","9421","0"
"2017-09-30T00:00:00.000","King","WA","Passenger","10889","4641","15530","1372493","1388023","1.118857540545077423068637912"
"2017-09-30T00:00:00.000","King","WA","Truck","7","1","8","186415","186423","0.004291315985688461187728981939"
"2017-09-30T00:00:00.000","Kitsap","WA","Passenger","704","362","1066","174298","175364","0.6078784699254122853037111380"
"2017-09-30T00:00:00.000","Kitsap","WA","Truck","1","0","1","52615","52616","0.001900562566519689828189143987"
"2017-09-30T00:00:00.000","Kittitas","WA","Passenger","34","21","55","27987","28042","0.1961343698737607873903430568"
"2017-09-30T00:00:00.000","Kittitas","WA","Truck","0","0","0","13659","13659","0"
"2017-09-30T00:00:00.000","Klickitat","WA","Passenger","25","28","53","14771","14824","0.3575283324338909875876956287"
"2017-09-30T00:00:00.000","Klickitat","WA","Truck","0","0","0","7989","7989","0"
"2017-09-30T00:00:00.000","Lewis","WA","Truck","0","0","0","25116","25116","0"
"2017-09-30T00:00:00.000","Lewis","WA","Passenger","57","48","105","56015","56120","0.1870990734141126158232359230"
"2017-09-30T00:00:00.000","Lincoln","WA","Passenger","4","7","11","7562","7573","0.1452528720454245345305691272"
"2017-09-30T00:00:00.000","Lincoln","WA","Truck","0","0","0","4473","4473","0"
"2017-09-30T00:00:00.000","Mason","WA","Truck","0","0","0","19383","19383","0"
"2017-09-30T00:00:00.000","Mason","WA","Passenger","71","74","145","44158","44303","0.3272916055346139087646434779"
"2017-09-30T00:00:00.000","Okanogan","WA","Truck","0","0","0","16241","16241","0"
"2017-09-30T00:00:00.000","Okanogan","WA","Passenger","6","18","24","25684","25708","0.09335615372646646958145324413"
"2017-09-30T00:00:00.000","Pacific","WA","Passenger","19","10","29","15256","15285","0.1897284919856068040562643114"
"2017-09-30T00:00:00.000","Pacific","WA","Truck","0","0","0","7513","7513","0"
"2017-09-30T00:00:00.000","Pend Oreille","WA","Passenger","4","4","8","9370","9378","0.08530603540200469183194711026"
"2017-09-30T00:00:00.000","Pend Oreille","WA","Truck","0","0","0","5546","5546","0"
"2017-09-30T00:00:00.000","Pierce","WA","Truck","0","0","0","137105","137105","0"
"2017-09-30T00:00:00.000","Pierce","WA","Passenger","1162","968","2130","525102","527232","0.4039967225054624908958485069"
"2017-09-30T00:00:00.000","San Juan","WA","Passenger","117","44","161","13675","13836","1.163631107256432494940734316"
"2017-09-30T00:00:00.000","San Juan","WA","Truck","0","0","0","5562","5562","0"
"2017-09-30T00:00:00.000","Skagit","WA","Truck","1","0","1","31558","31559","0.003168668208751861592572641719"
"2017-09-30T00:00:00.000","Skagit","WA","Passenger","166","135","301","88639","88940","0.3384304025185518326961996852"
"2017-09-30T00:00:00.000","Skamania","WA","Passenger","11","7","18","8571","8589","0.2095703807195249738037024101"
"2017-09-30T00:00:00.000","Skamania","WA","Truck","0","0","0","3876","3876","0"
"2017-09-30T00:00:00.000","Snohomish","WA","Truck","1","0","1","121538","121539","0.0008227811648935732563210162993"
"2017-09-30T00:00:00.000","Snohomish","WA","Passenger","2004","1066","3070","514294","517364","0.5933926597134705932380297044"
"2017-09-30T00:00:00.000","Spokane","WA","Truck","1","0","1","91192","91193","0.001096575395041286063623304420"
"2017-09-30T00:00:00.000","Spokane","WA","Passenger","301","260","561","298156","298717","0.1878031715637208461520435730"
"2017-09-30T00:00:00.000","Stevens","WA","Truck","0","0","0","18246","18246","0"
"2017-09-30T00:00:00.000","Stevens","WA","Passenger","10","24","34","31546","31580","0.1076630778974034198860037999"
"2017-09-30T00:00:00.000","Thurston","WA","Passenger","489","386","875","188224","189099","0.4627205855134083205093628205"
"2017-09-30T00:00:00.000","Thurston","WA","Truck","0","0","0","53512","53512","0"
"2017-09-30T00:00:00.000","Wahkiakum","WA","Truck","0","0","0","1667","1667","0"
"2017-09-30T00:00:00.000","Wahkiakum","WA","Passenger","2","2","4","2834","2838","0.1409443269908386187455954898"
"2017-09-30T00:00:00.000","Walla Walla","WA","Truck","0","0","0","13243","13243","0"
"2017-09-30T00:00:00.000","Walla Walla","WA","Passenger","27","28","55","35051","35106","0.1566683757762205890730929186"
"2017-09-30T00:00:00.000","Whatcom","WA","Passenger","523","204","727","143860","144587","0.5028114560783472926335009372"
"2017-09-30T00:00:00.000","Whatcom","WA","Truck","2","0","2","41846","41848","0.004779200917606576180462626649"
"2017-09-30T00:00:00.000","Whitman","WA","Truck","0","0","0","8430","8430","0"
"2017-09-30T00:00:00.000","Whitman","WA","Passenger","12","24","36","22210","22246","0.1618268452755551559830980850"
"2017-09-30T00:00:00.000","Yakima","WA","Passenger","66","74","140","160619","160759","0.08708688160538445747983005617"
"2017-09-30T00:00:00.000","Yakima","WA","Truck","0","0","0","57707","57707","0"
"2017-09-30T00:00:00.000","Ozaukee","WI","Passenger","0","1","1","2","3","33.33333333333333333333333333"
"2017-09-30T00:00:00.000",,,"Passenger","3","0","3","246","249","1.204819277108433734939759036"
"2017-10-31T00:00:00.000","Juneau","AK","Passenger","0","1","1","44","45","2.222222222222222222222222222"
"2017-10-31T00:00:00.000","Dale","AL","Passenger","0","1","1","63","64","1.562500"
"2017-10-31T00:00:00.000","Lee","AL","Passenger","1","0","1","35","36","2.777777777777777777777777778"
"2017-10-31T00:00:00.000","Maricopa","AZ","Passenger","3","1","4","1551","1555","0.2572347266881028938906752412"
"2017-10-31T00:00:00.000","Pima","AZ","Passenger","0","1","1","403","404","0.2475247524752475247524752475"
"2017-10-31T00:00:00.000","Pinal","AZ","Passenger","2","0","2","202","204","0.9803921568627450980392156863"
"2017-10-31T00:00:00.000","Alameda","CA","Passenger","0","1","1","348","349","0.2865329512893982808022922636"
"2017-10-31T00:00:00.000","Contra Costa","CA","Passenger","0","1","1","508","509","0.1964636542239685658153241650"
"2017-10-31T00:00:00.000","Los Angeles","CA","Passenger","4","2","6","1220","1226","0.4893964110929853181076672104"
"2017-10-31T00:00:00.000","Marin","CA","Passenger","1","0","1","56","57","1.754385964912280701754385965"
"2017-10-31T00:00:00.000","Monterey","CA","Passenger","0","2","2","193","195","1.025641025641025641025641026"
"2017-10-31T00:00:00.000","Orange","CA","Passenger","3","1","4","594","598","0.6688963210702341137123745819"
"2017-10-31T00:00:00.000","Riverside","CA","Passenger","0","2","2","728","730","0.2739726027397260273972602740"
"2017-10-31T00:00:00.000","Sacramento","CA","Passenger","1","0","1","320","321","0.3115264797507788161993769470"
"2017-10-31T00:00:00.000","San Diego","CA","Passenger","5","2","7","2626","2633","0.2658564375237371819217622484"
"2017-10-31T00:00:00.000","San Mateo","CA","Passenger","0","1","1","148","149","0.6711409395973154362416107383"
"2017-10-31T00:00:00.000","Santa Clara","CA","Passenger","6","1","7","379","386","1.813471502590673575129533679"
"2017-10-31T00:00:00.000","Tulare","CA","Passenger","1","0","1","194","195","0.5128205128205128205128205128"
"2017-10-31T00:00:00.000","Tuolumne","CA","Passenger","0","1","1","12","13","7.692307692307692307692307692"
"2017-10-31T00:00:00.000","Ventura","CA","Passenger","0","1","1","337","338","0.2958579881656804733727810651"
"2017-10-31T00:00:00.000","El Paso","CO","Passenger","2","0","2","772","774","0.2583979328165374677002583979"
"2017-10-31T00:00:00.000","Larimer","CO","Passenger","0","1","1","69","70","1.428571428571428571428571429"
"2017-10-31T00:00:00.000","New London","CT","Passenger","1","1","2","264","266","0.7518796992481203007518796992"
"2017-10-31T00:00:00.000","District of Columbia","DC","Passenger","0","4","4","201","205","1.951219512195121951219512195"
"2017-10-31T00:00:00.000","Kent","DE","Passenger","0","1","1","71","72","1.388888888888888888888888889"
"2017-10-31T00:00:00.000","New Castle","DE","Passenger","1","0","1","25","26","3.846153846153846153846153846"
"2017-10-31T00:00:00.000","Clay","FL","Passenger","0","1","1","110","111","0.9009009009009009009009009009"
"2017-10-31T00:00:00.000","Duval","FL","Passenger","1","1","2","362","364","0.5494505494505494505494505495"
"2017-10-31T00:00:00.000","Manatee","FL","Passenger","1","0","1","40","41","2.439024390243902439024390244"
"2017-10-31T00:00:00.000","Miami-Dade","FL","Passenger","0","1","1","123","124","0.8064516129032258064516129032"
"2017-10-31T00:00:00.000","Okaloosa","FL","Passenger","1","0","1","183","184","0.5434782608695652173913043478"
"2017-10-31T00:00:00.000","Orange","FL","Passenger","1","1","2","142","144","1.388888888888888888888888889"
"2017-10-31T00:00:00.000","Palm Beach","FL","Passenger","0","1","1","87","88","1.136363636363636363636363636"
"2017-10-31T00:00:00.000","Polk","FL","Passenger","1","0","1","63","64","1.562500"
"2017-10-31T00:00:00.000","Santa Rosa","FL","Passenger","1","0","1","109","110","0.9090909090909090909090909091"
"2017-10-31T00:00:00.000","St. Lucie","FL","Passenger","1","0","1","24","25","4.00"
"2017-10-31T00:00:00.000","Sumter","FL","Passenger","0","1","1","10","11","9.090909090909090909090909091"
"2017-10-31T00:00:00.000","Volusia","FL","Passenger","0","1","1","38","39","2.564102564102564102564102564"
"2017-10-31T00:00:00.000","Camden","GA","Passenger","0","1","1","176","177","0.5649717514124293785310734463"
"2017-10-31T00:00:00.000","Columbia","GA","Passenger","1","0","1","168","169","0.5917159763313609467455621302"
"2017-10-31T00:00:00.000","DeKalb","GA","Passenger","1","0","1","82","83","1.204819277108433734939759036"
"2017-10-31T00:00:00.000","Fulton","GA","Passenger","1","0","1","106","107","0.9345794392523364485981308411"
"2017-10-31T00:00:00.000","Gwinnett","GA","Passenger","0","1","1","88","89","1.123595505617977528089887640"
"2017-10-31T00:00:00.000","Liberty","GA","Passenger","1","0","1","157","158","0.6329113924050632911392405063"
"2017-10-31T00:00:00.000","Lumpkin","GA","Passenger","1","0","1","9","10","10.0"
"2017-10-31T00:00:00.000","Honolulu","HI","Passenger","3","1","4","551","555","0.7207207207207207207207207207"
"2017-10-31T00:00:00.000","Maui","HI","Passenger","1","0","1","69","70","1.428571428571428571428571429"
"2017-10-31T00:00:00.000","Canyon","ID","Passenger","0","1","1","88","89","1.123595505617977528089887640"
"2017-10-31T00:00:00.000","Latah","ID","Passenger","0","1","1","82","83","1.204819277108433734939759036"
"2017-10-31T00:00:00.000","Madison","ID","Passenger","1","0","1","36","37","2.702702702702702702702702703"
"2017-10-31T00:00:00.000","Twin Falls","ID","Passenger","0","1","1","24","25","4.00"
"2017-10-31T00:00:00.000","Sangamon","IL","Passenger","1","0","1","11","12","8.333333333333333333333333333"
"2017-10-31T00:00:00.000","St. Clair","IL","Passenger","0","1","1","159","160","0.62500"
"2017-10-31T00:00:00.000","DeKalb","IN","Passenger","1","0","1","1","2","50.0"
"2017-10-31T00:00:00.000","Hamilton","IN","Passenger","1","0","1","59","60","1.666666666666666666666666667"
"2017-10-31T00:00:00.000","Hardin","KY","Passenger","0","1","1","120","121","0.8264462809917355371900826446"
"2017-10-31T00:00:00.000","Orleans","LA","Passenger","0","1","1","47","48","2.083333333333333333333333333"
"2017-10-31T00:00:00.000","Franklin","MA","Passenger","0","1","1","4","5","20.0"
"2017-10-31T00:00:00.000","Nantucket","MA","Passenger","1","0","1","2","3","33.33333333333333333333333333"
"2017-10-31T00:00:00.000","Norfolk","MA","Passenger","1","0","1","33","34","2.941176470588235294117647059"
"2017-10-31T00:00:00.000","Anne Arundel","MD","Passenger","0","1","1","493","494","0.2024291497975708502024291498"
"2017-10-31T00:00:00.000","Charles","MD","Passenger","0","1","1","83","84","1.190476190476190476190476190"
"2017-10-31T00:00:00.000","Frederick","MD","Passenger","0","1","1","85","86","1.162790697674418604651162791"
"2017-10-31T00:00:00.000","Howard","MD","Passenger","0","2","2","87","89","2.247191011235955056179775281"
"2017-10-31T00:00:00.000","Montgomery","MD","Passenger","1","1","2","306","308","0.6493506493506493506493506494"
"2017-10-31T00:00:00.000","Kent","MI","Passenger","0","1","1","33","34","2.941176470588235294117647059"
"2017-10-31T00:00:00.000","Wayne","MI","Passenger","0","1","1","68","69","1.449275362318840579710144928"
"2017-10-31T00:00:00.000","Dakota","MN","Passenger","0","1","1","36","37","2.702702702702702702702702703"
"2017-10-31T00:00:00.000","Kanabec","MN","Passenger","1","0","1","0","1","100"
"2017-10-31T00:00:00.000","Ramsey","MN","Passenger","1","0","1","36","37","2.702702702702702702702702703"
"2017-10-31T00:00:00.000","Flathead","MT","Passenger","1","0","1","54","55","1.818181818181818181818181818"
"2017-10-31T00:00:00.000","Gallatin","MT","Passenger","0","1","1","63","64","1.562500"
"2017-10-31T00:00:00.000","Glacier","MT","Passenger","0","1","1","3","4","25.00"
"2017-10-31T00:00:00.000","Missoula","MT","Passenger","1","0","1","67","68","1.470588235294117647058823529"
"2017-10-31T00:00:00.000","Moore","NC","Passenger","0","1","1","200","201","0.4975124378109452736318407960"
"2017-10-31T00:00:00.000","Carroll","NH","Passenger","0","1","1","1","2","50.0"
"2017-10-31T00:00:00.000","Essex","NJ","Passenger","1","0","1","12","13","7.692307692307692307692307692"
"2017-10-31T00:00:00.000","Morris","NJ","Passenger","1","0","1","22","23","4.347826086956521739130434783"
"2017-10-31T00:00:00.000","Santa Fe","NM","Passenger","0","1","1","40","41","2.439024390243902439024390244"
"2017-10-31T00:00:00.000","Clark","NV","Passenger","1","2","3","755","758","0.3957783641160949868073878628"
"2017-10-31T00:00:00.000","Washoe","NV","Passenger","1","0","1","123","124","0.8064516129032258064516129032"
"2017-10-31T00:00:00.000","Jefferson","NY","Passenger","1","0","1","243","244","0.4098360655737704918032786885"
"2017-10-31T00:00:00.000","Nassau","NY","Passenger","1","1","2","37","39","5.128205128205128205128205128"
"2017-10-31T00:00:00.000","Queens","NY","Passenger","1","0","1","62","63","1.587301587301587301587301587"
"2017-10-31T00:00:00.000","Saratoga","NY","Passenger","1","1","2","74","76","2.631578947368421052631578947"
"2017-10-31T00:00:00.000","Franklin","OH","Passenger","0","1","1","113","114","0.8771929824561403508771929825"
"2017-10-31T00:00:00.000","Oklahoma","OK","Passenger","0","1","1","122","123","0.8130081300813008130081300813"
"2017-10-31T00:00:00.000","Deschutes","OR","Passenger","1","0","1","178","179","0.5586592178770949720670391061"
"2017-10-31T00:00:00.000","Lane","OR","Passenger","0","1","1","210","211","0.4739336492890995260663507109"
"2017-10-31T00:00:00.000","Multnomah","OR","Passenger","1","3","4","898","902","0.4434589800443458980044345898"
"2017-10-31T00:00:00.000","Allegheny","PA","Passenger","1","0","1","87","88","1.136363636363636363636363636"
"2017-10-31T00:00:00.000","Montgomery","PA","Passenger","1","0","1","35","36","2.777777777777777777777777778"
"2017-10-31T00:00:00.000","Northampton","PA","Passenger","0","1","1","70","71","1.408450704225352112676056338"
"2017-10-31T00:00:00.000","Newport","RI","Passenger","1","0","1","114","115","0.8695652173913043478260869565"
"2017-10-31T00:00:00.000","Richland","SC","Passenger","0","1","1","181","182","0.5494505494505494505494505495"
"2017-10-31T00:00:00.000","Hamilton","TN","Passenger","1","0","1","20","21","4.761904761904761904761904762"
"2017-10-31T00:00:00.000","Knox","TN","Passenger","1","0","1","38","39","2.564102564102564102564102564"
"2017-10-31T00:00:00.000","Montgomery","TN","Passenger","1","0","1","270","271","0.3690036900369003690036900369"
"2017-10-31T00:00:00.000","Shelby","TN","Passenger","0","1","1","107","108","0.9259259259259259259259259259"
"2017-10-31T00:00:00.000","Bexar","TX","Passenger","2","1","3","814","817","0.3671970624235006119951040392"
"2017-10-31T00:00:00.000","Dallas","TX","Passenger","0","1","1","172","173","0.5780346820809248554913294798"
"2017-10-31T00:00:00.000","El Paso","TX","Passenger","1","0","1","534","535","0.1869158878504672897196261682"
"2017-10-31T00:00:00.000","Montgomery","TX","Passenger","1","0","1","57","58","1.724137931034482758620689655"
"2017-10-31T00:00:00.000","Nueces","TX","Passenger","0","1","1","93","94","1.063829787234042553191489362"
"2017-10-31T00:00:00.000","Tarrant","TX","Passenger","1","0","1","221","222","0.4504504504504504504504504505"
"2017-10-31T00:00:00.000","Travis","TX","Passenger","0","1","1","192","193","0.5181347150259067357512953368"
"2017-10-31T00:00:00.000","Utah","UT","Passenger","0","1","1","135","136","0.7352941176470588235294117647"
"2017-10-31T00:00:00.000","Albemarle","VA","Passenger","0","1","1","32","33","3.030303030303030303030303030"
"2017-10-31T00:00:00.000","Alexandria","VA","Passenger","1","0","1","167","168","0.5952380952380952380952380952"
"2017-10-31T00:00:00.000","Arlington","VA","Passenger","1","2","3","169","172","1.744186046511627906976744186"
"2017-10-31T00:00:00.000","Fairfax","VA","Passenger","2","3","5","845","850","0.5882352941176470588235294118"
"2017-10-31T00:00:00.000","Manassas","VA","Passenger","0","1","1","9","10","10.0"
"2017-10-31T00:00:00.000","Norfolk","VA","Passenger","1","1","2","311","313","0.6389776357827476038338658147"
"2017-10-31T00:00:00.000","Portsmouth","VA","Passenger","0","1","1","58","59","1.694915254237288135593220339"
"2017-10-31T00:00:00.000","Prince William","VA","Passenger","0","3","3","260","263","1.140684410646387832699619772"
"2017-10-31T00:00:00.000","Rockbridge","VA","Passenger","1","0","1","3","4","25.00"
"2017-10-31T00:00:00.000","Virginia Beach","VA","Passenger","2","1","3","652","655","0.4580152671755725190839694656"
"2017-10-31T00:00:00.000","Adams","WA","Passenger","3","3","6","12285","12291","0.04881620698071759824261654869"
"2017-10-31T00:00:00.000","Adams","WA","Truck","0","0","0","5133","5133","0"
"2017-10-31T00:00:00.000","Asotin","WA","Truck","0","0","0","6529","6529","0"
"2017-10-31T00:00:00.000","Asotin","WA","Passenger","7","6","13","12482","12495","0.1040416166466586634653861545"
"2017-10-31T00:00:00.000","Benton","WA","Truck","0","0","0","40401","40401","0"
"2017-10-31T00:00:00.000","Benton","WA","Passenger","172","162","334","129399","129733","0.2574518434014475885087063430"
"2017-10-31T00:00:00.000","Chelan","WA","Truck","0","0","0","21498","21498","0"
"2017-10-31T00:00:00.000","Chelan","WA","Passenger","77","36","113","52731","52844","0.2138369540534403148891075619"
"2017-10-31T00:00:00.000","Clallam","WA","Passenger","103","91","194","48712","48906","0.3966793440477651003966793440"
"2017-10-31T00:00:00.000","Clallam","WA","Truck","0","0","0","21149","21149","0"
"2017-10-31T00:00:00.000","Clark","WA","Passenger","892","587","1479","302202","303681","0.4870242129076234601440327185"
"2017-10-31T00:00:00.000","Clark","WA","Truck","0","0","0","78131","78131","0"
"2017-10-31T00:00:00.000","Columbia","WA","Truck","0","0","0","1542","1542","0"
"2017-10-31T00:00:00.000","Columbia","WA","Passenger","1","1","2","2393","2395","0.08350730688935281837160751566"
"2017-10-31T00:00:00.000","Cowlitz","WA","Passenger","63","74","137","70425","70562","0.1941554944587738442787902837"
"2017-10-31T00:00:00.000","Cowlitz","WA","Truck","0","0","0","28125","28125","0"
"2017-10-31T00:00:00.000","Douglas","WA","Passenger","36","32","68","26967","27035","0.2515257998890327353430737932"
"2017-10-31T00:00:00.000","Douglas","WA","Truck","0","0","0","11656","11656","0"
"2017-10-31T00:00:00.000","Ferry","WA","Truck","0","0","0","3550","3550","0"
"2017-10-31T00:00:00.000","Ferry","WA","Passenger","1","1","2","4397","4399","0.04546487838145032962036826551"
"2017-10-31T00:00:00.000","Franklin","WA","Passenger","38","50","88","56507","56595","0.1554907677356656948493683188"
"2017-10-31T00:00:00.000","Franklin","WA","Truck","0","0","0","18322","18322","0"
"2017-10-31T00:00:00.000","Garfield","WA","Truck","0","0","0","943","943","0"
"2017-10-31T00:00:00.000","Garfield","WA","Passenger","1","0","1","1315","1316","0.07598784194528875379939209726"
"2017-10-31T00:00:00.000","Grant","WA","Passenger","21","37","58","61692","61750","0.09392712550607287449392712551"
"2017-10-31T00:00:00.000","Grant","WA","Truck","0","0","0","25461","25461","0"
"2017-10-31T00:00:00.000","Grays Harbor","WA","Truck","0","0","0","20010","20010","0"
"2017-10-31T00:00:00.000","Grays Harbor","WA","Passenger","45","47","92","45352","45444","0.2024469676965055892967168383"
"2017-10-31T00:00:00.000","Island","WA","Passenger","151","159","310","61075","61385","0.5050093671092286389183025169"
"2017-10-31T00:00:00.000","Island","WA","Truck","0","0","0","20592","20592","0"
"2017-10-31T00:00:00.000","Jefferson","WA","Truck","0","0","0","9440","9440","0"
"2017-10-31T00:00:00.000","Jefferson","WA","Passenger","125","72","197","24072","24269","0.8117351353578639416539618443"
"2017-10-31T00:00:00.000","King","WA","Passenger","11214","4774","15988","1372104","1388092","1.151796854963503859974699083"
"2017-10-31T00:00:00.000","King","WA","Truck","7","1","8","185904","185912","0.004303111149360987994319893283"
"2017-10-31T00:00:00.000","Kitsap","WA","Passenger","715","372","1087","174876","175963","0.6177435028954950756693168450"
"2017-10-31T00:00:00.000","Kitsap","WA","Truck","1","0","1","52605","52606","0.001900923848990609436185986389"
"2017-10-31T00:00:00.000","Kittitas","WA","Truck","0","0","0","13698","13698","0"
"2017-10-31T00:00:00.000","Kittitas","WA","Passenger","35","23","58","28116","28174","0.2058635621494995385816710442"
"2017-10-31T00:00:00.000","Klickitat","WA","Truck","0","0","0","8006","8006","0"
"2017-10-31T00:00:00.000","Klickitat","WA","Passenger","25","29","54","14802","14856","0.3634894991922455573505654281"
"2017-10-31T00:00:00.000","Lewis","WA","Truck","0","0","0","25211","25211","0"
"2017-10-31T00:00:00.000","Lewis","WA","Passenger","58","49","107","56266","56373","0.1898071771947563549926383198"
"2017-10-31T00:00:00.000","Lincoln","WA","Truck","0","0","0","4492","4492","0"
"2017-10-31T00:00:00.000","Lincoln","WA","Passenger","4","6","10","7574","7584","0.1318565400843881856540084388"
"2017-10-31T00:00:00.000","Mason","WA","Passenger","71","75","146","44436","44582","0.3274864295006953478982549011"
"2017-10-31T00:00:00.000","Mason","WA","Truck","0","0","0","19475","19475","0"
"2017-10-31T00:00:00.000","Okanogan","WA","Passenger","6","17","23","25709","25732","0.08938286957873464946370278253"
"2017-10-31T00:00:00.000","Okanogan","WA","Truck","0","0","0","16253","16253","0"
"2017-10-31T00:00:00.000","Pacific","WA","Truck","0","0","0","7520","7520","0"
"2017-10-31T00:00:00.000","Pacific","WA","Passenger","21","11","32","15316","15348","0.2084962210059942663539223352"
"2017-10-31T00:00:00.000","Pend Oreille","WA","Truck","0","0","0","5556","5556","0"
"2017-10-31T00:00:00.000","Pend Oreille","WA","Passenger","4","4","8","9370","9378","0.08530603540200469183194711026"
"2017-10-31T00:00:00.000","Pierce","WA","Passenger","1214","986","2200","525399","527599","0.4169833528873254119132143920"
"2017-10-31T00:00:00.000","Pierce","WA","Truck","0","0","0","137043","137043","0"
"2017-10-31T00:00:00.000","San Juan","WA","Passenger","127","42","169","13757","13926","1.213557374694815453109291972"
"2017-10-31T00:00:00.000","San Juan","WA","Truck","0","0","0","5572","5572","0"
"2017-10-31T00:00:00.000","Skagit","WA","Passenger","175","141","316","88951","89267","0.3539941971837297097471630054"
"2017-10-31T00:00:00.000","Skagit","WA","Truck","1","0","1","31637","31638","0.003160756052847841203615904924"
"2017-10-31T00:00:00.000","Skamania","WA","Truck","0","0","0","3890","3890","0"
"2017-10-31T00:00:00.000","Skamania","WA","Passenger","11","7","18","8569","8587","0.2096191918015604984278560615"
"2017-10-31T00:00:00.000","Snohomish","WA","Truck","1","0","1","121475","121476","0.0008232078764529619019394777569"
"2017-10-31T00:00:00.000","Snohomish","WA","Passenger","2048","1091","3139","515157","518296","0.6056384768549245990708012410"
"2017-10-31T00:00:00.000","Spokane","WA","Truck","1","0","1","91353","91354","0.001094642818048470783983186286"
"2017-10-31T00:00:00.000","Spokane","WA","Passenger","315","267","582","298912","299494","0.1943277661655993108376127735"
"2017-10-31T00:00:00.000","Stevens","WA","Passenger","11","24","35","31530","31565","0.1108823063519721210201172184"
"2017-10-31T00:00:00.000","Stevens","WA","Truck","0","0","0","18299","18299","0"
"2017-10-31T00:00:00.000","Thurston","WA","Truck","0","0","0","53590","53590","0"
"2017-10-31T00:00:00.000","Thurston","WA","Passenger","500","398","898","188838","189736","0.4732892018383438040224311675"
"2017-10-31T00:00:00.000","Wahkiakum","WA","Truck","0","0","0","1672","1672","0"
"2017-10-31T00:00:00.000","Wahkiakum","WA","Passenger","2","2","4","2847","2851","0.1403016485443703963521571378"
"2017-10-31T00:00:00.000","Walla Walla","WA","Truck","0","0","0","13257","13257","0"
"2017-10-31T00:00:00.000","Walla Walla","WA","Passenger","28","28","56","35162","35218","0.1590095973649838150945539213"
"2017-10-31T00:00:00.000","Whatcom","WA","Passenger","543","216","759","144313","145072","0.5231884857174368589390095952"
"2017-10-31T00:00:00.000","Whatcom","WA","Truck","2","0","2","41885","41887","0.004774751116098073387924654427"
"2017-10-31T00:00:00.000","Whitman","WA","Passenger","13","22","35","22314","22349","0.1566065595776097364535325965"
"2017-10-31T00:00:00.000","Whitman","WA","Truck","0","0","0","8443","8443","0"
"2017-10-31T00:00:00.000","Yakima","WA","Passenger","66","77","143","161007","161150","0.08873720136518771331058020478"
"2017-10-31T00:00:00.000","Yakima","WA","Truck","0","0","0","57812","57812","0"
"2017-10-31T00:00:00.000","Ozaukee","WI","Passenger","0","1","1","2","3","33.33333333333333333333333333"
"2017-10-31T00:00:00.000",,,"Passenger","3","0","3","245","248","1.209677419354838709677419355"
"2017-11-30T00:00:00.000","Juneau","AK","Passenger","0","1","1","44","45","2.222222222222222222222222222"
"2017-11-30T00:00:00.000","Dale","AL","Passenger","0","1","1","65","66","1.515151515151515151515151515"
"2017-11-30T00:00:00.000","Lee","AL","Passenger","1","0","1","35","36","2.777777777777777777777777778"
"2017-11-30T00:00:00.000","Maricopa","AZ","Passenger","3","1","4","1553","1557","0.2569043031470777135517019910"
"2017-11-30T00:00:00.000","Pima","AZ","Passenger","0","1","1","401","402","0.2487562189054726368159203980"
"2017-11-30T00:00:00.000","Pinal","AZ","Passenger","2","0","2","201","203","0.9852216748768472906403940887"
"2017-11-30T00:00:00.000","Alameda","CA","Passenger","0","1","1","350","351","0.2849002849002849002849002849"
"2017-11-30T00:00:00.000","Contra Costa","CA","Passenger","0","1","1","489","490","0.2040816326530612244897959184"
"2017-11-30T00:00:00.000","Los Angeles","CA","Passenger","5","2","7","1212","1219","0.5742411812961443806398687449"
"2017-11-30T00:00:00.000","Marin","CA","Passenger","1","0","1","55","56","1.785714285714285714285714286"
"2017-11-30T00:00:00.000","Monterey","CA","Passenger","0","2","2","196","198","1.010101010101010101010101010"
"2017-11-30T00:00:00.000","Orange","CA","Passenger","3","1","4","579","583","0.6861063464837049742710120069"
"2017-11-30T00:00:00.000","Riverside","CA","Passenger","0","2","2","730","732","0.2732240437158469945355191257"
"2017-11-30T00:00:00.000","Sacramento","CA","Passenger","1","0","1","314","315","0.3174603174603174603174603175"
"2017-11-30T00:00:00.000","San Diego","CA","Passenger","5","2","7","2601","2608","0.2684049079754601226993865031"
"2017-11-30T00:00:00.000","San Mateo","CA","Passenger","0","1","1","146","147","0.6802721088435374149659863946"
"2017-11-30T00:00:00.000","Santa Clara","CA","Passenger","7","1","8","377","385","2.077922077922077922077922078"
"2017-11-30T00:00:00.000","Tulare","CA","Passenger","1","0","1","190","191","0.5235602094240837696335078534"
"2017-11-30T00:00:00.000","Tuolumne","CA","Passenger","0","1","1","13","14","7.142857142857142857142857143"
"2017-11-30T00:00:00.000","Ventura","CA","Passenger","0","1","1","329","330","0.3030303030303030303030303030"
"2017-11-30T00:00:00.000","El Paso","CO","Passenger","2","0","2","765","767","0.2607561929595827900912646675"
"2017-11-30T00:00:00.000","Larimer","CO","Passenger","0","1","1","67","68","1.470588235294117647058823529"
"2017-11-30T00:00:00.000","New London","CT","Passenger","1","1","2","267","269","0.7434944237918215613382899628"
"2017-11-30T00:00:00.000","District of Columbia","DC","Passenger","0","4","4","203","207","1.932367149758454106280193237"
"2017-11-30T00:00:00.000","Kent","DE","Passenger","0","1","1","72","73","1.369863013698630136986301370"
"2017-11-30T00:00:00.000","New Castle","DE","Passenger","1","0","1","24","25","4.00"
"2017-11-30T00:00:00.000","Brevard","FL","Passenger","0","1","1","99","100","1.00"
"2017-11-30T00:00:00.000","Clay","FL","Passenger","0","1","1","106","107","0.9345794392523364485981308411"
"2017-11-30T00:00:00.000","Duval","FL","Passenger","1","1","2","359","361","0.5540166204986149584487534626"
"2017-11-30T00:00:00.000","Manatee","FL","Passenger","1","0","1","39","40","2.500"
"2017-11-30T00:00:00.000","Miami-Dade","FL","Passenger","0","1","1","121","122","0.8196721311475409836065573770"
"2017-11-30T00:00:00.000","Okaloosa","FL","Passenger","1","0","1","184","185","0.5405405405405405405405405405"
"2017-11-30T00:00:00.000","Orange","FL","Passenger","1","1","2","141","143","1.398601398601398601398601399"
"2017-11-30T00:00:00.000","Palm Beach","FL","Passenger","0","1","1","84","85","1.176470588235294117647058824"
"2017-11-30T00:00:00.000","Polk","FL","Passenger","1","0","1","62","63","1.587301587301587301587301587"
"2017-11-30T00:00:00.000","Santa Rosa","FL","Passenger","1","0","1","106","107","0.9345794392523364485981308411"
"2017-11-30T00:00:00.000","St. Lucie","FL","Passenger","1","0","1","23","24","4.166666666666666666666666667"
"2017-11-30T00:00:00.000","Sumter","FL","Passenger","0","1","1","10","11","9.090909090909090909090909091"
"2017-11-30T00:00:00.000","Volusia","FL","Passenger","0","1","1","36","37","2.702702702702702702702702703"
"2017-11-30T00:00:00.000","Camden","GA","Passenger","0","1","1","173","174","0.5747126436781609195402298851"
"2017-11-30T00:00:00.000","Columbia","GA","Passenger","1","0","1","165","166","0.6024096385542168674698795181"
"2017-11-30T00:00:00.000","DeKalb","GA","Passenger","1","0","1","82","83","1.204819277108433734939759036"
"2017-11-30T00:00:00.000","Fulton","GA","Passenger","1","0","1","105","106","0.9433962264150943396226415094"
"2017-11-30T00:00:00.000","Gwinnett","GA","Passenger","0","1","1","86","87","1.149425287356321839080459770"
"2017-11-30T00:00:00.000","Liberty","GA","Passenger","1","0","1","155","156","0.6410256410256410256410256410"
"2017-11-30T00:00:00.000","Lumpkin","GA","Passenger","1","0","1","9","10","10.0"
"2017-11-30T00:00:00.000","Honolulu","HI","Passenger","3","1","4","553","557","0.7181328545780969479353680431"
"2017-11-30T00:00:00.000","Maui","HI","Passenger","1","0","1","68","69","1.449275362318840579710144928"
"2017-11-30T00:00:00.000","Canyon","ID","Passenger","0","1","1","86","87","1.149425287356321839080459770"
"2017-11-30T00:00:00.000","Latah","ID","Passenger","0","1","1","75","76","1.315789473684210526315789474"
"2017-11-30T00:00:00.000","Madison","ID","Passenger","1","0","1","38","39","2.564102564102564102564102564"
"2017-11-30T00:00:00.000","Twin Falls","ID","Passenger","0","1","1","24","25","4.00"
"2017-11-30T00:00:00.000","Sangamon","IL","Passenger","1","0","1","11","12","8.333333333333333333333333333"
"2017-11-30T00:00:00.000","St. Clair","IL","Passenger","0","1","1","160","161","0.6211180124223602484472049689"
"2017-11-30T00:00:00.000","DeKalb","IN","Passenger","1","0","1","1","2","50.0"
"2017-11-30T00:00:00.000","Hamilton","IN","Passenger","1","0","1","55","56","1.785714285714285714285714286"
"2017-11-30T00:00:00.000","Hardin","KY","Passenger","0","1","1","122","123","0.8130081300813008130081300813"
"2017-11-30T00:00:00.000","Orleans","LA","Passenger","0","1","1","47","48","2.083333333333333333333333333"
"2017-11-30T00:00:00.000","Franklin","MA","Passenger","0","1","1","4","5","20.0"
"2017-11-30T00:00:00.000","Nantucket","MA","Passenger","1","0","1","2","3","33.33333333333333333333333333"
"2017-11-30T00:00:00.000","Norfolk","MA","Passenger","1","0","1","33","34","2.941176470588235294117647059"
"2017-11-30T00:00:00.000","Anne Arundel","MD","Passenger","0","1","1","495","496","0.2016129032258064516129032258"
"2017-11-30T00:00:00.000","Charles","MD","Passenger","0","1","1","84","85","1.176470588235294117647058824"
"2017-11-30T00:00:00.000","Frederick","MD","Passenger","0","1","1","89","90","1.111111111111111111111111111"
"2017-11-30T00:00:00.000","Howard","MD","Passenger","0","2","2","90","92","2.173913043478260869565217391"
"2017-11-30T00:00:00.000","Montgomery","MD","Passenger","1","1","2","304","306","0.6535947712418300653594771242"
"2017-11-30T00:00:00.000","Kent","MI","Passenger","0","1","1","33","34","2.941176470588235294117647059"
"2017-11-30T00:00:00.000","Dakota","MN","Passenger","0","1","1","35","36","2.777777777777777777777777778"
"2017-11-30T00:00:00.000","Kanabec","MN","Passenger","1","0","1","0","1","100"
"2017-11-30T00:00:00.000","Ramsey","MN","Passenger","1","0","1","35","36","2.777777777777777777777777778"
"2017-11-30T00:00:00.000","Flathead","MT","Passenger","1","0","1","55","56","1.785714285714285714285714286"
"2017-11-30T00:00:00.000","Gallatin","MT","Passenger","0","1","1","64","65","1.538461538461538461538461538"
"2017-11-30T00:00:00.000","Glacier","MT","Passenger","0","1","1","3","4","25.00"
"2017-11-30T00:00:00.000","Missoula","MT","Passenger","1","0","1","66","67","1.492537313432835820895522388"
"2017-11-30T00:00:00.000","Moore","NC","Passenger","0","1","1","201","202","0.4950495049504950495049504950"
"2017-11-30T00:00:00.000","Carroll","NH","Passenger","0","1","1","1","2","50.0"
"2017-11-30T00:00:00.000","Essex","NJ","Passenger","1","0","1","9","10","10.0"
"2017-11-30T00:00:00.000","Morris","NJ","Passenger","1","0","1","22","23","4.347826086956521739130434783"
"2017-11-30T00:00:00.000","Santa Fe","NM","Passenger","0","1","1","41","42","2.380952380952380952380952381"
"2017-11-30T00:00:00.000","Clark","NV","Passenger","1","2","3","749","752","0.3989361702127659574468085106"
"2017-11-30T00:00:00.000","Washoe","NV","Passenger","1","0","1","123","124","0.8064516129032258064516129032"
"2017-11-30T00:00:00.000","Jefferson","NY","Passenger","1","0","1","237","238","0.4201680672268907563025210084"
"2017-11-30T00:00:00.000","Nassau","NY","Passenger","1","1","2","37","39","5.128205128205128205128205128"
"2017-11-30T00:00:00.000","Queens","NY","Passenger","1","0","1","61","62","1.612903225806451612903225806"
"2017-11-30T00:00:00.000","Saratoga","NY","Passenger","1","1","2","72","74","2.702702702702702702702702703"
"2017-11-30T00:00:00.000","Franklin","OH","Passenger","0","1","1","110","111","0.9009009009009009009009009009"
"2017-11-30T00:00:00.000","Oklahoma","OK","Passenger","0","1","1","120","121","0.8264462809917355371900826446"
"2017-11-30T00:00:00.000","Deschutes","OR","Passenger","1","0","1","173","174","0.5747126436781609195402298851"
"2017-11-30T00:00:00.000","Lane","OR","Passenger","0","1","1","203","204","0.4901960784313725490196078431"
"2017-11-30T00:00:00.000","Multnomah","OR","Passenger","3","3","6","886","892","0.6726457399103139013452914798"
"2017-11-30T00:00:00.000","Allegheny","PA","Passenger","1","0","1","87","88","1.136363636363636363636363636"
"2017-11-30T00:00:00.000","Montgomery","PA","Passenger","1","0","1","35","36","2.777777777777777777777777778"
"2017-11-30T00:00:00.000","Northampton","PA","Passenger","0","1","1","66","67","1.492537313432835820895522388"
"2017-11-30T00:00:00.000","Newport","RI","Passenger","1","0","1","112","113","0.8849557522123893805309734513"
"2017-11-30T00:00:00.000","Richland","SC","Passenger","0","1","1","176","177","0.5649717514124293785310734463"
"2017-11-30T00:00:00.000","Hamilton","TN","Passenger","1","0","1","20","21","4.761904761904761904761904762"
"2017-11-30T00:00:00.000","Knox","TN","Passenger","1","0","1","36","37","2.702702702702702702702702703"
"2017-11-30T00:00:00.000","Montgomery","TN","Passenger","1","0","1","270","271","0.3690036900369003690036900369"
"2017-11-30T00:00:00.000","Shelby","TN","Passenger","0","1","1","107","108","0.9259259259259259259259259259"
"2017-11-30T00:00:00.000","Bexar","TX","Passenger","2","1","3","817","820","0.3658536585365853658536585366"
"2017-11-30T00:00:00.000","Dallas","TX","Passenger","0","1","1","173","174","0.5747126436781609195402298851"
"2017-11-30T00:00:00.000","El Paso","TX","Passenger","1","0","1","531","532","0.1879699248120300751879699248"
"2017-11-30T00:00:00.000","Montgomery","TX","Passenger","1","0","1","58","59","1.694915254237288135593220339"
"2017-11-30T00:00:00.000","Nueces","TX","Passenger","1","1","2","92","94","2.127659574468085106382978723"
"2017-11-30T00:00:00.000","Tarrant","TX","Passenger","1","0","1","223","224","0.4464285714285714285714285714"
"2017-11-30T00:00:00.000","Travis","TX","Passenger","0","1","1","183","184","0.5434782608695652173913043478"
"2017-11-30T00:00:00.000","Utah","UT","Passenger","0","1","1","131","132","0.7575757575757575757575757576"
"2017-11-30T00:00:00.000","Albemarle","VA","Passenger","0","1","1","32","33","3.030303030303030303030303030"
"2017-11-30T00:00:00.000","Alexandria","VA","Passenger","1","0","1","165","166","0.6024096385542168674698795181"
"2017-11-30T00:00:00.000","Arlington","VA","Passenger","1","2","3","170","173","1.734104046242774566473988439"
"2017-11-30T00:00:00.000","Fairfax","VA","Passenger","2","3","5","839","844","0.5924170616113744075829383886"
"2017-11-30T00:00:00.000","Manassas","VA","Passenger","0","1","1","9","10","10.0"
"2017-11-30T00:00:00.000","Norfolk","VA","Passenger","1","1","2","309","311","0.6430868167202572347266881029"
"2017-11-30T00:00:00.000","Portsmouth","VA","Passenger","0","1","1","60","61","1.639344262295081967213114754"
"2017-11-30T00:00:00.000","Prince George","VA","Passenger","0","1","1","69","70","1.428571428571428571428571429"
"2017-11-30T00:00:00.000","Prince William","VA","Passenger","0","3","3","263","266","1.127819548872180451127819549"
"2017-11-30T00:00:00.000","Rockbridge","VA","Passenger","1","0","1","3","4","25.00"
"2017-11-30T00:00:00.000","Virginia Beach","VA","Passenger","2","1","3","660","663","0.4524886877828054298642533937"
"2017-11-30T00:00:00.000","Adams","WA","Passenger","3","5","8","12360","12368","0.06468305304010349288486416559"
"2017-11-30T00:00:00.000","Adams","WA","Truck","0","0","0","5138","5138","0"
"2017-11-30T00:00:00.000","Asotin","WA","Truck","0","0","0","6557","6557","0"
"2017-11-30T00:00:00.000","Asotin","WA","Passenger","7","6","13","12517","12530","0.1037509976057462090981644054"
"2017-11-30T00:00:00.000","Benton","WA","Passenger","173","167","340","129874","130214","0.2611086365521372509868370529"
"2017-11-30T00:00:00.000","Benton","WA","Truck","0","0","0","40508","40508","0"
"2017-11-30T00:00:00.000","Chelan","WA","Passenger","84","36","120","52843","52963","0.2265732681305817268659252686"
"2017-11-30T00:00:00.000","Chelan","WA","Truck","0","0","0","21528","21528","0"
"2017-11-30T00:00:00.000","Clallam","WA","Passenger","105","92","197","48855","49052","0.4016146130636875152898964364"
"2017-11-30T00:00:00.000","Clallam","WA","Truck","0","0","0","21183","21183","0"
"2017-11-30T00:00:00.000","Clark","WA","Passenger","911","587","1498","303120","304618","0.4917634545561982548634683440"
"2017-11-30T00:00:00.000","Clark","WA","Truck","0","0","0","78255","78255","0"
"2017-11-30T00:00:00.000","Columbia","WA","Truck","0","0","0","1537","1537","0"
"2017-11-30T00:00:00.000","Columbia","WA","Passenger","2","1","3","2391","2394","0.1253132832080200501253132832"
"2017-11-30T00:00:00.000","Cowlitz","WA","Passenger","65","74","139","70585","70724","0.1965386573157626831061591539"
"2017-11-30T00:00:00.000","Cowlitz","WA","Truck","0","0","0","28156","28156","0"
"2017-11-30T00:00:00.000","Douglas","WA","Passenger","37","33","70","27074","27144","0.2578838785735337459475390510"
"2017-11-30T00:00:00.000","Douglas","WA","Truck","0","0","0","11702","11702","0"
"2017-11-30T00:00:00.000","Ferry","WA","Passenger","1","3","4","4409","4413","0.09064128710627690913210967596"
"2017-11-30T00:00:00.000","Ferry","WA","Truck","0","0","0","3545","3545","0"
"2017-11-30T00:00:00.000","Franklin","WA","Truck","0","0","0","18412","18412","0"
"2017-11-30T00:00:00.000","Franklin","WA","Passenger","39","49","88","56679","56767","0.1550196416932372681311325242"
"2017-11-30T00:00:00.000","Garfield","WA","Passenger","1","0","1","1313","1314","0.07610350076103500761035007610"
"2017-11-30T00:00:00.000","Garfield","WA","Truck","0","0","0","937","937","0"
"2017-11-30T00:00:00.000","Grant","WA","Passenger","25","36","61","61921","61982","0.09841566906521248104288341777"
"2017-11-30T00:00:00.000","Grant","WA","Truck","0","0","0","25521","25521","0"
"2017-11-30T00:00:00.000","Grays Harbor","WA","Truck","0","0","0","20022","20022","0"
"2017-11-30T00:00:00.000","Grays Harbor","WA","Passenger","50","47","97","45561","45658","0.2124490779271978623680406501"
"2017-11-30T00:00:00.000","Island","WA","Passenger","160","162","322","61336","61658","0.5222355574296928216938596776"
"2017-11-30T00:00:00.000","Island","WA","Truck","0","0","0","20690","20690","0"
"2017-11-30T00:00:00.000","Jefferson","WA","Passenger","126","75","201","24182","24383","0.8243448304146331460443751794"
"2017-11-30T00:00:00.000","Jefferson","WA","Truck","0","0","0","9464","9464","0"
"2017-11-30T00:00:00.000","King","WA","Truck","7","1","8","185558","185566","0.004311134582843839927572939008"
"2017-11-30T00:00:00.000","King","WA","Passenger","11434","4902","16336","1371414","1387750","1.177157268960547649072239236"
"2017-11-30T00:00:00.000","Kitsap","WA","Passenger","738","384","1122","175360","176482","0.6357588875919357214900103127"
"2017-11-30T00:00:00.000","Kitsap","WA","Truck","1","0","1","52643","52644","0.001899551705797431806093761872"
"2017-11-30T00:00:00.000","Kittitas","WA","Truck","0","0","0","13763","13763","0"
"2017-11-30T00:00:00.000","Kittitas","WA","Passenger","36","24","60","28269","28329","0.2117970983797521973948956899"
"2017-11-30T00:00:00.000","Klickitat","WA","Truck","0","0","0","8003","8003","0"
"2017-11-30T00:00:00.000","Klickitat","WA","Passenger","26","28","54","14868","14922","0.3618817852834740651387213510"
"2017-11-30T00:00:00.000","Lewis","WA","Passenger","58","47","105","56409","56514","0.1857946703471706125915702304"
"2017-11-30T00:00:00.000","Lewis","WA","Truck","0","0","0","25236","25236","0"
"2017-11-30T00:00:00.000","Lincoln","WA","Truck","0","0","0","4485","4485","0"
"2017-11-30T00:00:00.000","Lincoln","WA","Passenger","4","6","10","7553","7563","0.1322226629644321036625677641"
"2017-11-30T00:00:00.000","Mason","WA","Passenger","76","73","149","44581","44730","0.3331097697294880393471942768"
"2017-11-30T00:00:00.000","Mason","WA","Truck","0","0","0","19544","19544","0"
"2017-11-30T00:00:00.000","Okanogan","WA","Truck","0","0","0","16280","16280","0"
"2017-11-30T00:00:00.000","Okanogan","WA","Passenger","6","17","23","25725","25748","0.08932732639428305111076588473"
"2017-11-30T00:00:00.000","Pacific","WA","Truck","0","0","0","7534","7534","0"
"2017-11-30T00:00:00.000","Pacific","WA","Passenger","23","12","35","15327","15362","0.2278349173284728550969925791"
"2017-11-30T00:00:00.000","Pend Oreille","WA","Truck","0","0","0","5589","5589","0"
"2017-11-30T00:00:00.000","Pend Oreille","WA","Passenger","4","4","8","9428","9436","0.08478168715557439593047901653"
"2017-11-30T00:00:00.000","Pierce","WA","Passenger","1239","1013","2252","525921","528173","0.4263754489532785659244224904"
"2017-11-30T00:00:00.000","Pierce","WA","Truck","0","0","0","137052","137052","0"
"2017-11-30T00:00:00.000","San Juan","WA","Truck","0","0","0","5576","5576","0"
"2017-11-30T00:00:00.000","San Juan","WA","Passenger","126","43","169","13782","13951","1.211382696580890258762812702"
"2017-11-30T00:00:00.000","Skagit","WA","Passenger","183","146","329","89309","89638","0.3670318391753497400655971798"
"2017-11-30T00:00:00.000","Skagit","WA","Truck","1","0","1","31696","31697","0.003154872700886519228949111903"
"2017-11-30T00:00:00.000","Skamania","WA","Passenger","12","7","19","8573","8592","0.2211359404096834264432029795"
"2017-11-30T00:00:00.000","Skamania","WA","Truck","0","0","0","3892","3892","0"
"2017-11-30T00:00:00.000","Snohomish","WA","Passenger","2096","1110","3206","515921","519127","0.6175752754143013174040263750"
"2017-11-30T00:00:00.000","Snohomish","WA","Truck","1","0","1","121394","121395","0.0008237571563902961406977223115"
"2017-11-30T00:00:00.000","Spokane","WA","Passenger","321","266","587","299651","300238","0.1955115608284094618269506192"
"2017-11-30T00:00:00.000","Spokane","WA","Truck","1","0","1","91445","91446","0.001093541543643243006801828401"
"2017-11-30T00:00:00.000","Stevens","WA","Passenger","12","23","35","31547","31582","0.1108226204800202647077449180"
"2017-11-30T00:00:00.000","Stevens","WA","Truck","0","0","0","18327","18327","0"
"2017-11-30T00:00:00.000","Thurston","WA","Passenger","522","408","930","189472","190402","0.4884402474763920547053077174"
"2017-11-30T00:00:00.000","Thurston","WA","Truck","0","0","0","53703","53703","0"
"2017-11-30T00:00:00.000","Wahkiakum","WA","Passenger","2","2","4","2866","2870","0.1393728222996515679442508711"
"2017-11-30T00:00:00.000","Wahkiakum","WA","Truck","0","0","0","1662","1662","0"
"2017-11-30T00:00:00.000","Walla Walla","WA","Passenger","29","31","60","35255","35315","0.1698994761432818915475010619"
"2017-11-30T00:00:00.000","Walla Walla","WA","Truck","0","0","0","13313","13313","0"
"2017-11-30T00:00:00.000","Whatcom","WA","Truck","1","0","1","41939","41940","0.002384358607534573199809251311"
"2017-11-30T00:00:00.000","Whatcom","WA","Passenger","563","228","791","144651","145442","0.5438594078739291263871508918"
"2017-11-30T00:00:00.000","Whitman","WA","Passenger","17","21","38","22403","22441","0.1693329174279221068579831558"
"2017-11-30T00:00:00.000","Whitman","WA","Truck","0","0","0","8440","8440","0"
"2017-11-30T00:00:00.000","Yakima","WA","Passenger","67","78","145","161630","161775","0.08963065986709936640395611188"
"2017-11-30T00:00:00.000","Yakima","WA","Truck","0","0","0","57918","57918","0"
"2017-11-30T00:00:00.000","Ozaukee","WI","Passenger","0","1","1","3","4","25.00"
"2017-11-30T00:00:00.000",,,"Passenger","3","0","3","244","247","1.214574898785425101214574899"
"2017-12-31T00:00:00.000","Juneau","AK","Passenger","0","1","1","45","46","2.173913043478260869565217391"
"2017-12-31T00:00:00.000","Dale","AL","Passenger","0","1","1","67","68","1.470588235294117647058823529"
"2017-12-31T00:00:00.000","Lee","AL","Passenger","1","0","1","37","38","2.631578947368421052631578947"
"2017-12-31T00:00:00.000","Maricopa","AZ","Passenger","3","1","4","1545","1549","0.2582311168495803744351194319"
"2017-12-31T00:00:00.000","Pima","AZ","Passenger","0","1","1","399","400","0.2500"
"2017-12-31T00:00:00.000","Pinal","AZ","Passenger","2","0","2","192","194","1.030927835051546391752577320"
"2017-12-31T00:00:00.000","Alameda","CA","Passenger","0","1","1","346","347","0.2881844380403458213256484150"
"2017-12-31T00:00:00.000","Contra Costa","CA","Passenger","0","1","1","486","487","0.2053388090349075975359342916"
"2017-12-31T00:00:00.000","Los Angeles","CA","Passenger","6","2","8","1206","1214","0.6589785831960461285008237232"
"2017-12-31T00:00:00.000","Marin","CA","Passenger","1","0","1","56","57","1.754385964912280701754385965"
"2017-12-31T00:00:00.000","Monterey","CA","Passenger","0","2","2","191","193","1.036269430051813471502590674"
"2017-12-31T00:00:00.000","Orange","CA","Passenger","3","1","4","570","574","0.6968641114982578397212543554"
"2017-12-31T00:00:00.000","Riverside","CA","Passenger","0","2","2","718","720","0.2777777777777777777777777778"
"2017-12-31T00:00:00.000","Sacramento","CA","Passenger","1","0","1","307","308","0.3246753246753246753246753247"
"2017-12-31T00:00:00.000","San Diego","CA","Passenger","6","2","8","2584","2592","0.3086419753086419753086419753"
"2017-12-31T00:00:00.000","San Mateo","CA","Passenger","0","1","1","145","146","0.6849315068493150684931506849"
"2017-12-31T00:00:00.000","Santa Clara","CA","Passenger","7","1","8","375","383","2.088772845953002610966057441"
"2017-12-31T00:00:00.000","Tuolumne","CA","Passenger","0","1","1","12","13","7.692307692307692307692307692"
"2017-12-31T00:00:00.000","Ventura","CA","Passenger","0","1","1","329","330","0.3030303030303030303030303030"
"2017-12-31T00:00:00.000","El Paso","CO","Passenger","2","0","2","764","766","0.2610966057441253263707571802"
"2017-12-31T00:00:00.000","Larimer","CO","Passenger","0","1","1","67","68","1.470588235294117647058823529"
"2017-12-31T00:00:00.000","New London","CT","Passenger","1","1","2","265","267","0.7490636704119850187265917603"
"2017-12-31T00:00:00.000","District of Columbia","DC","Passenger","0","4","4","198","202","1.980198019801980198019801980"
"2017-12-31T00:00:00.000","Kent","DE","Passenger","0","1","1","72","73","1.369863013698630136986301370"
"2017-12-31T00:00:00.000","New Castle","DE","Passenger","1","0","1","26","27","3.703703703703703703703703704"
"2017-12-31T00:00:00.000","Brevard","FL","Passenger","0","1","1","96","97","1.030927835051546391752577320"
"2017-12-31T00:00:00.000","Clay","FL","Passenger","0","1","1","103","104","0.9615384615384615384615384615"
"2017-12-31T00:00:00.000","Duval","FL","Passenger","1","1","2","365","367","0.5449591280653950953678474114"
"2017-12-31T00:00:00.000","Manatee","FL","Passenger","1","0","1","38","39","2.564102564102564102564102564"
"2017-12-31T00:00:00.000","Miami-Dade","FL","Passenger","0","1","1","120","121","0.8264462809917355371900826446"
"2017-12-31T00:00:00.000","Okaloosa","FL","Passenger","1","0","1","181","182","0.5494505494505494505494505495"
"2017-12-31T00:00:00.000","Orange","FL","Passenger","1","1","2","136","138","1.449275362318840579710144928"
"2017-12-31T00:00:00.000","Palm Beach","FL","Passenger","0","1","1","82","83","1.204819277108433734939759036"
"2017-12-31T00:00:00.000","Polk","FL","Passenger","1","0","1","61","62","1.612903225806451612903225806"
"2017-12-31T00:00:00.000","Santa Rosa","FL","Passenger","1","0","1","104","105","0.9523809523809523809523809524"
"2017-12-31T00:00:00.000","St. Lucie","FL","Passenger","1","0","1","23","24","4.166666666666666666666666667"
"2017-12-31T00:00:00.000","Sumter","FL","Passenger","0","1","1","10","11","9.090909090909090909090909091"
"2017-12-31T00:00:00.000","Volusia","FL","Passenger","0","1","1","35","36","2.777777777777777777777777778"
"2017-12-31T00:00:00.000","Camden","GA","Passenger","0","1","1","167","168","0.5952380952380952380952380952"
"2017-12-31T00:00:00.000","Columbia","GA","Passenger","1","1","2","161","163","1.226993865030674846625766871"
"2017-12-31T00:00:00.000","DeKalb","GA","Passenger","1","0","1","84","85","1.176470588235294117647058824"
"2017-12-31T00:00:00.000","Fulton","GA","Passenger","1","0","1","102","103","0.9708737864077669902912621359"
"2017-12-31T00:00:00.000","Gwinnett","GA","Passenger","0","1","1","86","87","1.149425287356321839080459770"
"2017-12-31T00:00:00.000","Liberty","GA","Passenger","1","0","1","150","151","0.6622516556291390728476821192"
"2017-12-31T00:00:00.000","Lumpkin","GA","Passenger","1","0","1","9","10","10.0"
"2017-12-31T00:00:00.000","Honolulu","HI","Passenger","3","1","4","555","559","0.7155635062611806797853309481"
"2017-12-31T00:00:00.000","Maui","HI","Passenger","1","0","1","67","68","1.470588235294117647058823529"
"2017-12-31T00:00:00.000","Ada","ID","Passenger","0","1","1","342","343","0.2915451895043731778425655977"
"2017-12-31T00:00:00.000","Canyon","ID","Passenger","0","1","1","87","88","1.136363636363636363636363636"
"2017-12-31T00:00:00.000","Latah","ID","Passenger","0","1","1","75","76","1.315789473684210526315789474"
"2017-12-31T00:00:00.000","Madison","ID","Passenger","1","0","1","39","40","2.500"
"2017-12-31T00:00:00.000","Twin Falls","ID","Passenger","0","1","1","24","25","4.00"
"2017-12-31T00:00:00.000","DuPage","IL","Passenger","1","0","1","58","59","1.694915254237288135593220339"
"2017-12-31T00:00:00.000","Sangamon","IL","Passenger","1","0","1","10","11","9.090909090909090909090909091"
"2017-12-31T00:00:00.000","St. Clair","IL","Passenger","0","1","1","157","158","0.6329113924050632911392405063"
"2017-12-31T00:00:00.000","DeKalb","IN","Passenger","1","0","1","1","2","50.0"
"2017-12-31T00:00:00.000","Hamilton","IN","Passenger","1","0","1","55","56","1.785714285714285714285714286"
"2017-12-31T00:00:00.000","Hardin","KY","Passenger","0","1","1","122","123","0.8130081300813008130081300813"
"2017-12-31T00:00:00.000","Orleans","LA","Passenger","0","1","1","48","49","2.040816326530612244897959184"
"2017-12-31T00:00:00.000","Franklin","MA","Passenger","0","1","1","4","5","20.0"
"2017-12-31T00:00:00.000","Nantucket","MA","Passenger","1","0","1","2","3","33.33333333333333333333333333"
"2017-12-31T00:00:00.000","Norfolk","MA","Passenger","1","0","1","33","34","2.941176470588235294117647059"
"2017-12-31T00:00:00.000","Anne Arundel","MD","Passenger","0","1","1","482","483","0.2070393374741200828157349896"
"2017-12-31T00:00:00.000","Charles","MD","Passenger","0","1","1","84","85","1.176470588235294117647058824"
"2017-12-31T00:00:00.000","Frederick","MD","Passenger","0","1","1","90","91","1.098901098901098901098901099"
"2017-12-31T00:00:00.000","Howard","MD","Passenger","0","2","2","86","88","2.272727272727272727272727273"
"2017-12-31T00:00:00.000","Montgomery","MD","Passenger","1","1","2","304","306","0.6535947712418300653594771242"
"2017-12-31T00:00:00.000","Kent","MI","Passenger","0","1","1","33","34","2.941176470588235294117647059"
"2017-12-31T00:00:00.000","Dakota","MN","Passenger","0","1","1","36","37","2.702702702702702702702702703"
"2017-12-31T00:00:00.000","Kanabec","MN","Passenger","1","0","1","0","1","100"
"2017-12-31T00:00:00.000","Ramsey","MN","Passenger","1","0","1","35","36","2.777777777777777777777777778"
"2017-12-31T00:00:00.000","Flathead","MT","Passenger","1","0","1","55","56","1.785714285714285714285714286"
"2017-12-31T00:00:00.000","Gallatin","MT","Passenger","0","1","1","61","62","1.612903225806451612903225806"
"2017-12-31T00:00:00.000","Glacier","MT","Passenger","0","1","1","4","5","20.0"
"2017-12-31T00:00:00.000","Missoula","MT","Passenger","1","0","1","66","67","1.492537313432835820895522388"
"2017-12-31T00:00:00.000","Guilford","NC","Passenger","1","0","1","30","31","3.225806451612903225806451613"
"2017-12-31T00:00:00.000","Moore","NC","Passenger","0","1","1","199","200","0.500"
"2017-12-31T00:00:00.000","Carroll","NH","Passenger","0","1","1","1","2","50.0"
"2017-12-31T00:00:00.000","Essex","NJ","Passenger","1","0","1","9","10","10.0"
"2017-12-31T00:00:00.000","Morris","NJ","Passenger","1","0","1","21","22","4.545454545454545454545454545"
"2017-12-31T00:00:00.000","Santa Fe","NM","Passenger","0","1","1","41","42","2.380952380952380952380952381"
"2017-12-31T00:00:00.000","Clark","NV","Passenger","1","2","3","740","743","0.4037685060565275908479138627"
"2017-12-31T00:00:00.000","Washoe","NV","Passenger","1","0","1","120","121","0.8264462809917355371900826446"
"2017-12-31T00:00:00.000","Jefferson","NY","Passenger","1","0","1","235","236","0.4237288135593220338983050847"
"2017-12-31T00:00:00.000","Nassau","NY","Passenger","1","1","2","37","39","5.128205128205128205128205128"
"2017-12-31T00:00:00.000","Queens","NY","Passenger","1","0","1","61","62","1.612903225806451612903225806"
"2017-12-31T00:00:00.000","Saratoga","NY","Passenger","1","1","2","70","72","2.777777777777777777777777778"
"2017-12-31T00:00:00.000","Franklin","OH","Passenger","0","1","1","109","110","0.9090909090909090909090909091"
"2017-12-31T00:00:00.000","Oklahoma","OK","Passenger","0","1","1","116","117","0.8547008547008547008547008547"
"2017-12-31T00:00:00.000","Deschutes","OR","Passenger","1","0","1","171","172","0.5813953488372093023255813953"
"2017-12-31T00:00:00.000","Lane","OR","Passenger","0","1","1","203","204","0.4901960784313725490196078431"
"2017-12-31T00:00:00.000","Multnomah","OR","Passenger","3","3","6","865","871","0.6888633754305396096440872560"
"2017-12-31T00:00:00.000","Allegheny","PA","Passenger","1","0","1","80","81","1.234567901234567901234567901"
"2017-12-31T00:00:00.000","Montgomery","PA","Passenger","1","0","1","35","36","2.777777777777777777777777778"
"2017-12-31T00:00:00.000","Northampton","PA","Passenger","0","1","1","66","67","1.492537313432835820895522388"
"2017-12-31T00:00:00.000","Newport","RI","Passenger","1","0","1","112","113","0.8849557522123893805309734513"
"2017-12-31T00:00:00.000","Richland","SC","Passenger","0","1","1","169","170","0.5882352941176470588235294118"
"2017-12-31T00:00:00.000","Hamilton","TN","Passenger","1","0","1","20","21","4.761904761904761904761904762"
"2017-12-31T00:00:00.000","Knox","TN","Passenger","1","0","1","36","37","2.702702702702702702702702703"
"2017-12-31T00:00:00.000","Montgomery","TN","Passenger","1","0","1","269","270","0.3703703703703703703703703704"
"2017-12-31T00:00:00.000","Shelby","TN","Passenger","0","1","1","108","109","0.9174311926605504587155963303"
"2017-12-31T00:00:00.000","Bexar","TX","Passenger","2","2","4","814","818","0.4889975550122249388753056235"
"2017-12-31T00:00:00.000","Dallas","TX","Passenger","0","1","1","174","175","0.5714285714285714285714285714"
"2017-12-31T00:00:00.000","El Paso","TX","Passenger","1","0","1","530","531","0.1883239171374764595103578154"
"2017-12-31T00:00:00.000","Montgomery","TX","Passenger","1","0","1","57","58","1.724137931034482758620689655"
"2017-12-31T00:00:00.000","Nueces","TX","Passenger","1","1","2","93","95","2.105263157894736842105263158"
"2017-12-31T00:00:00.000","Tarrant","TX","Passenger","1","0","1","221","222","0.4504504504504504504504504505"
"2017-12-31T00:00:00.000","Travis","TX","Passenger","0","1","1","186","187","0.5347593582887700534759358289"
"2017-12-31T00:00:00.000","Utah","UT","Passenger","0","1","1","129","130","0.7692307692307692307692307692"
"2017-12-31T00:00:00.000","Albemarle","VA","Passenger","0","1","1","32","33","3.030303030303030303030303030"
"2017-12-31T00:00:00.000","Alexandria","VA","Passenger","1","0","1","162","163","0.6134969325153374233128834356"
"2017-12-31T00:00:00.000","Arlington","VA","Passenger","1","2","3","172","175","1.714285714285714285714285714"
"2017-12-31T00:00:00.000","Fairfax","VA","Passenger","2","3","5","834","839","0.5959475566150178784266984505"
"2017-12-31T00:00:00.000","Manassas","VA","Passenger","0","1","1","9","10","10.0"
"2017-12-31T00:00:00.000","Norfolk","VA","Passenger","1","1","2","309","311","0.6430868167202572347266881029"
"2017-12-31T00:00:00.000","Portsmouth","VA","Passenger","0","1","1","60","61","1.639344262295081967213114754"
"2017-12-31T00:00:00.000","Prince George","VA","Passenger","0","1","1","72","73","1.369863013698630136986301370"
"2017-12-31T00:00:00.000","Prince William","VA","Passenger","0","3","3","264","267","1.123595505617977528089887640"
"2017-12-31T00:00:00.000","Rockbridge","VA","Passenger","1","0","1","3","4","25.00"
"2017-12-31T00:00:00.000","Virginia Beach","VA","Passenger","2","1","3","669","672","0.4464285714285714285714285714"
"2017-12-31T00:00:00.000","Adams","WA","Passenger","4","5","9","12410","12419","0.07246960302761897093163700781"
"2017-12-31T00:00:00.000","Adams","WA","Truck","0","0","0","5125","5125","0"
"2017-12-31T00:00:00.000","Asotin","WA","Truck","0","0","0","6548","6548","0"
"2017-12-31T00:00:00.000","Asotin","WA","Passenger","8","6","14","12521","12535","0.1116872756282409254088552054"
"2017-12-31T00:00:00.000","Benton","WA","Passenger","180","175","355","130220","130575","0.2718744016848554470610760100"
"2017-12-31T00:00:00.000","Benton","WA","Truck","0","0","0","40585","40585","0"
"2017-12-31T00:00:00.000","Chelan","WA","Passenger","87","38","125","53039","53164","0.2351215107967797757881273042"
"2017-12-31T00:00:00.000","Chelan","WA","Truck","0","0","0","21626","21626","0"
"2017-12-31T00:00:00.000","Clallam","WA","Passenger","106","97","203","49048","49251","0.4121743720939676351749203062"
"2017-12-31T00:00:00.000","Clallam","WA","Truck","0","0","0","21222","21222","0"
"2017-12-31T00:00:00.000","Clark","WA","Truck","0","0","0","78396","78396","0"
"2017-12-31T00:00:00.000","Clark","WA","Passenger","934","603","1537","304195","305732","0.5027278793191422553085709052"
"2017-12-31T00:00:00.000","Columbia","WA","Truck","0","0","0","1540","1540","0"
"2017-12-31T00:00:00.000","Columbia","WA","Passenger","2","1","3","2403","2406","0.1246882793017456359102244389"
"2017-12-31T00:00:00.000","Cowlitz","WA","Truck","0","0","0","28162","28162","0"
"2017-12-31T00:00:00.000","Cowlitz","WA","Passenger","65","76","141","70738","70879","0.1989305718195798473454760931"
"2017-12-31T00:00:00.000","Douglas","WA","Truck","0","0","0","11756","11756","0"
"2017-12-31T00:00:00.000","Douglas","WA","Passenger","38","33","71","27175","27246","0.2605887102693973427292079571"
"2017-12-31T00:00:00.000","Ferry","WA","Passenger","1","3","4","4402","4406","0.09078529278256922378574670903"
"2017-12-31T00:00:00.000","Ferry","WA","Truck","0","0","0","3524","3524","0"
"2017-12-31T00:00:00.000","Franklin","WA","Truck","0","0","0","18489","18489","0"
"2017-12-31T00:00:00.000","Franklin","WA","Passenger","38","51","89","56862","56951","0.1562746922793278432336570034"
"2017-12-31T00:00:00.000","Garfield","WA","Passenger","1","0","1","1321","1322","0.07564296520423600605143721634"
"2017-12-31T00:00:00.000","Garfield","WA","Truck","0","0","0","943","943","0"
"2017-12-31T00:00:00.000","Grant","WA","Passenger","27","38","65","62123","62188","0.1045217726892648099311764328"
"2017-12-31T00:00:00.000","Grant","WA","Truck","0","0","0","25587","25587","0"
"2017-12-31T00:00:00.000","Grays Harbor","WA","Truck","0","0","0","20065","20065","0"
"2017-12-31T00:00:00.000","Grays Harbor","WA","Passenger","50","47","97","45801","45898","0.2113381846703560067976818162"
"2017-12-31T00:00:00.000","Island","WA","Truck","0","0","0","20751","20751","0"
"2017-12-31T00:00:00.000","Island","WA","Passenger","170","171","341","61561","61902","0.5508707311556977157442408969"
"2017-12-31T00:00:00.000","Jefferson","WA","Passenger","131","78","209","24283","24492","0.8533398660787195819042952801"
"2017-12-31T00:00:00.000","Jefferson","WA","Truck","0","0","0","9478","9478","0"
"2017-12-31T00:00:00.000","King","WA","Passenger","11603","4972","16575","1370682","1387257","1.194803846727751238595299934"
"2017-12-31T00:00:00.000","King","WA","Truck","8","1","9","185104","185113","0.004861895166735993690340494725"
"2017-12-31T00:00:00.000","Kitsap","WA","Passenger","756","395","1151","175838","176989","0.6503229014232522925153540616"
"2017-12-31T00:00:00.000","Kitsap","WA","Truck","1","0","1","52702","52703","0.001897425194011726087698992467"
"2017-12-31T00:00:00.000","Kittitas","WA","Truck","0","0","0","13809","13809","0"
"2017-12-31T00:00:00.000","Kittitas","WA","Passenger","38","26","64","28448","28512","0.2244668911335578002244668911"
"2017-12-31T00:00:00.000","Klickitat","WA","Truck","0","0","0","8004","8004","0"
"2017-12-31T00:00:00.000","Klickitat","WA","Passenger","26","28","54","14897","14951","0.3611798541903551601899538492"
"2017-12-31T00:00:00.000","Lewis","WA","Passenger","60","48","108","56557","56665","0.1905938409953233918644666020"
"2017-12-31T00:00:00.000","Lewis","WA","Truck","0","0","0","25313","25313","0"
"2017-12-31T00:00:00.000","Lincoln","WA","Truck","0","0","0","4494","4494","0"
"2017-12-31T00:00:00.000","Lincoln","WA","Passenger","4","6","10","7570","7580","0.1319261213720316622691292876"
"2017-12-31T00:00:00.000","Mason","WA","Truck","0","0","0","19596","19596","0"
"2017-12-31T00:00:00.000","Mason","WA","Passenger","79","75","154","44820","44974","0.3424200649264019211099746520"
"2017-12-31T00:00:00.000","Okanogan","WA","Truck","0","0","0","16275","16275","0"
"2017-12-31T00:00:00.000","Okanogan","WA","Passenger","8","18","26","25738","25764","0.1009160068312373854991460953"
"2017-12-31T00:00:00.000","Pacific","WA","Passenger","23","14","37","15397","15434","0.2397304652066865362187378515"
"2017-12-31T00:00:00.000","Pacific","WA","Truck","0","0","0","7544","7544","0"
"2017-12-31T00:00:00.000","Pend Oreille","WA","Passenger","4","4","8","9440","9448","0.08467400508044030482641828959"
"2017-12-31T00:00:00.000","Pend Oreille","WA","Truck","0","0","0","5612","5612","0"
"2017-12-31T00:00:00.000","Pierce","WA","Truck","0","0","0","137050","137050","0"
"2017-12-31T00:00:00.000","Pierce","WA","Passenger","1272","1038","2310","526335","528645","0.4369662060551031410492863831"
"2017-12-31T00:00:00.000","San Juan","WA","Passenger","132","45","177","13852","14029","1.261672250338584360966569249"
"2017-12-31T00:00:00.000","San Juan","WA","Truck","0","0","0","5606","5606","0"
"2017-12-31T00:00:00.000","Skagit","WA","Truck","1","0","1","31738","31739","0.003150697879580327042439900438"
"2017-12-31T00:00:00.000","Skagit","WA","Passenger","195","153","348","89541","89889","0.3871441444448152721690084437"
"2017-12-31T00:00:00.000","Skamania","WA","Passenger","12","7","19","8587","8606","0.2207762026493144317917731815"
"2017-12-31T00:00:00.000","Skamania","WA","Truck","0","0","0","3895","3895","0"
"2017-12-31T00:00:00.000","Snohomish","WA","Passenger","2128","1141","3269","516832","520101","0.6285317659454605932309301463"
"2017-12-31T00:00:00.000","Snohomish","WA","Truck","1","0","1","121420","121421","0.0008235807644476655603231730920"
"2017-12-31T00:00:00.000","Spokane","WA","Passenger","328","268","596","300118","300714","0.1981949626555464660774024488"
"2017-12-31T00:00:00.000","Spokane","WA","Truck","1","0","1","91607","91608","0.001091607719849794777748668239"
"2017-12-31T00:00:00.000","Stevens","WA","Truck","0","0","0","18372","18372","0"
"2017-12-31T00:00:00.000","Stevens","WA","Passenger","12","23","35","31523","31558","0.1109069015780467710247797706"
"2017-12-31T00:00:00.000","Thurston","WA","Truck","0","0","0","53772","53772","0"
"2017-12-31T00:00:00.000","Thurston","WA","Passenger","540","418","958","190009","190967","0.5016573544120188304785643593"
"2017-12-31T00:00:00.000","Wahkiakum","WA","Passenger","2","2","4","2858","2862","0.1397624039133473095737246681"
"2017-12-31T00:00:00.000","Wahkiakum","WA","Truck","0","0","0","1671","1671","0"
"2017-12-31T00:00:00.000","Walla Walla","WA","Passenger","29","32","61","35302","35363","0.1724966773181008398608715324"
"2017-12-31T00:00:00.000","Walla Walla","WA","Truck","0","0","0","13294","13294","0"
"2017-12-31T00:00:00.000","Whatcom","WA","Truck","1","0","1","42022","42023","0.002379649239702067915189301097"
"2017-12-31T00:00:00.000","Whatcom","WA","Passenger","575","242","817","145179","145996","0.5596043727225403435710567413"
"2017-12-31T00:00:00.000","Whitman","WA","Truck","0","0","0","8453","8453","0"
"2017-12-31T00:00:00.000","Whitman","WA","Passenger","18","22","40","22444","22484","0.1779042874933285892190001779"
"2017-12-31T00:00:00.000","Yakima","WA","Truck","0","0","0","58014","58014","0"
"2017-12-31T00:00:00.000","Yakima","WA","Passenger","69","80","149","162077","162226","0.09184717616165103004450581288"
"2017-12-31T00:00:00.000","Ozaukee","WI","Passenger","0","1","1","3","4","25.00"
"2017-12-31T00:00:00.000",,,"Passenger","3","0","3","241","244","1.229508196721311475409836066"
"2018-01-31T00:00:00.000","Juneau","AK","Passenger","0","1","1","43","44","2.272727272727272727272727273"
"2018-01-31T00:00:00.000","Dale","AL","Passenger","0","1","1","70","71","1.408450704225352112676056338"
"2018-01-31T00:00:00.000","Lee","AL","Passenger","1","0","1","35","36","2.777777777777777777777777778"
"2018-01-31T00:00:00.000","Maricopa","AZ","Passenger","3","1","4","1547","1551","0.2578981302385557704706640877"
"2018-01-31T00:00:00.000","Pima","AZ","Passenger","0","1","1","402","403","0.2481389578163771712158808933"
"2018-01-31T00:00:00.000","Pinal","AZ","Passenger","2","0","2","188","190","1.052631578947368421052631579"
"2018-01-31T00:00:00.000","Alameda","CA","Passenger","0","1","1","352","353","0.2832861189801699716713881020"
"2018-01-31T00:00:00.000","Contra Costa","CA","Passenger","0","1","1","491","492","0.2032520325203252032520325203"
"2018-01-31T00:00:00.000","Los Angeles","CA","Passenger","6","3","9","1191","1200","0.7500"
"2018-01-31T00:00:00.000","Marin","CA","Passenger","1","0","1","54","55","1.818181818181818181818181818"
"2018-01-31T00:00:00.000","Monterey","CA","Passenger","0","2","2","195","197","1.015228426395939086294416244"
"2018-01-31T00:00:00.000","Orange","CA","Passenger","3","1","4","560","564","0.7092198581560283687943262411"
"2018-01-31T00:00:00.000","Riverside","CA","Passenger","0","2","2","711","713","0.2805049088359046283309957924"
"2018-01-31T00:00:00.000","Sacramento","CA","Passenger","1","0","1","300","301","0.3322259136212624584717607973"
"2018-01-31T00:00:00.000","San Diego","CA","Passenger","6","2","8","2587","2595","0.3082851637764932562620423892"
"2018-01-31T00:00:00.000","San Mateo","CA","Passenger","0","1","1","140","141","0.7092198581560283687943262411"
"2018-01-31T00:00:00.000","Santa Clara","CA","Passenger","7","1","8","380","388","2.061855670103092783505154639"
"2018-01-31T00:00:00.000","Tuolumne","CA","Passenger","0","1","1","12","13","7.692307692307692307692307692"
"2018-01-31T00:00:00.000","Ventura","CA","Passenger","0","1","1","327","328","0.3048780487804878048780487805"
"2018-01-31T00:00:00.000","El Paso","CO","Passenger","2","0","2","761","763","0.2621231979030144167758846658"
"2018-01-31T00:00:00.000","Larimer","CO","Passenger","0","1","1","66","67","1.492537313432835820895522388"
"2018-01-31T00:00:00.000","New London","CT","Passenger","1","1","2","266","268","0.7462686567164179104477611940"
"2018-01-31T00:00:00.000","District of Columbia","DC","Passenger","0","4","4","195","199","2.010050251256281407035175879"
"2018-01-31T00:00:00.000","Kent","DE","Passenger","0","1","1","74","75","1.333333333333333333333333333"
"2018-01-31T00:00:00.000","New Castle","DE","Passenger","1","0","1","26","27","3.703703703703703703703703704"
"2018-01-31T00:00:00.000","Brevard","FL","Passenger","0","1","1","97","98","1.020408163265306122448979592"
"2018-01-31T00:00:00.000","Clay","FL","Passenger","0","1","1","102","103","0.9708737864077669902912621359"
"2018-01-31T00:00:00.000","Duval","FL","Passenger","1","1","2","364","366","0.5464480874316939890710382514"
"2018-01-31T00:00:00.000","Manatee","FL","Passenger","1","0","1","38","39","2.564102564102564102564102564"
"2018-01-31T00:00:00.000","Miami-Dade","FL","Passenger","0","1","1","117","118","0.8474576271186440677966101695"
"2018-01-31T00:00:00.000","Okaloosa","FL","Passenger","1","0","1","176","177","0.5649717514124293785310734463"
"2018-01-31T00:00:00.000","Orange","FL","Passenger","2","1","3","164","167","1.796407185628742514970059880"
"2018-01-31T00:00:00.000","Palm Beach","FL","Passenger","0","1","1","79","80","1.2500"
"2018-01-31T00:00:00.000","Polk","FL","Passenger","1","0","1","62","63","1.587301587301587301587301587"
"2018-01-31T00:00:00.000","Santa Rosa","FL","Passenger","1","0","1","103","104","0.9615384615384615384615384615"
"2018-01-31T00:00:00.000","St. Lucie","FL","Passenger","1","0","1","24","25","4.00"
"2018-01-31T00:00:00.000","Sumter","FL","Passenger","0","1","1","10","11","9.090909090909090909090909091"
"2018-01-31T00:00:00.000","Volusia","FL","Passenger","0","1","1","32","33","3.030303030303030303030303030"
"2018-01-31T00:00:00.000","Camden","GA","Passenger","0","1","1","168","169","0.5917159763313609467455621302"
"2018-01-31T00:00:00.000","Columbia","GA","Passenger","1","1","2","162","164","1.219512195121951219512195122"
"2018-01-31T00:00:00.000","DeKalb","GA","Passenger","1","0","1","81","82","1.219512195121951219512195122"
"2018-01-31T00:00:00.000","Fulton","GA","Passenger","1","0","1","101","102","0.9803921568627450980392156863"
"2018-01-31T00:00:00.000","Gwinnett","GA","Passenger","0","1","1","84","85","1.176470588235294117647058824"
"2018-01-31T00:00:00.000","Liberty","GA","Passenger","1","0","1","149","150","0.6666666666666666666666666667"
"2018-01-31T00:00:00.000","Lumpkin","GA","Passenger","1","0","1","7","8","12.500"
"2018-01-31T00:00:00.000","Honolulu","HI","Passenger","3","1","4","553","557","0.7181328545780969479353680431"
"2018-01-31T00:00:00.000","Maui","HI","Passenger","1","0","1","66","67","1.492537313432835820895522388"
"2018-01-31T00:00:00.000","Ada","ID","Passenger","0","1","1","340","341","0.2932551319648093841642228739"
"2018-01-31T00:00:00.000","Canyon","ID","Passenger","0","1","1","89","90","1.111111111111111111111111111"
"2018-01-31T00:00:00.000","Latah","ID","Passenger","0","1","1","74","75","1.333333333333333333333333333"
"2018-01-31T00:00:00.000","Madison","ID","Passenger","1","0","1","39","40","2.500"
"2018-01-31T00:00:00.000","Twin Falls","ID","Passenger","0","1","1","23","24","4.166666666666666666666666667"
"2018-01-31T00:00:00.000","Cook","IL","Passenger","1","0","1","279","280","0.3571428571428571428571428571"
"2018-01-31T00:00:00.000","DuPage","IL","Passenger","1","0","1","61","62","1.612903225806451612903225806"
"2018-01-31T00:00:00.000","Sangamon","IL","Passenger","1","0","1","11","12","8.333333333333333333333333333"
"2018-01-31T00:00:00.000","St. Clair","IL","Passenger","0","1","1","157","158","0.6329113924050632911392405063"
"2018-01-31T00:00:00.000","DeKalb","IN","Passenger","1","0","1","1","2","50.0"
"2018-01-31T00:00:00.000","Hamilton","IN","Passenger","1","0","1","54","55","1.818181818181818181818181818"
"2018-01-31T00:00:00.000","Hardin","KY","Passenger","0","1","1","120","121","0.8264462809917355371900826446"
"2018-01-31T00:00:00.000","Orleans","LA","Passenger","0","1","1","47","48","2.083333333333333333333333333"
"2018-01-31T00:00:00.000","Franklin","MA","Passenger","0","1","1","3","4","25.00"
"2018-01-31T00:00:00.000","Nantucket","MA","Passenger","1","0","1","2","3","33.33333333333333333333333333"
"2018-01-31T00:00:00.000","Norfolk","MA","Passenger","1","0","1","31","32","3.12500"
"2018-01-31T00:00:00.000","Anne Arundel","MD","Passenger","0","1","1","479","480","0.2083333333333333333333333333"
"2018-01-31T00:00:00.000","Charles","MD","Passenger","0","1","1","81","82","1.219512195121951219512195122"
"2018-01-31T00:00:00.000","Frederick","MD","Passenger","0","1","1","93","94","1.063829787234042553191489362"
"2018-01-31T00:00:00.000","Howard","MD","Passenger","0","2","2","86","88","2.272727272727272727272727273"
"2018-01-31T00:00:00.000","Montgomery","MD","Passenger","1","1","2","302","304","0.6578947368421052631578947368"
"2018-01-31T00:00:00.000","Kent","MI","Passenger","0","1","1","34","35","2.857142857142857142857142857"
"2018-01-31T00:00:00.000","Dakota","MN","Passenger","0","1","1","36","37","2.702702702702702702702702703"
"2018-01-31T00:00:00.000","Kanabec","MN","Passenger","1","0","1","0","1","100"
"2018-01-31T00:00:00.000","Ramsey","MN","Passenger","1","0","1","36","37","2.702702702702702702702702703"
"2018-01-31T00:00:00.000","Flathead","MT","Passenger","1","0","1","52","53","1.886792452830188679245283019"
"2018-01-31T00:00:00.000","Gallatin","MT","Passenger","0","1","1","62","63","1.587301587301587301587301587"
"2018-01-31T00:00:00.000","Glacier","MT","Passenger","0","1","1","4","5","20.0"
"2018-01-31T00:00:00.000","Missoula","MT","Passenger","1","0","1","65","66","1.515151515151515151515151515"
"2018-01-31T00:00:00.000","Guilford","NC","Passenger","1","0","1","27","28","3.571428571428571428571428571"
"2018-01-31T00:00:00.000","Moore","NC","Passenger","0","1","1","199","200","0.500"
"2018-01-31T00:00:00.000","Carroll","NH","Passenger","0","1","1","1","2","50.0"
"2018-01-31T00:00:00.000","Essex","NJ","Passenger","1","0","1","9","10","10.0"
"2018-01-31T00:00:00.000","Morris","NJ","Passenger","1","0","1","20","21","4.761904761904761904761904762"
"2018-01-31T00:00:00.000","Santa Fe","NM","Passenger","0","1","1","42","43","2.325581395348837209302325581"
"2018-01-31T00:00:00.000","Clark","NV","Passenger","1","2","3","733","736","0.4076086956521739130434782609"
"2018-01-31T00:00:00.000","Washoe","NV","Passenger","1","0","1","120","121","0.8264462809917355371900826446"
"2018-01-31T00:00:00.000","Jefferson","NY","Passenger","1","0","1","231","232","0.4310344827586206896551724138"
"2018-01-31T00:00:00.000","Nassau","NY","Passenger","1","0","1","36","37","2.702702702702702702702702703"
"2018-01-31T00:00:00.000","Queens","NY","Passenger","1","0","1","62","63","1.587301587301587301587301587"
"2018-01-31T00:00:00.000","Saratoga","NY","Passenger","1","1","2","69","71","2.816901408450704225352112676"
"2018-01-31T00:00:00.000","Franklin","OH","Passenger","0","1","1","111","112","0.8928571428571428571428571429"
"2018-01-31T00:00:00.000","Oklahoma","OK","Passenger","0","1","1","117","118","0.8474576271186440677966101695"
"2018-01-31T00:00:00.000","Deschutes","OR","Passenger","1","0","1","171","172","0.5813953488372093023255813953"
"2018-01-31T00:00:00.000","Douglas","OR","Passenger","1","0","1","53","54","1.851851851851851851851851852"
"2018-01-31T00:00:00.000","Lane","OR","Passenger","0","1","1","194","195","0.5128205128205128205128205128"
"2018-01-31T00:00:00.000","Multnomah","OR","Passenger","3","4","7","830","837","0.8363201911589008363201911589"
"2018-01-31T00:00:00.000","Allegheny","PA","Passenger","1","0","1","79","80","1.2500"
"2018-01-31T00:00:00.000","Montgomery","PA","Passenger","1","0","1","30","31","3.225806451612903225806451613"
"2018-01-31T00:00:00.000","Northampton","PA","Passenger","0","1","1","64","65","1.538461538461538461538461538"
"2018-01-31T00:00:00.000","Newport","RI","Passenger","1","0","1","112","113","0.8849557522123893805309734513"
"2018-01-31T00:00:00.000","Richland","SC","Passenger","0","1","1","171","172","0.5813953488372093023255813953"
"2018-01-31T00:00:00.000","Hamilton","TN","Passenger","1","0","1","20","21","4.761904761904761904761904762"
"2018-01-31T00:00:00.000","Knox","TN","Passenger","1","0","1","36","37","2.702702702702702702702702703"
"2018-01-31T00:00:00.000","Montgomery","TN","Passenger","1","0","1","270","271","0.3690036900369003690036900369"
"2018-01-31T00:00:00.000","Shelby","TN","Passenger","0","1","1","107","108","0.9259259259259259259259259259"
"2018-01-31T00:00:00.000","Bexar","TX","Passenger","2","2","4","803","807","0.4956629491945477075588599752"
"2018-01-31T00:00:00.000","Dallas","TX","Passenger","0","1","1","178","179","0.5586592178770949720670391061"
"2018-01-31T00:00:00.000","El Paso","TX","Passenger","1","0","1","527","528","0.1893939393939393939393939394"
"2018-01-31T00:00:00.000","Montgomery","TX","Passenger","1","0","1","56","57","1.754385964912280701754385965"
"2018-01-31T00:00:00.000","Nueces","TX","Passenger","1","1","2","96","98","2.040816326530612244897959184"
"2018-01-31T00:00:00.000","Tarrant","TX","Passenger","1","0","1","216","217","0.4608294930875576036866359447"
"2018-01-31T00:00:00.000","Travis","TX","Passenger","0","1","1","182","183","0.5464480874316939890710382514"
"2018-01-31T00:00:00.000","Utah","UT","Passenger","0","1","1","131","132","0.7575757575757575757575757576"
"2018-01-31T00:00:00.000","Albemarle","VA","Passenger","0","1","1","30","31","3.225806451612903225806451613"
"2018-01-31T00:00:00.000","Alexandria","VA","Passenger","1","0","1","163","164","0.6097560975609756097560975610"
"2018-01-31T00:00:00.000","Arlington","VA","Passenger","1","2","3","172","175","1.714285714285714285714285714"
"2018-01-31T00:00:00.000","Fairfax","VA","Passenger","2","3","5","826","831","0.6016847172081829121540312876"
"2018-01-31T00:00:00.000","Manassas","VA","Passenger","0","1","1","9","10","10.0"
"2018-01-31T00:00:00.000","Norfolk","VA","Passenger","1","1","2","315","317","0.6309148264984227129337539432"
"2018-01-31T00:00:00.000","Portsmouth","VA","Passenger","0","1","1","63","64","1.562500"
"2018-01-31T00:00:00.000","Prince George","VA","Passenger","0","1","1","72","73","1.369863013698630136986301370"
"2018-01-31T00:00:00.000","Prince William","VA","Passenger","0","4","4","262","266","1.503759398496240601503759398"
"2018-01-31T00:00:00.000","Rockbridge","VA","Passenger","1","0","1","3","4","25.00"
"2018-01-31T00:00:00.000","Virginia Beach","VA","Passenger","2","1","3","673","676","0.4437869822485207100591715976"
"2018-01-31T00:00:00.000","Adams","WA","Passenger","4","4","8","12445","12453","0.06424154822131213362242030033"
"2018-01-31T00:00:00.000","Adams","WA","Truck","0","0","0","5145","5145","0"
"2018-01-31T00:00:00.000","Asotin","WA","Passenger","8","6","14","12550","12564","0.1114294810569882203120025470"
"2018-01-31T00:00:00.000","Asotin","WA","Truck","0","0","0","6564","6564","0"
"2018-01-31T00:00:00.000","Benton","WA","Passenger","185","186","371","130612","130983","0.2832428635777161921776108350"
"2018-01-31T00:00:00.000","Benton","WA","Truck","0","0","0","40722","40722","0"
"2018-01-31T00:00:00.000","Chelan","WA","Truck","0","0","0","21682","21682","0"
"2018-01-31T00:00:00.000","Chelan","WA","Passenger","95","38","133","53246","53379","0.2491616553326214428895258435"
"2018-01-31T00:00:00.000","Clallam","WA","Passenger","112","101","213","49274","49487","0.4304160688665710186513629842"
"2018-01-31T00:00:00.000","Clallam","WA","Truck","0","0","0","21284","21284","0"
"2018-01-31T00:00:00.000","Clark","WA","Passenger","959","629","1588","305230","306818","0.5175706770789197504709632421"
"2018-01-31T00:00:00.000","Clark","WA","Truck","0","0","0","78589","78589","0"
"2018-01-31T00:00:00.000","Columbia","WA","Passenger","2","1","3","2401","2404","0.1247920133111480865224625624"
"2018-01-31T00:00:00.000","Columbia","WA","Truck","0","0","0","1545","1545","0"
"2018-01-31T00:00:00.000","Cowlitz","WA","Passenger","65","78","143","70964","71107","0.2011053764045733893990746340"
"2018-01-31T00:00:00.000","Cowlitz","WA","Truck","0","0","0","28215","28215","0"
"2018-01-31T00:00:00.000","Douglas","WA","Truck","0","0","0","11790","11790","0"
"2018-01-31T00:00:00.000","Douglas","WA","Passenger","44","33","77","27226","27303","0.2820202908105336409918323994"
"2018-01-31T00:00:00.000","Ferry","WA","Passenger","1","3","4","4409","4413","0.09064128710627690913210967596"
"2018-01-31T00:00:00.000","Ferry","WA","Truck","0","0","0","3545","3545","0"
"2018-01-31T00:00:00.000","Franklin","WA","Passenger","40","52","92","57015","57107","0.1611010909345614373019069466"
"2018-01-31T00:00:00.000","Franklin","WA","Truck","0","0","0","18559","18559","0"
"2018-01-31T00:00:00.000","Garfield","WA","Truck","0","0","0","945","945","0"
"2018-01-31T00:00:00.000","Garfield","WA","Passenger","1","0","1","1329","1330","0.07518796992481203007518796992"
"2018-01-31T00:00:00.000","Grant","WA","Truck","0","0","0","25642","25642","0"
"2018-01-31T00:00:00.000","Grant","WA","Passenger","31","40","71","62306","62377","0.1138240056431056318835468201"
"2018-01-31T00:00:00.000","Grays Harbor","WA","Passenger","51","48","99","45951","46050","0.2149837133550488599348534202"
"2018-01-31T00:00:00.000","Grays Harbor","WA","Truck","0","0","0","20089","20089","0"
"2018-01-31T00:00:00.000","Island","WA","Truck","0","0","0","20784","20784","0"
"2018-01-31T00:00:00.000","Island","WA","Passenger","174","173","347","61829","62176","0.5580931549150797735460627895"
"2018-01-31T00:00:00.000","Jefferson","WA","Passenger","135","84","219","24351","24570","0.8913308913308913308913308913"
"2018-01-31T00:00:00.000","Jefferson","WA","Truck","0","0","0","9489","9489","0"
"2018-01-31T00:00:00.000","King","WA","Truck","8","1","9","184857","184866","0.004868391159001655252994060563"
"2018-01-31T00:00:00.000","King","WA","Passenger","11964","5167","17131","1370701","1387832","1.234371307189919240945589956"
"2018-01-31T00:00:00.000","Kitsap","WA","Passenger","771","419","1190","176384","177574","0.6701431515875071801051955804"
"2018-01-31T00:00:00.000","Kitsap","WA","Truck","1","0","1","52767","52768","0.001895087932080048514251061249"
"2018-01-31T00:00:00.000","Kittitas","WA","Passenger","39","27","66","28636","28702","0.2299491324646366106891505818"
"2018-01-31T00:00:00.000","Kittitas","WA","Truck","0","0","0","13880","13880","0"
"2018-01-31T00:00:00.000","Klickitat","WA","Passenger","26","28","54","14929","14983","0.3604084629246479343255689782"
"2018-01-31T00:00:00.000","Klickitat","WA","Truck","0","0","0","8001","8001","0"
"2018-01-31T00:00:00.000","Lewis","WA","Truck","0","0","0","25327","25327","0"
"2018-01-31T00:00:00.000","Lewis","WA","Passenger","58","51","109","56794","56903","0.1915540481169709857125283377"
"2018-01-31T00:00:00.000","Lincoln","WA","Passenger","4","6","10","7588","7598","0.1316135825217162411160831798"
"2018-01-31T00:00:00.000","Lincoln","WA","Truck","0","0","0","4505","4505","0"
"2018-01-31T00:00:00.000","Mason","WA","Truck","0","0","0","19648","19648","0"
"2018-01-31T00:00:00.000","Mason","WA","Passenger","80","78","158","44951","45109","0.3502626970227670753064798599"
"2018-01-31T00:00:00.000","Okanogan","WA","Passenger","8","19","27","25703","25730","0.1049358725223474543334628838"
"2018-01-31T00:00:00.000","Okanogan","WA","Truck","0","0","0","16340","16340","0"
"2018-01-31T00:00:00.000","Pacific","WA","Passenger","23","14","37","15446","15483","0.2389717754957049667377123297"
"2018-01-31T00:00:00.000","Pacific","WA","Truck","0","0","0","7533","7533","0"
"2018-01-31T00:00:00.000","Pend Oreille","WA","Passenger","5","4","9","9442","9451","0.09522801819913236694529679399"
"2018-01-31T00:00:00.000","Pend Oreille","WA","Truck","0","0","0","5613","5613","0"
"2018-01-31T00:00:00.000","Pierce","WA","Truck","0","0","0","137174","137174","0"
"2018-01-31T00:00:00.000","Pierce","WA","Passenger","1299","1070","2369","527309","529678","0.4472528592843199075664837883"
"2018-01-31T00:00:00.000","San Juan","WA","Passenger","137","48","185","13925","14110","1.311126860382707299787384833"
"2018-01-31T00:00:00.000","San Juan","WA","Truck","0","0","0","5646","5646","0"
"2018-01-31T00:00:00.000","Skagit","WA","Truck","1","0","1","31847","31848","0.003139914594323034413463953780"
"2018-01-31T00:00:00.000","Skagit","WA","Passenger","199","155","354","89767","90121","0.3928052285260926975954549994"
"2018-01-31T00:00:00.000","Skamania","WA","Passenger","13","8","21","8607","8628","0.2433936022253129346314325452"
"2018-01-31T00:00:00.000","Skamania","WA","Truck","0","0","0","3899","3899","0"
"2018-01-31T00:00:00.000","Snohomish","WA","Passenger","2195","1184","3379","517976","521355","0.6481188441656836512549030891"
"2018-01-31T00:00:00.000","Snohomish","WA","Truck","1","0","1","121568","121569","0.0008225781243573608403458118435"
"2018-01-31T00:00:00.000","Spokane","WA","Truck","1","0","1","91768","91769","0.001089692597718183700378123331"
"2018-01-31T00:00:00.000","Spokane","WA","Passenger","332","282","614","300809","301423","0.2037004475438171606015466637"
"2018-01-31T00:00:00.000","Stevens","WA","Passenger","12","24","36","31590","31626","0.1138303927148548662492885600"
"2018-01-31T00:00:00.000","Stevens","WA","Truck","0","0","0","18383","18383","0"
"2018-01-31T00:00:00.000","Thurston","WA","Truck","0","0","0","53904","53904","0"
"2018-01-31T00:00:00.000","Thurston","WA","Passenger","559","433","992","190631","191623","0.5176831591197298862871367216"
"2018-01-31T00:00:00.000","Wahkiakum","WA","Passenger","2","2","4","2842","2846","0.1405481377371749824314827829"
"2018-01-31T00:00:00.000","Wahkiakum","WA","Truck","0","0","0","1682","1682","0"
"2018-01-31T00:00:00.000","Walla Walla","WA","Passenger","30","33","63","35390","35453","0.1777000535920796547541815925"
"2018-01-31T00:00:00.000","Walla Walla","WA","Truck","0","0","0","13326","13326","0"
"2018-01-31T00:00:00.000","Whatcom","WA","Truck","1","0","1","42075","42076","0.002376651772982222644738092975"
"2018-01-31T00:00:00.000","Whatcom","WA","Passenger","593","253","846","145493","146339","0.5781097315138138158659004093"
"2018-01-31T00:00:00.000","Whitman","WA","Passenger","19","22","41","22492","22533","0.1819553543691474725957484578"
"2018-01-31T00:00:00.000","Whitman","WA","Truck","0","0","0","8475","8475","0"
"2018-01-31T00:00:00.000","Yakima","WA","Truck","0","0","0","58108","58108","0"
"2018-01-31T00:00:00.000","Yakima","WA","Passenger","72","81","153","162514","162667","0.09405718430904854703166591872"
"2018-01-31T00:00:00.000","Ozaukee","WI","Passenger","0","1","1","3","4","25.00"
"2018-01-31T00:00:00.000",,,"Passenger","3","0","3","239","242","1.239669421487603305785123967"
"2018-02-28T00:00:00.000","Juneau","AK","Passenger","0","1","1","42","43","2.325581395348837209302325581"
"2018-02-28T00:00:00.000","Dale","AL","Passenger","0","1","1","68","69","1.449275362318840579710144928"
"2018-02-28T00:00:00.000","Lee","AL","Passenger","1","0","1","34","35","2.857142857142857142857142857"
"2018-02-28T00:00:00.000","Maricopa","AZ","Passenger","3","1","4","1523","1527","0.2619515389652914210870988867"
"2018-02-28T00:00:00.000","Pima","AZ","Passenger","0","1","1","403","404","0.2475247524752475247524752475"
"2018-02-28T00:00:00.000","Pinal","AZ","Passenger","2","0","2","188","190","1.052631578947368421052631579"
"2018-02-28T00:00:00.000","Alameda","CA","Passenger","0","1","1","351","352","0.2840909090909090909090909091"
"2018-02-28T00:00:00.000","Contra Costa","CA","Passenger","0","1","1","491","492","0.2032520325203252032520325203"
"2018-02-28T00:00:00.000","Los Angeles","CA","Passenger","6","3","9","1185","1194","0.7537688442211055276381909548"
"2018-02-28T00:00:00.000","Marin","CA","Passenger","1","0","1","55","56","1.785714285714285714285714286"
"2018-02-28T00:00:00.000","Monterey","CA","Passenger","0","2","2","194","196","1.020408163265306122448979592"
"2018-02-28T00:00:00.000","Orange","CA","Passenger","3","1","4","569","573","0.6980802792321116928446771379"
"2018-02-28T00:00:00.000","Riverside","CA","Passenger","1","2","3","703","706","0.4249291784702549575070821530"
"2018-02-28T00:00:00.000","Sacramento","CA","Passenger","1","0","1","295","296","0.3378378378378378378378378378"
"2018-02-28T00:00:00.000","San Diego","CA","Passenger","6","2","8","2583","2591","0.3087610961018911617136240834"
"2018-02-28T00:00:00.000","San Mateo","CA","Passenger","0","1","1","136","137","0.7299270072992700729927007299"
"2018-02-28T00:00:00.000","Santa Clara","CA","Passenger","7","1","8","370","378","2.116402116402116402116402116"
"2018-02-28T00:00:00.000","Tuolumne","CA","Passenger","0","1","1","12","13","7.692307692307692307692307692"
"2018-02-28T00:00:00.000","Ventura","CA","Passenger","0","1","1","330","331","0.3021148036253776435045317221"
"2018-02-28T00:00:00.000","El Paso","CO","Passenger","2","0","2","763","765","0.2614379084967320261437908497"
"2018-02-28T00:00:00.000","Jefferson","CO","Passenger","0","1","1","74","75","1.333333333333333333333333333"
"2018-02-28T00:00:00.000","Larimer","CO","Passenger","0","1","1","66","67","1.492537313432835820895522388"
"2018-02-28T00:00:00.000","New London","CT","Passenger","1","1","2","267","269","0.7434944237918215613382899628"
"2018-02-28T00:00:00.000","District of Columbia","DC","Passenger","0","4","4","191","195","2.051282051282051282051282051"
"2018-02-28T00:00:00.000","Kent","DE","Passenger","0","1","1","74","75","1.333333333333333333333333333"
"2018-02-28T00:00:00.000","New Castle","DE","Passenger","1","0","1","26","27","3.703703703703703703703703704"
"2018-02-28T00:00:00.000","Brevard","FL","Passenger","0","1","1","97","98","1.020408163265306122448979592"
"2018-02-28T00:00:00.000","Broward","FL","Passenger","0","1","1","136","137","0.7299270072992700729927007299"
"2018-02-28T00:00:00.000","Clay","FL","Passenger","0","1","1","99","100","1.00"
"2018-02-28T00:00:00.000","Duval","FL","Passenger","1","1","2","365","367","0.5449591280653950953678474114"
"2018-02-28T00:00:00.000","Manatee","FL","Passenger","1","0","1","37","38","2.631578947368421052631578947"
"2018-02-28T00:00:00.000","Miami-Dade","FL","Passenger","0","1","1","119","120","0.8333333333333333333333333333"
"2018-02-28T00:00:00.000","Okaloosa","FL","Passenger","1","0","1","176","177","0.5649717514124293785310734463"
"2018-02-28T00:00:00.000","Orange","FL","Passenger","2","1","3","166","169","1.775147928994082840236686391"
"2018-02-28T00:00:00.000","Palm Beach","FL","Passenger","0","1","1","78","79","1.265822784810126582278481013"
"2018-02-28T00:00:00.000","Polk","FL","Passenger","1","0","1","63","64","1.562500"
"2018-02-28T00:00:00.000","Santa Rosa","FL","Passenger","1","0","1","100","101","0.9900990099009900990099009901"
"2018-02-28T00:00:00.000","St. Lucie","FL","Passenger","1","0","1","23","24","4.166666666666666666666666667"
"2018-02-28T00:00:00.000","Sumter","FL","Passenger","0","1","1","10","11","9.090909090909090909090909091"
"2018-02-28T00:00:00.000","Volusia","FL","Passenger","0","1","1","32","33","3.030303030303030303030303030"
"2018-02-28T00:00:00.000","Camden","GA","Passenger","0","1","1","170","171","0.5847953216374269005847953216"
"2018-02-28T00:00:00.000","Columbia","GA","Passenger","1","1","2","159","161","1.242236024844720496894409938"
"2018-02-28T00:00:00.000","DeKalb","GA","Passenger","1","0","1","81","82","1.219512195121951219512195122"
"2018-02-28T00:00:00.000","Fulton","GA","Passenger","1","0","1","101","102","0.9803921568627450980392156863"
"2018-02-28T00:00:00.000","Gwinnett","GA","Passenger","0","1","1","81","82","1.219512195121951219512195122"
"2018-02-28T00:00:00.000","Liberty","GA","Passenger","1","0","1","144","145","0.6896551724137931034482758621"
"2018-02-28T00:00:00.000","Lumpkin","GA","Passenger","1","0","1","7","8","12.500"
"2018-02-28T00:00:00.000","Honolulu","HI","Passenger","3","1","4","553","557","0.7181328545780969479353680431"
"2018-02-28T00:00:00.000","Maui","HI","Passenger","1","0","1","65","66","1.515151515151515151515151515"
"2018-02-28T00:00:00.000","Ada","ID","Passenger","0","2","2","336","338","0.5917159763313609467455621302"
"2018-02-28T00:00:00.000","Canyon","ID","Passenger","0","1","1","89","90","1.111111111111111111111111111"
"2018-02-28T00:00:00.000","Latah","ID","Passenger","0","1","1","74","75","1.333333333333333333333333333"
"2018-02-28T00:00:00.000","Madison","ID","Passenger","1","0","1","39","40","2.500"
"2018-02-28T00:00:00.000","Twin Falls","ID","Passenger","0","1","1","23","24","4.166666666666666666666666667"
"2018-02-28T00:00:00.000","Cook","IL","Passenger","1","0","1","280","281","0.3558718861209964412811387900"
"2018-02-28T00:00:00.000","DuPage","IL","Passenger","1","0","1","62","63","1.587301587301587301587301587"
"2018-02-28T00:00:00.000","Sangamon","IL","Passenger","1","0","1","11","12","8.333333333333333333333333333"
"2018-02-28T00:00:00.000","St. Clair","IL","Passenger","0","1","1","155","156","0.6410256410256410256410256410"
"2018-02-28T00:00:00.000","DeKalb","IN","Passenger","1","0","1","1","2","50.0"
"2018-02-28T00:00:00.000","Hamilton","IN","Passenger","1","0","1","52","53","1.886792452830188679245283019"
"2018-02-28T00:00:00.000","Hardin","KY","Passenger","0","1","1","117","118","0.8474576271186440677966101695"
"2018-02-28T00:00:00.000","Caddo","LA","Passenger","0","1","1","22","23","4.347826086956521739130434783"
"2018-02-28T00:00:00.000","Orleans","LA","Passenger","0","1","1","47","48","2.083333333333333333333333333"
"2018-02-28T00:00:00.000","Franklin","MA","Passenger","0","1","1","3","4","25.00"
"2018-02-28T00:00:00.000","Nantucket","MA","Passenger","1","0","1","3","4","25.00"
"2018-02-28T00:00:00.000","Norfolk","MA","Passenger","1","0","1","34","35","2.857142857142857142857142857"
"2018-02-28T00:00:00.000","Anne Arundel","MD","Passenger","0","1","1","483","484","0.2066115702479338842975206612"
"2018-02-28T00:00:00.000","Charles","MD","Passenger","0","1","1","81","82","1.219512195121951219512195122"
"2018-02-28T00:00:00.000","Frederick","MD","Passenger","0","1","1","93","94","1.063829787234042553191489362"
"2018-02-28T00:00:00.000","Howard","MD","Passenger","0","1","1","86","87","1.149425287356321839080459770"
"2018-02-28T00:00:00.000","Montgomery","MD","Passenger","1","1","2","302","304","0.6578947368421052631578947368"
"2018-02-28T00:00:00.000","Kent","MI","Passenger","0","1","1","34","35","2.857142857142857142857142857"
"2018-02-28T00:00:00.000","Dakota","MN","Passenger","0","1","1","34","35","2.857142857142857142857142857"
"2018-02-28T00:00:00.000","Kanabec","MN","Passenger","1","0","1","0","1","100"
"2018-02-28T00:00:00.000","Ramsey","MN","Passenger","1","0","1","35","36","2.777777777777777777777777778"
"2018-02-28T00:00:00.000","Flathead","MT","Passenger","1","0","1","53","54","1.851851851851851851851851852"
"2018-02-28T00:00:00.000","Gallatin","MT","Passenger","0","1","1","63","64","1.562500"
"2018-02-28T00:00:00.000","Glacier","MT","Passenger","0","1","1","4","5","20.0"
"2018-02-28T00:00:00.000","Missoula","MT","Passenger","1","0","1","64","65","1.538461538461538461538461538"
"2018-02-28T00:00:00.000","Guilford","NC","Passenger","1","0","1","27","28","3.571428571428571428571428571"
"2018-02-28T00:00:00.000","Moore","NC","Passenger","0","1","1","199","200","0.500"
"2018-02-28T00:00:00.000","Carroll","NH","Passenger","0","1","1","1","2","50.0"
"2018-02-28T00:00:00.000","Essex","NJ","Passenger","1","0","1","9","10","10.0"
"2018-02-28T00:00:00.000","Morris","NJ","Passenger","1","0","1","19","20","5.00"
"2018-02-28T00:00:00.000","Santa Fe","NM","Passenger","0","1","1","41","42","2.380952380952380952380952381"
"2018-02-28T00:00:00.000","Clark","NV","Passenger","1","2","3","731","734","0.4087193460490463215258855586"
"2018-02-28T00:00:00.000","Washoe","NV","Passenger","1","0","1","117","118","0.8474576271186440677966101695"
"2018-02-28T00:00:00.000","Jefferson","NY","Passenger","1","0","1","230","231","0.4329004329004329004329004329"
"2018-02-28T00:00:00.000","Nassau","NY","Passenger","1","0","1","36","37","2.702702702702702702702702703"
"2018-02-28T00:00:00.000","Queens","NY","Passenger","1","0","1","63","64","1.562500"
"2018-02-28T00:00:00.000","Saratoga","NY","Passenger","1","1","2","68","70","2.857142857142857142857142857"
"2018-02-28T00:00:00.000","Garfield","OK","Passenger","1","0","1","22","23","4.347826086956521739130434783"
"2018-02-28T00:00:00.000","Oklahoma","OK","Passenger","0","1","1","119","120","0.8333333333333333333333333333"
"2018-02-28T00:00:00.000","Deschutes","OR","Passenger","1","0","1","170","171","0.5847953216374269005847953216"
"2018-02-28T00:00:00.000","Douglas","OR","Passenger","1","0","1","56","57","1.754385964912280701754385965"
"2018-02-28T00:00:00.000","Lane","OR","Passenger","0","1","1","192","193","0.5181347150259067357512953368"
"2018-02-28T00:00:00.000","Multnomah","OR","Passenger","3","4","7","819","826","0.8474576271186440677966101695"
"2018-02-28T00:00:00.000","Allegheny","PA","Passenger","1","0","1","77","78","1.282051282051282051282051282"
"2018-02-28T00:00:00.000","Montgomery","PA","Passenger","1","0","1","30","31","3.225806451612903225806451613"
"2018-02-28T00:00:00.000","Northampton","PA","Passenger","0","1","1","60","61","1.639344262295081967213114754"
"2018-02-28T00:00:00.000","Newport","RI","Passenger","1","0","1","110","111","0.9009009009009009009009009009"
"2018-02-28T00:00:00.000","Richland","SC","Passenger","0","1","1","170","171","0.5847953216374269005847953216"
"2018-02-28T00:00:00.000","Hamilton","TN","Passenger","1","0","1","21","22","4.545454545454545454545454545"
"2018-02-28T00:00:00.000","Montgomery","TN","Passenger","1","0","1","264","265","0.3773584905660377358490566038"
"2018-02-28T00:00:00.000","Shelby","TN","Passenger","0","1","1","109","110","0.9090909090909090909090909091"
"2018-02-28T00:00:00.000","Bexar","TX","Passenger","2","2","4","788","792","0.5050505050505050505050505051"
"2018-02-28T00:00:00.000","Dallas","TX","Passenger","0","1","1","177","178","0.5617977528089887640449438202"
"2018-02-28T00:00:00.000","El Paso","TX","Passenger","1","0","1","531","532","0.1879699248120300751879699248"
"2018-02-28T00:00:00.000","Montgomery","TX","Passenger","1","0","1","57","58","1.724137931034482758620689655"
"2018-02-28T00:00:00.000","Nueces","TX","Passenger","1","1","2","97","99","2.020202020202020202020202020"
"2018-02-28T00:00:00.000","Tarrant","TX","Passenger","1","0","1","216","217","0.4608294930875576036866359447"
"2018-02-28T00:00:00.000","Travis","TX","Passenger","0","1","1","183","184","0.5434782608695652173913043478"
"2018-02-28T00:00:00.000","Utah","UT","Passenger","0","1","1","129","130","0.7692307692307692307692307692"
"2018-02-28T00:00:00.000","Alexandria","VA","Passenger","1","0","1","163","164","0.6097560975609756097560975610"
"2018-02-28T00:00:00.000","Arlington","VA","Passenger","1","2","3","171","174","1.724137931034482758620689655"
"2018-02-28T00:00:00.000","Fairfax","VA","Passenger","2","3","5","829","834","0.5995203836930455635491606715"
"2018-02-28T00:00:00.000","Manassas","VA","Passenger","0","1","1","9","10","10.0"
"2018-02-28T00:00:00.000","Norfolk","VA","Passenger","1","1","2","320","322","0.6211180124223602484472049689"
"2018-02-28T00:00:00.000","Portsmouth","VA","Passenger","0","1","1","64","65","1.538461538461538461538461538"
"2018-02-28T00:00:00.000","Prince George","VA","Passenger","0","1","1","72","73","1.369863013698630136986301370"
"2018-02-28T00:00:00.000","Prince William","VA","Passenger","0","4","4","262","266","1.503759398496240601503759398"
"2018-02-28T00:00:00.000","Rockbridge","VA","Passenger","1","0","1","2","3","33.33333333333333333333333333"
"2018-02-28T00:00:00.000","Virginia Beach","VA","Passenger","2","1","3","678","681","0.4405286343612334801762114537"
"2018-02-28T00:00:00.000","Adams","WA","Truck","0","0","0","5136","5136","0"
"2018-02-28T00:00:00.000","Adams","WA","Passenger","5","4","9","12460","12469","0.07217900392974576950838078435"
"2018-02-28T00:00:00.000","Asotin","WA","Passenger","8","6","14","12590","12604","0.1110758489368454458901935893"
"2018-02-28T00:00:00.000","Asotin","WA","Truck","0","0","0","6585","6585","0"
"2018-02-28T00:00:00.000","Benton","WA","Passenger","185","186","371","130446","130817","0.2836022841068056903919215392"
"2018-02-28T00:00:00.000","Benton","WA","Truck","0","0","0","40766","40766","0"
"2018-02-28T00:00:00.000","Chelan","WA","Truck","0","0","0","21677","21677","0"
"2018-02-28T00:00:00.000","Chelan","WA","Passenger","95","39","134","53251","53385","0.2510068371265336705066966376"
"2018-02-28T00:00:00.000","Clallam","WA","Truck","0","0","0","21293","21293","0"
"2018-02-28T00:00:00.000","Clallam","WA","Passenger","115","107","222","49351","49573","0.4478244205515098944990216448"
"2018-02-28T00:00:00.000","Clark","WA","Truck","0","0","0","78581","78581","0"
"2018-02-28T00:00:00.000","Clark","WA","Passenger","975","645","1620","305236","306856","0.5279349271319446254920874938"
"2018-02-28T00:00:00.000","Columbia","WA","Passenger","2","1","3","2407","2410","0.1244813278008298755186721992"
"2018-02-28T00:00:00.000","Columbia","WA","Truck","0","0","0","1536","1536","0"
"2018-02-28T00:00:00.000","Cowlitz","WA","Truck","0","0","0","28198","28198","0"
"2018-02-28T00:00:00.000","Cowlitz","WA","Passenger","65","79","144","70930","71074","0.2026057348678841770549005262"
"2018-02-28T00:00:00.000","Douglas","WA","Passenger","44","33","77","27317","27394","0.2810834489304227203037161422"
"2018-02-28T00:00:00.000","Douglas","WA","Truck","0","0","0","11812","11812","0"
"2018-02-28T00:00:00.000","Ferry","WA","Truck","0","0","0","3528","3528","0"
"2018-02-28T00:00:00.000","Ferry","WA","Passenger","1","3","4","4397","4401","0.09088843444671665530561236083"
"2018-02-28T00:00:00.000","Franklin","WA","Passenger","40","52","92","57014","57106","0.1611039120232549994746611564"
"2018-02-28T00:00:00.000","Franklin","WA","Truck","0","0","0","18573","18573","0"
"2018-02-28T00:00:00.000","Garfield","WA","Truck","0","0","0","943","943","0"
"2018-02-28T00:00:00.000","Garfield","WA","Passenger","1","0","1","1323","1324","0.07552870090634441087613293051"
"2018-02-28T00:00:00.000","Grant","WA","Passenger","33","42","75","62332","62407","0.1201788260932267213613857420"
"2018-02-28T00:00:00.000","Grant","WA","Truck","0","0","0","25680","25680","0"
"2018-02-28T00:00:00.000","Grays Harbor","WA","Passenger","51","50","101","45871","45972","0.2196989471852431915078743583"
"2018-02-28T00:00:00.000","Grays Harbor","WA","Truck","0","0","0","20115","20115","0"
"2018-02-28T00:00:00.000","Island","WA","Passenger","180","177","357","61867","62224","0.5737336076112111082540498843"
"2018-02-28T00:00:00.000","Island","WA","Truck","0","0","0","20825","20825","0"
"2018-02-28T00:00:00.000","Jefferson","WA","Passenger","137","84","221","24311","24532","0.9008641774009457035708462416"
"2018-02-28T00:00:00.000","Jefferson","WA","Truck","0","0","0","9514","9514","0"
"2018-02-28T00:00:00.000","King","WA","Passenger","12115","5306","17421","1368110","1385531","1.257351874479892546612093125"
"2018-02-28T00:00:00.000","King","WA","Truck","8","1","9","184141","184150","0.004887320119467825142546836818"
"2018-02-28T00:00:00.000","Kitsap","WA","Passenger","779","436","1215","176356","177571","0.6842333489139555445427462818"
"2018-02-28T00:00:00.000","Kitsap","WA","Truck","1","0","1","52849","52850","0.001892147587511825922421948912"
"2018-02-28T00:00:00.000","Kittitas","WA","Truck","0","0","0","13950","13950","0"
"2018-02-28T00:00:00.000","Kittitas","WA","Passenger","39","27","66","28689","28755","0.2295252999478351591027647366"
"2018-02-28T00:00:00.000","Klickitat","WA","Passenger","27","29","56","14940","14996","0.3734329154441184315817551347"
"2018-02-28T00:00:00.000","Klickitat","WA","Truck","0","0","0","8040","8040","0"
"2018-02-28T00:00:00.000","Lewis","WA","Truck","0","0","0","25270","25270","0"
"2018-02-28T00:00:00.000","Lewis","WA","Passenger","58","53","111","56843","56954","0.1948941250834006391122660393"
"2018-02-28T00:00:00.000","Lincoln","WA","Passenger","4","6","10","7594","7604","0.1315097317201472908995265650"
"2018-02-28T00:00:00.000","Lincoln","WA","Truck","0","0","0","4512","4512","0"
"2018-02-28T00:00:00.000","Mason","WA","Passenger","80","81","161","45023","45184","0.3563208215297450424929178470"
"2018-02-28T00:00:00.000","Mason","WA","Truck","0","0","0","19728","19728","0"
"2018-02-28T00:00:00.000","Okanogan","WA","Truck","0","0","0","16311","16311","0"
"2018-02-28T00:00:00.000","Okanogan","WA","Passenger","8","19","27","25663","25690","0.1050992604126119112495134293"
"2018-02-28T00:00:00.000","Pacific","WA","Passenger","23","18","41","15455","15496","0.2645844088797108931337119257"
"2018-02-28T00:00:00.000","Pacific","WA","Truck","0","0","0","7560","7560","0"
"2018-02-28T00:00:00.000","Pend Oreille","WA","Passenger","5","3","8","9420","9428","0.08485362749257530759439966059"
"2018-02-28T00:00:00.000","Pend Oreille","WA","Truck","0","0","0","5626","5626","0"
"2018-02-28T00:00:00.000","Pierce","WA","Passenger","1320","1104","2424","526301","528725","0.4584613929736630573549576812"
"2018-02-28T00:00:00.000","Pierce","WA","Truck","0","0","0","137042","137042","0"
"2018-02-28T00:00:00.000","San Juan","WA","Passenger","140","50","190","13920","14110","1.346562721474131821403260099"
"2018-02-28T00:00:00.000","San Juan","WA","Truck","0","0","0","5642","5642","0"
"2018-02-28T00:00:00.000","Skagit","WA","Passenger","201","160","361","89735","90096","0.4006837151482862724205292133"
"2018-02-28T00:00:00.000","Skagit","WA","Truck","1","0","1","31822","31823","0.003142381296546522955095371272"
"2018-02-28T00:00:00.000","Skamania","WA","Passenger","13","8","21","8623","8644","0.2429430819065247570569180935"
"2018-02-28T00:00:00.000","Skamania","WA","Truck","0","0","0","3920","3920","0"
"2018-02-28T00:00:00.000","Snohomish","WA","Truck","1","0","1","121350","121351","0.0008240558380235844780842349878"
"2018-02-28T00:00:00.000","Snohomish","WA","Passenger","2211","1209","3420","517195","520615","0.6569153789268461338993305994"
"2018-02-28T00:00:00.000","Spokane","WA","Truck","1","0","1","91752","91753","0.001089882619641864571185683302"
"2018-02-28T00:00:00.000","Spokane","WA","Passenger","338","290","628","300543","301171","0.2085194125596421966258371490"
"2018-02-28T00:00:00.000","Stevens","WA","Truck","0","0","0","18396","18396","0"
"2018-02-28T00:00:00.000","Stevens","WA","Passenger","12","23","35","31505","31540","0.1109701965757767913760304375"
"2018-02-28T00:00:00.000","Thurston","WA","Passenger","566","440","1006","190722","191728","0.5247016606859717933739464241"
"2018-02-28T00:00:00.000","Thurston","WA","Truck","0","0","0","53930","53930","0"
"2018-02-28T00:00:00.000","Wahkiakum","WA","Truck","0","0","0","1674","1674","0"
"2018-02-28T00:00:00.000","Wahkiakum","WA","Passenger","2","2","4","2858","2862","0.1397624039133473095737246681"
"2018-02-28T00:00:00.000","Walla Walla","WA","Truck","0","0","0","13326","13326","0"
"2018-02-28T00:00:00.000","Walla Walla","WA","Passenger","31","35","66","35404","35470","0.1860727375246687341415280519"
"2018-02-28T00:00:00.000","Whatcom","WA","Passenger","600","265","865","145563","146428","0.5907340126205370557543639195"
"2018-02-28T00:00:00.000","Whatcom","WA","Truck","1","0","1","42044","42045","0.002378404090855036270662385539"
"2018-02-28T00:00:00.000","Whitman","WA","Truck","0","0","0","8456","8456","0"
"2018-02-28T00:00:00.000","Whitman","WA","Passenger","19","23","42","22546","22588","0.1859394368691340534797237471"
"2018-02-28T00:00:00.000","Yakima","WA","Passenger","74","84","158","162336","162494","0.09723435942250175391091363373"
"2018-02-28T00:00:00.000","Yakima","WA","Truck","0","0","0","58128","58128","0"
"2018-02-28T00:00:00.000","Ozaukee","WI","Passenger","0","1","1","3","4","25.00"
"2018-02-28T00:00:00.000",,,"Passenger","3","0","3","239","242","1.239669421487603305785123967"
"2018-03-31T00:00:00.000","Juneau","AK","Passenger","0","1","1","43","44","2.272727272727272727272727273"
"2018-03-31T00:00:00.000","Dale","AL","Passenger","0","1","1","66","67","1.492537313432835820895522388"
"2018-03-31T00:00:00.000","Lee","AL","Passenger","1","0","1","33","34","2.941176470588235294117647059"
"2018-03-31T00:00:00.000","Maricopa","AZ","Passenger","3","2","5","1485","1490","0.3355704697986577181208053691"
"2018-03-31T00:00:00.000","Pima","AZ","Passenger","0","1","1","405","406","0.2463054187192118226600985222"
"2018-03-31T00:00:00.000","Pinal","AZ","Passenger","2","0","2","189","191","1.047120418848167539267015707"
"2018-03-31T00:00:00.000","Alameda","CA","Passenger","0","1","1","344","345","0.2898550724637681159420289855"
"2018-03-31T00:00:00.000","Contra Costa","CA","Passenger","0","1","1","490","491","0.2036659877800407331975560081"
"2018-03-31T00:00:00.000","Los Angeles","CA","Passenger","6","4","10","1172","1182","0.8460236886632825719120135364"
"2018-03-31T00:00:00.000","Marin","CA","Passenger","1","0","1","53","54","1.851851851851851851851851852"
"2018-03-31T00:00:00.000","Monterey","CA","Passenger","0","2","2","191","193","1.036269430051813471502590674"
"2018-03-31T00:00:00.000","Orange","CA","Passenger","3","1","4","567","571","0.7005253940455341506129597198"
"2018-03-31T00:00:00.000","Riverside","CA","Passenger","1","2","3","686","689","0.4354136429608127721335268505"
"2018-03-31T00:00:00.000","Sacramento","CA","Passenger","1","0","1","291","292","0.3424657534246575342465753425"
"2018-03-31T00:00:00.000","San Diego","CA","Passenger","6","2","8","2580","2588","0.3091190108191653786707882535"
"2018-03-31T00:00:00.000","San Mateo","CA","Passenger","1","1","2","133","135","1.481481481481481481481481481"
"2018-03-31T00:00:00.000","Santa Clara","CA","Passenger","6","1","7","367","374","1.871657754010695187165775401"
"2018-03-31T00:00:00.000","Tuolumne","CA","Passenger","0","1","1","12","13","7.692307692307692307692307692"
"2018-03-31T00:00:00.000","Ventura","CA","Passenger","0","1","1","324","325","0.3076923076923076923076923077"
"2018-03-31T00:00:00.000","El Paso","CO","Passenger","2","0","2","755","757","0.2642007926023778071334214003"
"2018-03-31T00:00:00.000","Jefferson","CO","Passenger","0","1","1","75","76","1.315789473684210526315789474"
"2018-03-31T00:00:00.000","Larimer","CO","Passenger","0","1","1","63","64","1.562500"
"2018-03-31T00:00:00.000","New London","CT","Passenger","1","1","2","265","267","0.7490636704119850187265917603"
"2018-03-31T00:00:00.000","District of Columbia","DC","Passenger","0","4","4","193","197","2.030456852791878172588832487"
"2018-03-31T00:00:00.000","Kent","DE","Passenger","0","1","1","73","74","1.351351351351351351351351351"
"2018-03-31T00:00:00.000","New Castle","DE","Passenger","1","0","1","27","28","3.571428571428571428571428571"
"2018-03-31T00:00:00.000","Brevard","FL","Passenger","0","1","1","95","96","1.041666666666666666666666667"
"2018-03-31T00:00:00.000","Broward","FL","Passenger","0","1","1","129","130","0.7692307692307692307692307692"
"2018-03-31T00:00:00.000","Clay","FL","Passenger","0","1","1","98","99","1.010101010101010101010101010"
"2018-03-31T00:00:00.000","Duval","FL","Passenger","1","1","2","370","372","0.5376344086021505376344086022"
"2018-03-31T00:00:00.000","Manatee","FL","Passenger","1","0","1","36","37","2.702702702702702702702702703"
"2018-03-31T00:00:00.000","Miami-Dade","FL","Passenger","0","1","1","119","120","0.8333333333333333333333333333"
"2018-03-31T00:00:00.000","Okaloosa","FL","Passenger","1","0","1","173","174","0.5747126436781609195402298851"
"2018-03-31T00:00:00.000","Orange","FL","Passenger","2","1","3","166","169","1.775147928994082840236686391"
"2018-03-31T00:00:00.000","Palm Beach","FL","Passenger","0","1","1","76","77","1.298701298701298701298701299"
"2018-03-31T00:00:00.000","Polk","FL","Passenger","1","0","1","62","63","1.587301587301587301587301587"
"2018-03-31T00:00:00.000","Santa Rosa","FL","Passenger","1","0","1","101","102","0.9803921568627450980392156863"
"2018-03-31T00:00:00.000","St. Lucie","FL","Passenger","1","0","1","24","25","4.00"
"2018-03-31T00:00:00.000","Sumter","FL","Passenger","0","1","1","10","11","9.090909090909090909090909091"
"2018-03-31T00:00:00.000","Volusia","FL","Passenger","0","1","1","31","32","3.12500"
"2018-03-31T00:00:00.000","Camden","GA","Passenger","0","1","1","170","171","0.5847953216374269005847953216"
"2018-03-31T00:00:00.000","Columbia","GA","Passenger","1","1","2","159","161","1.242236024844720496894409938"
"2018-03-31T00:00:00.000","DeKalb","GA","Passenger","1","0","1","78","79","1.265822784810126582278481013"
"2018-03-31T00:00:00.000","Fulton","GA","Passenger","1","0","1","94","95","1.052631578947368421052631579"
"2018-03-31T00:00:00.000","Gwinnett","GA","Passenger","0","1","1","81","82","1.219512195121951219512195122"
"2018-03-31T00:00:00.000","Liberty","GA","Passenger","1","0","1","144","145","0.6896551724137931034482758621"
"2018-03-31T00:00:00.000","Lumpkin","GA","Passenger","1","0","1","7","8","12.500"
"2018-03-31T00:00:00.000","Honolulu","HI","Passenger","3","1","4","543","547","0.7312614259597806215722120658"
"2018-03-31T00:00:00.000","Maui","HI","Passenger","1","0","1","64","65","1.538461538461538461538461538"
"2018-03-31T00:00:00.000","Ada","ID","Passenger","0","2","2","328","330","0.6060606060606060606060606061"
"2018-03-31T00:00:00.000","Canyon","ID","Passenger","0","1","1","88","89","1.123595505617977528089887640"
"2018-03-31T00:00:00.000","Latah","ID","Passenger","0","1","1","76","77","1.298701298701298701298701299"
"2018-03-31T00:00:00.000","Madison","ID","Passenger","1","0","1","39","40","2.500"
"2018-03-31T00:00:00.000","Twin Falls","ID","Passenger","0","1","1","24","25","4.00"
"2018-03-31T00:00:00.000","Cook","IL","Passenger","1","0","1","273","274","0.3649635036496350364963503650"
"2018-03-31T00:00:00.000","DuPage","IL","Passenger","1","0","1","62","63","1.587301587301587301587301587"
"2018-03-31T00:00:00.000","Sangamon","IL","Passenger","1","0","1","11","12","8.333333333333333333333333333"
"2018-03-31T00:00:00.000","St. Clair","IL","Passenger","0","1","1","152","153","0.6535947712418300653594771242"
"2018-03-31T00:00:00.000","DeKalb","IN","Passenger","1","0","1","1","2","50.0"
"2018-03-31T00:00:00.000","Hamilton","IN","Passenger","1","0","1","50","51","1.960784313725490196078431373"
"2018-03-31T00:00:00.000","Marion","IN","Passenger","1","0","1","118","119","0.8403361344537815126050420168"
"2018-03-31T00:00:00.000","Hardin","KY","Passenger","0","1","1","118","119","0.8403361344537815126050420168"
"2018-03-31T00:00:00.000","Caddo","LA","Passenger","0","1","1","22","23","4.347826086956521739130434783"
"2018-03-31T00:00:00.000","Orleans","LA","Passenger","0","1","1","46","47","2.127659574468085106382978723"
"2018-03-31T00:00:00.000","Franklin","MA","Passenger","0","1","1","2","3","33.33333333333333333333333333"
"2018-03-31T00:00:00.000","Nantucket","MA","Passenger","1","0","1","3","4","25.00"
"2018-03-31T00:00:00.000","Norfolk","MA","Passenger","1","0","1","32","33","3.030303030303030303030303030"
"2018-03-31T00:00:00.000","Anne Arundel","MD","Passenger","0","2","2","476","478","0.4184100418410041841004184100"
"2018-03-31T00:00:00.000","Charles","MD","Passenger","0","1","1","81","82","1.219512195121951219512195122"
"2018-03-31T00:00:00.000","Frederick","MD","Passenger","0","1","1","92","93","1.075268817204301075268817204"
"2018-03-31T00:00:00.000","Howard","MD","Passenger","0","1","1","86","87","1.149425287356321839080459770"
"2018-03-31T00:00:00.000","Montgomery","MD","Passenger","1","1","2","299","301","0.6644518272425249169435215947"
"2018-03-31T00:00:00.000","Kent","MI","Passenger","0","1","1","33","34","2.941176470588235294117647059"
"2018-03-31T00:00:00.000","Washtenaw","MI","Passenger","1","0","1","34","35","2.857142857142857142857142857"
"2018-03-31T00:00:00.000","Dakota","MN","Passenger","0","1","1","34","35","2.857142857142857142857142857"
"2018-03-31T00:00:00.000","Kanabec","MN","Passenger","1","0","1","0","1","100"
"2018-03-31T00:00:00.000","Ramsey","MN","Passenger","1","0","1","36","37","2.702702702702702702702702703"
"2018-03-31T00:00:00.000","Flathead","MT","Passenger","1","0","1","51","52","1.923076923076923076923076923"
"2018-03-31T00:00:00.000","Gallatin","MT","Passenger","0","1","1","61","62","1.612903225806451612903225806"
"2018-03-31T00:00:00.000","Glacier","MT","Passenger","0","1","1","4","5","20.0"
"2018-03-31T00:00:00.000","Guilford","NC","Passenger","1","0","1","28","29","3.448275862068965517241379310"
"2018-03-31T00:00:00.000","Moore","NC","Passenger","0","1","1","199","200","0.500"
"2018-03-31T00:00:00.000","Carroll","NH","Passenger","0","1","1","1","2","50.0"
"2018-03-31T00:00:00.000","Essex","NJ","Passenger","1","0","1","10","11","9.090909090909090909090909091"
"2018-03-31T00:00:00.000","Morris","NJ","Passenger","1","0","1","19","20","5.00"
"2018-03-31T00:00:00.000","Santa Fe","NM","Passenger","0","1","1","39","40","2.500"
"2018-03-31T00:00:00.000","Clark","NV","Passenger","1","2","3","737","740","0.4054054054054054054054054054"
"2018-03-31T00:00:00.000","Washoe","NV","Passenger","1","0","1","113","114","0.8771929824561403508771929825"
"2018-03-31T00:00:00.000","Jefferson","NY","Passenger","1","0","1","229","230","0.4347826086956521739130434783"
"2018-03-31T00:00:00.000","Nassau","NY","Passenger","1","0","1","34","35","2.857142857142857142857142857"
"2018-03-31T00:00:00.000","Queens","NY","Passenger","1","0","1","65","66","1.515151515151515151515151515"
"2018-03-31T00:00:00.000","Saratoga","NY","Passenger","1","1","2","67","69","2.898550724637681159420289855"
"2018-03-31T00:00:00.000","Garfield","OK","Passenger","1","0","1","22","23","4.347826086956521739130434783"
"2018-03-31T00:00:00.000","Oklahoma","OK","Passenger","0","1","1","116","117","0.8547008547008547008547008547"
"2018-03-31T00:00:00.000","Deschutes","OR","Passenger","1","0","1","165","166","0.6024096385542168674698795181"
"2018-03-31T00:00:00.000","Douglas","OR","Passenger","1","0","1","56","57","1.754385964912280701754385965"
"2018-03-31T00:00:00.000","Lane","OR","Passenger","0","1","1","181","182","0.5494505494505494505494505495"
"2018-03-31T00:00:00.000","Multnomah","OR","Passenger","3","4","7","799","806","0.8684863523573200992555831266"
"2018-03-31T00:00:00.000","Allegheny","PA","Passenger","1","0","1","73","74","1.351351351351351351351351351"
"2018-03-31T00:00:00.000","Montgomery","PA","Passenger","1","0","1","30","31","3.225806451612903225806451613"
"2018-03-31T00:00:00.000","Northampton","PA","Passenger","0","1","1","62","63","1.587301587301587301587301587"
"2018-03-31T00:00:00.000","Newport","RI","Passenger","1","0","1","108","109","0.9174311926605504587155963303"
"2018-03-31T00:00:00.000","Richland","SC","Passenger","0","1","1","170","171","0.5847953216374269005847953216"
"2018-03-31T00:00:00.000","Hamilton","TN","Passenger","1","0","1","21","22","4.545454545454545454545454545"
"2018-03-31T00:00:00.000","Montgomery","TN","Passenger","1","0","1","265","266","0.3759398496240601503759398496"
"2018-03-31T00:00:00.000","Shelby","TN","Passenger","0","1","1","105","106","0.9433962264150943396226415094"
"2018-03-31T00:00:00.000","Bexar","TX","Passenger","2","2","4","780","784","0.5102040816326530612244897959"
"2018-03-31T00:00:00.000","Dallas","TX","Passenger","0","1","1","179","180","0.5555555555555555555555555556"
"2018-03-31T00:00:00.000","El Paso","TX","Passenger","1","0","1","533","534","0.1872659176029962546816479401"
"2018-03-31T00:00:00.000","Montgomery","TX","Passenger","1","0","1","58","59","1.694915254237288135593220339"
"2018-03-31T00:00:00.000","Nueces","TX","Passenger","1","1","2","95","97","2.061855670103092783505154639"
"2018-03-31T00:00:00.000","Tarrant","TX","Passenger","1","0","1","210","211","0.4739336492890995260663507109"
"2018-03-31T00:00:00.000","Travis","TX","Passenger","0","1","1","185","186","0.5376344086021505376344086022"
"2018-03-31T00:00:00.000","Utah","UT","Passenger","0","1","1","132","133","0.7518796992481203007518796992"
"2018-03-31T00:00:00.000","Alexandria","VA","Passenger","1","0","1","161","162","0.6172839506172839506172839506"
"2018-03-31T00:00:00.000","Arlington","VA","Passenger","1","2","3","173","176","1.704545454545454545454545455"
"2018-03-31T00:00:00.000","Fairfax","VA","Passenger","2","3","5","827","832","0.6009615384615384615384615385"
"2018-03-31T00:00:00.000","Manassas","VA","Passenger","0","1","1","8","9","11.11111111111111111111111111"
"2018-03-31T00:00:00.000","Norfolk","VA","Passenger","1","2","3","326","329","0.9118541033434650455927051672"
"2018-03-31T00:00:00.000","Portsmouth","VA","Passenger","0","1","1","64","65","1.538461538461538461538461538"
"2018-03-31T00:00:00.000","Prince George","VA","Passenger","0","1","1","72","73","1.369863013698630136986301370"
"2018-03-31T00:00:00.000","Prince William","VA","Passenger","0","4","4","260","264","1.515151515151515151515151515"
"2018-03-31T00:00:00.000","Rockbridge","VA","Passenger","1","0","1","2","3","33.33333333333333333333333333"
"2018-03-31T00:00:00.000","Virginia Beach","VA","Passenger","2","1","3","678","681","0.4405286343612334801762114537"
"2018-03-31T00:00:00.000","Adams","WA","Passenger","5","4","9","12471","12480","0.07211538461538461538461538462"
"2018-03-31T00:00:00.000","Adams","WA","Truck","0","0","0","5149","5149","0"
"2018-03-31T00:00:00.000","Asotin","WA","Truck","0","0","0","6598","6598","0"
"2018-03-31T00:00:00.000","Asotin","WA","Passenger","8","6","14","12629","12643","0.1107332120541010836035751008"
"2018-03-31T00:00:00.000","Benton","WA","Truck","0","0","0","40806","40806","0"
"2018-03-31T00:00:00.000","Benton","WA","Passenger","187","194","381","130783","131164","0.2904760452563203317983593059"
"2018-03-31T00:00:00.000","Chelan","WA","Truck","0","0","0","21728","21728","0"
"2018-03-31T00:00:00.000","Chelan","WA","Passenger","97","40","137","53359","53496","0.2560939135636309256766861074"
"2018-03-31T00:00:00.000","Clallam","WA","Truck","0","0","0","21318","21318","0"
"2018-03-31T00:00:00.000","Clallam","WA","Passenger","126","109","235","49499","49734","0.4725137732738167048699079101"
"2018-03-31T00:00:00.000","Clark","WA","Passenger","1007","672","1679","305924","307603","0.5458334281525212692984138646"
"2018-03-31T00:00:00.000","Clark","WA","Truck","0","0","0","78642","78642","0"
"2018-03-31T00:00:00.000","Columbia","WA","Truck","0","0","0","1533","1533","0"
"2018-03-31T00:00:00.000","Columbia","WA","Passenger","2","1","3","2409","2412","0.1243781094527363184079601990"
"2018-03-31T00:00:00.000","Cowlitz","WA","Passenger","65","79","144","71213","71357","0.2018022058102218422859705425"
"2018-03-31T00:00:00.000","Cowlitz","WA","Truck","0","0","0","28286","28286","0"
"2018-03-31T00:00:00.000","Douglas","WA","Passenger","43","33","76","27417","27493","0.2764340013821700069108500346"
"2018-03-31T00:00:00.000","Douglas","WA","Truck","0","0","0","11858","11858","0"
"2018-03-31T00:00:00.000","Ferry","WA","Passenger","1","3","4","4405","4409","0.09072352007257881605806305285"
"2018-03-31T00:00:00.000","Ferry","WA","Truck","0","0","0","3505","3505","0"
"2018-03-31T00:00:00.000","Franklin","WA","Truck","0","0","0","18615","18615","0"
"2018-03-31T00:00:00.000","Franklin","WA","Passenger","42","56","98","57216","57314","0.1709878912656593502460131905"
"2018-03-31T00:00:00.000","Garfield","WA","Truck","0","0","0","953","953","0"
"2018-03-31T00:00:00.000","Garfield","WA","Passenger","1","0","1","1330","1331","0.07513148009015777610818933133"
"2018-03-31T00:00:00.000","Grant","WA","Passenger","34","46","80","62618","62698","0.1275957765797952087785894287"
"2018-03-31T00:00:00.000","Grant","WA","Truck","0","0","0","25746","25746","0"
"2018-03-31T00:00:00.000","Grays Harbor","WA","Passenger","54","53","107","46072","46179","0.2317070529894540808592650339"
"2018-03-31T00:00:00.000","Grays Harbor","WA","Truck","0","0","0","20078","20078","0"
"2018-03-31T00:00:00.000","Island","WA","Passenger","189","184","373","62046","62419","0.5975744564956183213444624233"
"2018-03-31T00:00:00.000","Island","WA","Truck","0","0","0","20853","20853","0"
"2018-03-31T00:00:00.000","Jefferson","WA","Truck","0","0","0","9517","9517","0"
"2018-03-31T00:00:00.000","Jefferson","WA","Passenger","142","94","236","24285","24521","0.9624403572448105705313812650"
"2018-03-31T00:00:00.000","King","WA","Passenger","12337","5437","17774","1367813","1385587","1.282777624212698300431513864"
"2018-03-31T00:00:00.000","King","WA","Truck","7","1","8","183775","183783","0.004352959740563599462409472040"
"2018-03-31T00:00:00.000","Kitsap","WA","Passenger","804","447","1251","176863","178114","0.7023591632325364654097937276"
"2018-03-31T00:00:00.000","Kitsap","WA","Truck","1","0","1","52980","52981","0.001887469092693607142183046753"
"2018-03-31T00:00:00.000","Kittitas","WA","Truck","0","0","0","13987","13987","0"
"2018-03-31T00:00:00.000","Kittitas","WA","Passenger","43","30","73","28751","28824","0.2532611712461837357757424369"
"2018-03-31T00:00:00.000","Klickitat","WA","Passenger","28","29","57","14969","15026","0.3793424730467190203647011846"
"2018-03-31T00:00:00.000","Klickitat","WA","Truck","0","0","0","8047","8047","0"
"2018-03-31T00:00:00.000","Lewis","WA","Truck","0","0","0","25254","25254","0"
"2018-03-31T00:00:00.000","Lewis","WA","Passenger","62","55","117","57135","57252","0.2043596730245231607629427793"
"2018-03-31T00:00:00.000","Lincoln","WA","Passenger","4","6","10","7578","7588","0.1317870321560358460727464418"
"2018-03-31T00:00:00.000","Lincoln","WA","Truck","0","0","0","4516","4516","0"
"2018-03-31T00:00:00.000","Mason","WA","Truck","0","0","0","19795","19795","0"
"2018-03-31T00:00:00.000","Mason","WA","Passenger","85","84","169","45193","45362","0.3725585291653807151360169305"
"2018-03-31T00:00:00.000","Okanogan","WA","Passenger","8","19","27","25732","25759","0.1048177336076711052447688187"
"2018-03-31T00:00:00.000","Okanogan","WA","Truck","0","0","0","16339","16339","0"
"2018-03-31T00:00:00.000","Pacific","WA","Truck","0","0","0","7576","7576","0"
"2018-03-31T00:00:00.000","Pacific","WA","Passenger","23","19","42","15455","15497","0.2710201974575724333742014583"
"2018-03-31T00:00:00.000","Pend Oreille","WA","Passenger","5","3","8","9457","9465","0.08452192287374537770734284205"
"2018-03-31T00:00:00.000","Pend Oreille","WA","Truck","0","0","0","5655","5655","0"
"2018-03-31T00:00:00.000","Pierce","WA","Passenger","1332","1130","2462","527746","530208","0.4643460679582352586154867524"
"2018-03-31T00:00:00.000","Pierce","WA","Truck","0","0","0","137125","137125","0"
"2018-03-31T00:00:00.000","San Juan","WA","Truck","0","0","0","5659","5659","0"
"2018-03-31T00:00:00.000","San Juan","WA","Passenger","140","52","192","13937","14129","1.358907212116922641375893552"
"2018-03-31T00:00:00.000","Skagit","WA","Passenger","205","169","374","89876","90250","0.4144044321329639889196675900"
"2018-03-31T00:00:00.000","Skagit","WA","Truck","1","0","1","31929","31930","0.003131850923896022549326652051"
"2018-03-31T00:00:00.000","Skamania","WA","Truck","0","0","0","3925","3925","0"
"2018-03-31T00:00:00.000","Skamania","WA","Passenger","14","8","22","8666","8688","0.2532228360957642725598526703"
"2018-03-31T00:00:00.000","Snohomish","WA","Truck","1","0","1","121248","121249","0.0008247490700954234674100404952"
"2018-03-31T00:00:00.000","Snohomish","WA","Passenger","2257","1250","3507","517851","521358","0.6726663827926300162268537166"
"2018-03-31T00:00:00.000","Spokane","WA","Truck","1","0","1","91933","91934","0.001087736854700110949159179411"
"2018-03-31T00:00:00.000","Spokane","WA","Passenger","337","301","638","301290","301928","0.2113086563684057126202273390"
"2018-03-31T00:00:00.000","Stevens","WA","Passenger","11","23","34","31595","31629","0.1074962850548547219324038066"
"2018-03-31T00:00:00.000","Stevens","WA","Truck","0","0","0","18418","18418","0"
"2018-03-31T00:00:00.000","Thurston","WA","Truck","0","0","0","54022","54022","0"
"2018-03-31T00:00:00.000","Thurston","WA","Passenger","593","459","1052","191122","192174","0.5474205667780240823420441891"
"2018-03-31T00:00:00.000","Wahkiakum","WA","Truck","0","0","0","1669","1669","0"
"2018-03-31T00:00:00.000","Wahkiakum","WA","Passenger","3","2","5","2869","2874","0.1739735560194850382741823243"
"2018-03-31T00:00:00.000","Walla Walla","WA","Truck","0","0","0","13315","13315","0"
"2018-03-31T00:00:00.000","Walla Walla","WA","Passenger","32","36","68","35482","35550","0.1912798874824191279887482419"
"2018-03-31T00:00:00.000","Whatcom","WA","Passenger","621","276","897","146095","146992","0.6102372918254054642429519974"
"2018-03-31T00:00:00.000","Whatcom","WA","Truck","2","0","2","42075","42077","0.004753190579176272072628752050"
"2018-03-31T00:00:00.000","Whitman","WA","Passenger","19","25","44","22504","22548","0.1951392584708178108923186092"
"2018-03-31T00:00:00.000","Whitman","WA","Truck","0","0","0","8456","8456","0"
"2018-03-31T00:00:00.000","Yakima","WA","Passenger","76","86","162","162831","162993","0.09939077138282012110949549981"
"2018-03-31T00:00:00.000","Yakima","WA","Truck","0","0","0","58179","58179","0"
"2018-03-31T00:00:00.000","Ozaukee","WI","Passenger","0","1","1","3","4","25.00"
"2018-03-31T00:00:00.000",,,"Passenger","2","0","2","241","243","0.8230452674897119341563786008"
"2018-04-30T00:00:00.000","Juneau","AK","Passenger","0","1","1","45","46","2.173913043478260869565217391"
"2018-04-30T00:00:00.000","Dale","AL","Passenger","0","1","1","67","68","1.470588235294117647058823529"
"2018-04-30T00:00:00.000","Lee","AL","Passenger","1","0","1","32","33","3.030303030303030303030303030"
"2018-04-30T00:00:00.000","Maricopa","AZ","Passenger","3","2","5","1492","1497","0.3340013360053440213760855043"
"2018-04-30T00:00:00.000","Pima","AZ","Passenger","0","1","1","407","408","0.2450980392156862745098039216"
"2018-04-30T00:00:00.000","Pinal","AZ","Passenger","2","0","2","187","189","1.058201058201058201058201058"
"2018-04-30T00:00:00.000","Alameda","CA","Passenger","0","1","1","342","343","0.2915451895043731778425655977"
"2018-04-30T00:00:00.000","Contra Costa","CA","Passenger","0","1","1","485","486","0.2057613168724279835390946502"
"2018-04-30T00:00:00.000","Los Angeles","CA","Passenger","7","4","11","1163","1174","0.9369676320272572402044293015"
"2018-04-30T00:00:00.000","Marin","CA","Passenger","1","0","1","55","56","1.785714285714285714285714286"
"2018-04-30T00:00:00.000","Monterey","CA","Passenger","0","1","1","188","189","0.5291005291005291005291005291"
"2018-04-30T00:00:00.000","Orange","CA","Passenger","3","1","4","567","571","0.7005253940455341506129597198"
"2018-04-30T00:00:00.000","Riverside","CA","Passenger","1","2","3","685","688","0.4360465116279069767441860465"
"2018-04-30T00:00:00.000","Sacramento","CA","Passenger","1","0","1","294","295","0.3389830508474576271186440678"
"2018-04-30T00:00:00.000","San Diego","CA","Passenger","7","2","9","2577","2586","0.3480278422273781902552204176"
"2018-04-30T00:00:00.000","San Francisco","CA","Passenger","0","1","1","128","129","0.7751937984496124031007751938"
"2018-04-30T00:00:00.000","San Mateo","CA","Passenger","1","1","2","132","134","1.492537313432835820895522388"
"2018-04-30T00:00:00.000","Santa Clara","CA","Passenger","6","1","7","371","378","1.851851851851851851851851852"
"2018-04-30T00:00:00.000","Tuolumne","CA","Passenger","0","1","1","11","12","8.333333333333333333333333333"
"2018-04-30T00:00:00.000","Ventura","CA","Passenger","0","1","1","316","317","0.3154574132492113564668769716"
"2018-04-30T00:00:00.000","El Paso","CO","Passenger","2","0","2","753","755","0.2649006622516556291390728477"
"2018-04-30T00:00:00.000","Jefferson","CO","Passenger","0","1","1","72","73","1.369863013698630136986301370"
"2018-04-30T00:00:00.000","Larimer","CO","Passenger","0","1","1","61","62","1.612903225806451612903225806"
"2018-04-30T00:00:00.000","New London","CT","Passenger","0","1","1","266","267","0.3745318352059925093632958801"
"2018-04-30T00:00:00.000","District of Columbia","DC","Passenger","0","4","4","190","194","2.061855670103092783505154639"
"2018-04-30T00:00:00.000","Kent","DE","Passenger","0","1","1","76","77","1.298701298701298701298701299"
"2018-04-30T00:00:00.000","New Castle","DE","Passenger","1","0","1","27","28","3.571428571428571428571428571"
"2018-04-30T00:00:00.000","Brevard","FL","Passenger","0","1","1","97","98","1.020408163265306122448979592"
"2018-04-30T00:00:00.000","Broward","FL","Passenger","0","1","1","127","128","0.7812500"
"2018-04-30T00:00:00.000","Clay","FL","Passenger","0","1","1","96","97","1.030927835051546391752577320"
"2018-04-30T00:00:00.000","Duval","FL","Passenger","1","1","2","373","375","0.5333333333333333333333333333"
"2018-04-30T00:00:00.000","Manatee","FL","Passenger","1","0","1","37","38","2.631578947368421052631578947"
"2018-04-30T00:00:00.000","Miami-Dade","FL","Passenger","0","1","1","116","117","0.8547008547008547008547008547"
"2018-04-30T00:00:00.000","Okaloosa","FL","Passenger","1","0","1","169","170","0.5882352941176470588235294118"
"2018-04-30T00:00:00.000","Orange","FL","Passenger","2","1","3","167","170","1.764705882352941176470588235"
"2018-04-30T00:00:00.000","Palm Beach","FL","Passenger","0","1","1","78","79","1.265822784810126582278481013"
"2018-04-30T00:00:00.000","Polk","FL","Passenger","1","0","1","63","64","1.562500"
"2018-04-30T00:00:00.000","Santa Rosa","FL","Passenger","1","0","1","102","103","0.9708737864077669902912621359"
"2018-04-30T00:00:00.000","St. Lucie","FL","Passenger","1","0","1","23","24","4.166666666666666666666666667"
"2018-04-30T00:00:00.000","Sumter","FL","Passenger","0","1","1","10","11","9.090909090909090909090909091"
"2018-04-30T00:00:00.000","Volusia","FL","Passenger","0","1","1","30","31","3.225806451612903225806451613"
"2018-04-30T00:00:00.000","Camden","GA","Passenger","0","1","1","168","169","0.5917159763313609467455621302"
"2018-04-30T00:00:00.000","Columbia","GA","Passenger","1","1","2","162","164","1.219512195121951219512195122"
"2018-04-30T00:00:00.000","DeKalb","GA","Passenger","1","0","1","80","81","1.234567901234567901234567901"
"2018-04-30T00:00:00.000","Fulton","GA","Passenger","1","1","2","95","97","2.061855670103092783505154639"
"2018-04-30T00:00:00.000","Gwinnett","GA","Passenger","0","1","1","83","84","1.190476190476190476190476190"
"2018-04-30T00:00:00.000","Liberty","GA","Passenger","1","0","1","144","145","0.6896551724137931034482758621"
"2018-04-30T00:00:00.000","Lumpkin","GA","Passenger","1","0","1","7","8","12.500"
"2018-04-30T00:00:00.000","Honolulu","HI","Passenger","3","1","4","529","533","0.7504690431519699812382739212"
"2018-04-30T00:00:00.000","Maui","HI","Passenger","1","0","1","59","60","1.666666666666666666666666667"
"2018-04-30T00:00:00.000","Ada","ID","Passenger","0","2","2","323","325","0.6153846153846153846153846154"
"2018-04-30T00:00:00.000","Canyon","ID","Passenger","0","1","1","81","82","1.219512195121951219512195122"
"2018-04-30T00:00:00.000","Kootenai","ID","Passenger","0","1","1","212","213","0.4694835680751173708920187793"
"2018-04-30T00:00:00.000","Latah","ID","Passenger","0","1","1","76","77","1.298701298701298701298701299"
"2018-04-30T00:00:00.000","Madison","ID","Passenger","1","0","1","37","38","2.631578947368421052631578947"
"2018-04-30T00:00:00.000","Twin Falls","ID","Passenger","0","1","1","23","24","4.166666666666666666666666667"
"2018-04-30T00:00:00.000","Cook","IL","Passenger","1","0","1","265","266","0.3759398496240601503759398496"
"2018-04-30T00:00:00.000","DuPage","IL","Passenger","1","0","1","60","61","1.639344262295081967213114754"
"2018-04-30T00:00:00.000","Monroe","IL","Passenger","1","0","1","4","5","20.0"
"2018-04-30T00:00:00.000","Sangamon","IL","Passenger","1","0","1","11","12","8.333333333333333333333333333"
"2018-04-30T00:00:00.000","St. Clair","IL","Passenger","0","1","1","149","150","0.6666666666666666666666666667"
"2018-04-30T00:00:00.000","DeKalb","IN","Passenger","1","0","1","1","2","50.0"
"2018-04-30T00:00:00.000","Hamilton","IN","Passenger","1","0","1","48","49","2.040816326530612244897959184"
"2018-04-30T00:00:00.000","Marion","IN","Passenger","1","0","1","118","119","0.8403361344537815126050420168"
"2018-04-30T00:00:00.000","Hardin","KY","Passenger","0","1","1","118","119","0.8403361344537815126050420168"
"2018-04-30T00:00:00.000","Caddo","LA","Passenger","0","1","1","22","23","4.347826086956521739130434783"
"2018-04-30T00:00:00.000","Orleans","LA","Passenger","0","1","1","47","48","2.083333333333333333333333333"
"2018-04-30T00:00:00.000","Franklin","MA","Passenger","0","1","1","2","3","33.33333333333333333333333333"
"2018-04-30T00:00:00.000","Nantucket","MA","Passenger","1","0","1","3","4","25.00"
"2018-04-30T00:00:00.000","Norfolk","MA","Passenger","1","0","1","31","32","3.12500"
"2018-04-30T00:00:00.000","Anne Arundel","MD","Passenger","0","2","2","458","460","0.4347826086956521739130434783"
"2018-04-30T00:00:00.000","Charles","MD","Passenger","0","1","1","82","83","1.204819277108433734939759036"
"2018-04-30T00:00:00.000","Frederick","MD","Passenger","0","1","1","91","92","1.086956521739130434782608696"
"2018-04-30T00:00:00.000","Howard","MD","Passenger","0","1","1","84","85","1.176470588235294117647058824"
"2018-04-30T00:00:00.000","Montgomery","MD","Passenger","1","1","2","296","298","0.6711409395973154362416107383"
"2018-04-30T00:00:00.000","Kent","MI","Passenger","0","1","1","32","33","3.030303030303030303030303030"
"2018-04-30T00:00:00.000","Washtenaw","MI","Passenger","1","0","1","34","35","2.857142857142857142857142857"
"2018-04-30T00:00:00.000","Dakota","MN","Passenger","0","1","1","34","35","2.857142857142857142857142857"
"2018-04-30T00:00:00.000","Kanabec","MN","Passenger","1","0","1","0","1","100"
"2018-04-30T00:00:00.000","Ramsey","MN","Passenger","1","0","1","38","39","2.564102564102564102564102564"
"2018-04-30T00:00:00.000","Flathead","MT","Passenger","1","0","1","51","52","1.923076923076923076923076923"
"2018-04-30T00:00:00.000","Gallatin","MT","Passenger","0","1","1","61","62","1.612903225806451612903225806"
"2018-04-30T00:00:00.000","Glacier","MT","Passenger","0","1","1","4","5","20.0"
"2018-04-30T00:00:00.000","Guilford","NC","Passenger","1","0","1","29","30","3.333333333333333333333333333"
"2018-04-30T00:00:00.000","Moore","NC","Passenger","0","1","1","195","196","0.5102040816326530612244897959"
"2018-04-30T00:00:00.000","Carroll","NH","Passenger","0","1","1","1","2","50.0"
"2018-04-30T00:00:00.000","Essex","NJ","Passenger","1","0","1","10","11","9.090909090909090909090909091"
"2018-04-30T00:00:00.000","Morris","NJ","Passenger","1","0","1","18","19","5.263157894736842105263157895"
"2018-04-30T00:00:00.000","Santa Fe","NM","Passenger","0","1","1","39","40","2.500"
"2018-04-30T00:00:00.000","Clark","NV","Passenger","1","2","3","739","742","0.4043126684636118598382749326"
"2018-04-30T00:00:00.000","Washoe","NV","Passenger","1","0","1","108","109","0.9174311926605504587155963303"
"2018-04-30T00:00:00.000","Jefferson","NY","Passenger","1","0","1","227","228","0.4385964912280701754385964912"
"2018-04-30T00:00:00.000","Nassau","NY","Passenger","1","0","1","36","37","2.702702702702702702702702703"
"2018-04-30T00:00:00.000","Queens","NY","Passenger","1","0","1","64","65","1.538461538461538461538461538"
"2018-04-30T00:00:00.000","Saratoga","NY","Passenger","1","1","2","66","68","2.941176470588235294117647059"
"2018-04-30T00:00:00.000","Garfield","OK","Passenger","1","0","1","20","21","4.761904761904761904761904762"
"2018-04-30T00:00:00.000","Jackson","OK","Passenger","1","0","1","46","47","2.127659574468085106382978723"
"2018-04-30T00:00:00.000","Oklahoma","OK","Passenger","0","1","1","116","117","0.8547008547008547008547008547"
"2018-04-30T00:00:00.000","Tulsa","OK","Passenger","0","1","1","47","48","2.083333333333333333333333333"
"2018-04-30T00:00:00.000","Clackamas","OR","Passenger","0","1","1","221","222","0.4504504504504504504504504505"
"2018-04-30T00:00:00.000","Deschutes","OR","Passenger","1","0","1","165","166","0.6024096385542168674698795181"
"2018-04-30T00:00:00.000","Douglas","OR","Passenger","1","0","1","55","56","1.785714285714285714285714286"
"2018-04-30T00:00:00.000","Klamath","OR","Passenger","1","0","1","29","30","3.333333333333333333333333333"
"2018-04-30T00:00:00.000","Lane","OR","Passenger","0","1","1","182","183","0.5464480874316939890710382514"
"2018-04-30T00:00:00.000","Multnomah","OR","Passenger","4","4","8","798","806","0.9925558312655086848635235732"
"2018-04-30T00:00:00.000","Allegheny","PA","Passenger","1","0","1","72","73","1.369863013698630136986301370"
"2018-04-30T00:00:00.000","Montgomery","PA","Passenger","1","0","1","30","31","3.225806451612903225806451613"
"2018-04-30T00:00:00.000","Northampton","PA","Passenger","0","1","1","62","63","1.587301587301587301587301587"
"2018-04-30T00:00:00.000","Newport","RI","Passenger","1","0","1","110","111","0.9009009009009009009009009009"
"2018-04-30T00:00:00.000","Beaufort","SC","Passenger","1","0","1","37","38","2.631578947368421052631578947"
"2018-04-30T00:00:00.000","Richland","SC","Passenger","0","1","1","171","172","0.5813953488372093023255813953"
"2018-04-30T00:00:00.000","Hamilton","TN","Passenger","1","0","1","21","22","4.545454545454545454545454545"
"2018-04-30T00:00:00.000","Montgomery","TN","Passenger","1","0","1","268","269","0.3717472118959107806691449814"
"2018-04-30T00:00:00.000","Shelby","TN","Passenger","0","1","1","105","106","0.9433962264150943396226415094"
"2018-04-30T00:00:00.000","Bexar","TX","Passenger","2","2","4","769","773","0.5174644243208279430789133247"
"2018-04-30T00:00:00.000","Dallas","TX","Passenger","0","1","1","180","181","0.5524861878453038674033149171"
"2018-04-30T00:00:00.000","El Paso","TX","Passenger","1","0","1","525","526","0.1901140684410646387832699620"
"2018-04-30T00:00:00.000","Montgomery","TX","Passenger","1","0","1","57","58","1.724137931034482758620689655"
"2018-04-30T00:00:00.000","Nueces","TX","Passenger","1","1","2","97","99","2.020202020202020202020202020"
"2018-04-30T00:00:00.000","Tarrant","TX","Passenger","1","0","1","209","210","0.4761904761904761904761904762"
"2018-04-30T00:00:00.000","Travis","TX","Passenger","0","1","1","185","186","0.5376344086021505376344086022"
"2018-04-30T00:00:00.000","Utah","UT","Passenger","0","1","1","132","133","0.7518796992481203007518796992"
"2018-04-30T00:00:00.000","Alexandria","VA","Passenger","1","0","1","160","161","0.6211180124223602484472049689"
"2018-04-30T00:00:00.000","Arlington","VA","Passenger","1","2","3","172","175","1.714285714285714285714285714"
"2018-04-30T00:00:00.000","Fairfax","VA","Passenger","2","3","5","834","839","0.5959475566150178784266984505"
"2018-04-30T00:00:00.000","Manassas","VA","Passenger","0","1","1","9","10","10.0"
"2018-04-30T00:00:00.000","Norfolk","VA","Passenger","1","2","3","326","329","0.9118541033434650455927051672"
"2018-04-30T00:00:00.000","Portsmouth","VA","Passenger","0","1","1","65","66","1.515151515151515151515151515"
"2018-04-30T00:00:00.000","Prince George","VA","Passenger","0","1","1","72","73","1.369863013698630136986301370"
"2018-04-30T00:00:00.000","Prince William","VA","Passenger","0","4","4","259","263","1.520912547528517110266159696"
"2018-04-30T00:00:00.000","Rockbridge","VA","Passenger","1","0","1","2","3","33.33333333333333333333333333"
"2018-04-30T00:00:00.000","Virginia Beach","VA","Passenger","2","1","3","678","681","0.4405286343612334801762114537"
"2018-04-30T00:00:00.000","Adams","WA","Passenger","5","4","9","12524","12533","0.07181042048990664645336312136"
"2018-04-30T00:00:00.000","Adams","WA","Truck","0","0","0","5147","5147","0"
"2018-04-30T00:00:00.000","Asotin","WA","Passenger","8","7","15","12642","12657","0.1185114956150746622422374970"
"2018-04-30T00:00:00.000","Asotin","WA","Truck","0","0","0","6599","6599","0"
"2018-04-30T00:00:00.000","Benton","WA","Passenger","190","195","385","130944","131329","0.2931568808107881732138370048"
"2018-04-30T00:00:00.000","Benton","WA","Truck","0","0","0","40864","40864","0"
"2018-04-30T00:00:00.000","Chelan","WA","Passenger","99","44","143","53406","53549","0.2670451362303684475900577042"
"2018-04-30T00:00:00.000","Chelan","WA","Truck","0","0","0","21772","21772","0"
"2018-04-30T00:00:00.000","Clallam","WA","Passenger","124","110","234","49599","49833","0.4695683583167780386490879538"
"2018-04-30T00:00:00.000","Clallam","WA","Truck","0","0","0","21361","21361","0"
"2018-04-30T00:00:00.000","Clark","WA","Passenger","1031","689","1720","306372","308092","0.5582748010334575386572841878"
"2018-04-30T00:00:00.000","Clark","WA","Truck","0","0","0","78748","78748","0"
"2018-04-30T00:00:00.000","Columbia","WA","Truck","0","0","0","1524","1524","0"
"2018-04-30T00:00:00.000","Columbia","WA","Passenger","2","1","3","2414","2417","0.1241208109226313611915597849"
"2018-04-30T00:00:00.000","Cowlitz","WA","Passenger","65","82","147","71346","71493","0.2056145356888086945575091268"
"2018-04-30T00:00:00.000","Cowlitz","WA","Truck","0","0","0","28305","28305","0"
"2018-04-30T00:00:00.000","Douglas","WA","Passenger","42","32","74","27441","27515","0.2689442122478648010176267490"
"2018-04-30T00:00:00.000","Douglas","WA","Truck","0","0","0","11884","11884","0"
"2018-04-30T00:00:00.000","Ferry","WA","Passenger","2","3","5","4415","4420","0.1131221719457013574660633484"
"2018-04-30T00:00:00.000","Ferry","WA","Truck","0","0","0","3500","3500","0"
"2018-04-30T00:00:00.000","Franklin","WA","Truck","0","0","0","18595","18595","0"
"2018-04-30T00:00:00.000","Franklin","WA","Passenger","45","60","105","57405","57510","0.1825769431403234220135628586"
"2018-04-30T00:00:00.000","Garfield","WA","Passenger","1","0","1","1330","1331","0.07513148009015777610818933133"
"2018-04-30T00:00:00.000","Garfield","WA","Truck","0","0","0","951","951","0"
"2018-04-30T00:00:00.000","Grant","WA","Passenger","33","46","79","62809","62888","0.1256201501081287368019335962"
"2018-04-30T00:00:00.000","Grant","WA","Truck","0","0","0","25854","25854","0"
"2018-04-30T00:00:00.000","Grays Harbor","WA","Truck","0","0","0","20130","20130","0"
"2018-04-30T00:00:00.000","Grays Harbor","WA","Passenger","56","59","115","46269","46384","0.2479303208002759572266298724"
"2018-04-30T00:00:00.000","Island","WA","Passenger","198","183","381","62271","62652","0.6081210496073549128519440720"
"2018-04-30T00:00:00.000","Island","WA","Truck","0","0","0","20840","20840","0"
"2018-04-30T00:00:00.000","Jefferson","WA","Passenger","144","94","238","24351","24589","0.9679124811907763634145349547"
"2018-04-30T00:00:00.000","Jefferson","WA","Truck","0","0","0","9528","9528","0"
"2018-04-30T00:00:00.000","King","WA","Truck","7","1","8","183415","183423","0.004361503192075148699999454812"
"2018-04-30T00:00:00.000","King","WA","Passenger","12652","5571","18223","1368297","1386520","1.314297666099298964313533162"
"2018-04-30T00:00:00.000","Kitsap","WA","Truck","1","0","1","53014","53015","0.001886258606054890125436197303"
"2018-04-30T00:00:00.000","Kitsap","WA","Passenger","807","460","1267","177354","178621","0.7093230919096858712021542820"
"2018-04-30T00:00:00.000","Kittitas","WA","Truck","0","0","0","13996","13996","0"
"2018-04-30T00:00:00.000","Kittitas","WA","Passenger","43","32","75","28776","28851","0.2599563273370073827596963710"
"2018-04-30T00:00:00.000","Klickitat","WA","Passenger","27","31","58","15047","15105","0.3839788149619331347236014565"
"2018-04-30T00:00:00.000","Klickitat","WA","Truck","0","0","0","8073","8073","0"
"2018-04-30T00:00:00.000","Lewis","WA","Passenger","85","60","145","57331","57476","0.2522792121929153037789686130"
"2018-04-30T00:00:00.000","Lewis","WA","Truck","0","0","0","25311","25311","0"
"2018-04-30T00:00:00.000","Lincoln","WA","Truck","0","0","0","4533","4533","0"
"2018-04-30T00:00:00.000","Lincoln","WA","Passenger","4","7","11","7613","7624","0.1442812172088142707240293809"
"2018-04-30T00:00:00.000","Mason","WA","Passenger","88","88","176","45370","45546","0.3864225178939972774777148377"
"2018-04-30T00:00:00.000","Mason","WA","Truck","0","0","0","19810","19810","0"
"2018-04-30T00:00:00.000","Okanogan","WA","Truck","0","0","0","16356","16356","0"
"2018-04-30T00:00:00.000","Okanogan","WA","Passenger","9","19","28","25823","25851","0.1083130246412131058759815868"
"2018-04-30T00:00:00.000","Pacific","WA","Truck","0","0","0","7595","7595","0"
"2018-04-30T00:00:00.000","Pacific","WA","Passenger","24","20","44","15478","15522","0.2834686251771678907357299317"
"2018-04-30T00:00:00.000","Pend Oreille","WA","Truck","0","0","0","5651","5651","0"
"2018-04-30T00:00:00.000","Pend Oreille","WA","Passenger","5","5","10","9477","9487","0.1054073995994518815220828502"
"2018-04-30T00:00:00.000","Pierce","WA","Passenger","1361","1171","2532","529050","531582","0.4763140964140998002189690396"
"2018-04-30T00:00:00.000","Pierce","WA","Truck","0","0","0","137385","137385","0"
"2018-04-30T00:00:00.000","San Juan","WA","Truck","0","0","0","5700","5700","0"
"2018-04-30T00:00:00.000","San Juan","WA","Passenger","141","55","196","13960","14156","1.384571912969765470471884713"
"2018-04-30T00:00:00.000","Skagit","WA","Passenger","214","171","385","90022","90407","0.4258519804882365303571626091"
"2018-04-30T00:00:00.000","Skagit","WA","Truck","1","0","1","31987","31988","0.003126172314617981743153682631"
"2018-04-30T00:00:00.000","Skamania","WA","Passenger","14","8","22","8706","8728","0.2520623281393217231897341888"
"2018-04-30T00:00:00.000","Skamania","WA","Truck","0","0","0","3922","3922","0"
"2018-04-30T00:00:00.000","Snohomish","WA","Passenger","2320","1286","3606","518738","522344","0.6903496546337279647129095003"
"2018-04-30T00:00:00.000","Snohomish","WA","Truck","1","0","1","121279","121280","0.0008245382585751978891820580475"
"2018-04-30T00:00:00.000","Spokane","WA","Passenger","351","316","667","301931","302598","0.2204244575311138870712959107"
"2018-04-30T00:00:00.000","Spokane","WA","Truck","1","0","1","92090","92091","0.001085882442366789371382654114"
"2018-04-30T00:00:00.000","Stevens","WA","Passenger","12","26","38","31577","31615","0.1201961094417207021983235806"
"2018-04-30T00:00:00.000","Stevens","WA","Truck","0","0","0","18502","18502","0"
"2018-04-30T00:00:00.000","Thurston","WA","Passenger","599","470","1069","191765","192834","0.5543628198346764574711928394"
"2018-04-30T00:00:00.000","Thurston","WA","Truck","0","0","0","54078","54078","0"
"2018-04-30T00:00:00.000","Wahkiakum","WA","Passenger","2","3","5","2886","2891","0.1729505361466620546523694223"
"2018-04-30T00:00:00.000","Wahkiakum","WA","Truck","0","0","0","1670","1670","0"
"2018-04-30T00:00:00.000","Walla Walla","WA","Passenger","35","40","75","35474","35549","0.2109763987735238684632479113"
"2018-04-30T00:00:00.000","Walla Walla","WA","Truck","0","0","0","13336","13336","0"
"2018-04-30T00:00:00.000","Whatcom","WA","Truck","2","0","2","42127","42129","0.004747323696266229912886610174"
"2018-04-30T00:00:00.000","Whatcom","WA","Passenger","640","283","923","146595","147518","0.6256863569191556284656787646"
"2018-04-30T00:00:00.000","Whitman","WA","Passenger","21","26","47","22570","22617","0.2078082858027147720741035504"
"2018-04-30T00:00:00.000","Whitman","WA","Truck","0","0","0","8467","8467","0"
"2018-04-30T00:00:00.000","Yakima","WA","Truck","0","0","0","58221","58221","0"
"2018-04-30T00:00:00.000","Yakima","WA","Passenger","74","90","164","163244","163408","0.1003622833643395672182512484"
"2018-04-30T00:00:00.000","Ozaukee","WI","Passenger","0","1","1","3","4","25.00"
"2018-04-30T00:00:00.000",,,"Passenger","3","0","3","243","246","1.219512195121951219512195122"
"2018-05-31T00:00:00.000","Juneau","AK","Passenger","0","1","1","46","47","2.127659574468085106382978723"
"2018-05-31T00:00:00.000","Dale","AL","Passenger","0","1","1","63","64","1.562500"
"2018-05-31T00:00:00.000","Lee","AL","Passenger","1","0","1","33","34","2.941176470588235294117647059"
"2018-05-31T00:00:00.000","Maricopa","AZ","Passenger","3","2","5","1491","1496","0.3342245989304812834224598930"
"2018-05-31T00:00:00.000","Pima","AZ","Passenger","0","1","1","403","404","0.2475247524752475247524752475"
"2018-05-31T00:00:00.000","Pinal","AZ","Passenger","2","0","2","185","187","1.069518716577540106951871658"
"2018-05-31T00:00:00.000","Alameda","CA","Passenger","0","1","1","338","339","0.2949852507374631268436578171"
"2018-05-31T00:00:00.000","Contra Costa","CA","Passenger","0","1","1","475","476","0.2100840336134453781512605042"
"2018-05-31T00:00:00.000","Los Angeles","CA","Passenger","8","4","12","1144","1156","1.038062283737024221453287197"
"2018-05-31T00:00:00.000","Marin","CA","Passenger","1","0","1","55","56","1.785714285714285714285714286"
"2018-05-31T00:00:00.000","Monterey","CA","Passenger","0","1","1","188","189","0.5291005291005291005291005291"
"2018-05-31T00:00:00.000","Orange","CA","Passenger","3","1","4","561","565","0.7079646017699115044247787611"
"2018-05-31T00:00:00.000","Riverside","CA","Passenger","1","2","3","682","685","0.4379562043795620437956204380"
"2018-05-31T00:00:00.000","Sacramento","CA","Passenger","1","0","1","296","297","0.3367003367003367003367003367"
"2018-05-31T00:00:00.000","San Diego","CA","Passenger","7","2","9","2597","2606","0.3453568687643898695318495779"
"2018-05-31T00:00:00.000","San Francisco","CA","Passenger","0","1","1","123","124","0.8064516129032258064516129032"
"2018-05-31T00:00:00.000","San Mateo","CA","Passenger","1","1","2","133","135","1.481481481481481481481481481"
"2018-05-31T00:00:00.000","Santa Clara","CA","Passenger","7","0","7","374","381","1.837270341207349081364829396"
"2018-05-31T00:00:00.000","Tuolumne","CA","Passenger","0","1","1","10","11","9.090909090909090909090909091"
"2018-05-31T00:00:00.000","Ventura","CA","Passenger","0","1","1","312","313","0.3194888178913738019169329073"
"2018-05-31T00:00:00.000","El Paso","CO","Passenger","2","1","3","749","752","0.3989361702127659574468085106"
"2018-05-31T00:00:00.000","Jefferson","CO","Passenger","0","1","1","70","71","1.408450704225352112676056338"
"2018-05-31T00:00:00.000","Larimer","CO","Passenger","0","1","1","61","62","1.612903225806451612903225806"
"2018-05-31T00:00:00.000","New London","CT","Passenger","0","1","1","269","270","0.3703703703703703703703703704"
"2018-05-31T00:00:00.000","District of Columbia","DC","Passenger","0","4","4","190","194","2.061855670103092783505154639"
"2018-05-31T00:00:00.000","Kent","DE","Passenger","0","1","1","76","77","1.298701298701298701298701299"
"2018-05-31T00:00:00.000","New Castle","DE","Passenger","1","0","1","27","28","3.571428571428571428571428571"
"2018-05-31T00:00:00.000","Brevard","FL","Passenger","0","1","1","93","94","1.063829787234042553191489362"
"2018-05-31T00:00:00.000","Broward","FL","Passenger","0","1","1","127","128","0.7812500"
"2018-05-31T00:00:00.000","Clay","FL","Passenger","0","1","1","91","92","1.086956521739130434782608696"
"2018-05-31T00:00:00.000","Duval","FL","Passenger","1","1","2","377","379","0.5277044854881266490765171504"
"2018-05-31T00:00:00.000","Manatee","FL","Passenger","1","0","1","36","37","2.702702702702702702702702703"
"2018-05-31T00:00:00.000","Miami-Dade","FL","Passenger","0","1","1","114","115","0.8695652173913043478260869565"
"2018-05-31T00:00:00.000","Okaloosa","FL","Passenger","1","0","1","168","169","0.5917159763313609467455621302"
"2018-05-31T00:00:00.000","Orange","FL","Passenger","2","1","3","169","172","1.744186046511627906976744186"
"2018-05-31T00:00:00.000","Palm Beach","FL","Passenger","0","1","1","74","75","1.333333333333333333333333333"
"2018-05-31T00:00:00.000","Polk","FL","Passenger","1","0","1","64","65","1.538461538461538461538461538"
"2018-05-31T00:00:00.000","Santa Rosa","FL","Passenger","1","0","1","99","100","1.00"
"2018-05-31T00:00:00.000","St. Lucie","FL","Passenger","1","0","1","25","26","3.846153846153846153846153846"
"2018-05-31T00:00:00.000","Sumter","FL","Passenger","0","1","1","9","10","10.0"
"2018-05-31T00:00:00.000","Volusia","FL","Passenger","0","1","1","31","32","3.12500"
"2018-05-31T00:00:00.000","Camden","GA","Passenger","0","1","1","165","166","0.6024096385542168674698795181"
"2018-05-31T00:00:00.000","Columbia","GA","Passenger","1","1","2","163","165","1.212121212121212121212121212"
"2018-05-31T00:00:00.000","DeKalb","GA","Passenger","1","0","1","78","79","1.265822784810126582278481013"
"2018-05-31T00:00:00.000","Fulton","GA","Passenger","1","1","2","93","95","2.105263157894736842105263158"
"2018-05-31T00:00:00.000","Gwinnett","GA","Passenger","0","1","1","85","86","1.162790697674418604651162791"
"2018-05-31T00:00:00.000","Liberty","GA","Passenger","1","0","1","143","144","0.6944444444444444444444444444"
"2018-05-31T00:00:00.000","Lumpkin","GA","Passenger","1","0","1","7","8","12.500"
"2018-05-31T00:00:00.000","Honolulu","HI","Passenger","3","1","4","524","528","0.7575757575757575757575757576"
"2018-05-31T00:00:00.000","Maui","HI","Passenger","1","0","1","59","60","1.666666666666666666666666667"
"2018-05-31T00:00:00.000","Ada","ID","Passenger","0","2","2","322","324","0.6172839506172839506172839506"
"2018-05-31T00:00:00.000","Canyon","ID","Passenger","0","1","1","81","82","1.219512195121951219512195122"
"2018-05-31T00:00:00.000","Kootenai","ID","Passenger","0","1","1","208","209","0.4784688995215311004784688995"
"2018-05-31T00:00:00.000","Latah","ID","Passenger","0","1","1","74","75","1.333333333333333333333333333"
"2018-05-31T00:00:00.000","Madison","ID","Passenger","1","0","1","37","38","2.631578947368421052631578947"
"2018-05-31T00:00:00.000","Twin Falls","ID","Passenger","0","1","1","23","24","4.166666666666666666666666667"
"2018-05-31T00:00:00.000","Cook","IL","Passenger","1","0","1","260","261","0.3831417624521072796934865900"
"2018-05-31T00:00:00.000","DuPage","IL","Passenger","1","0","1","62","63","1.587301587301587301587301587"
"2018-05-31T00:00:00.000","Monroe","IL","Passenger","1","0","1","4","5","20.0"
"2018-05-31T00:00:00.000","Sangamon","IL","Passenger","1","0","1","11","12","8.333333333333333333333333333"
"2018-05-31T00:00:00.000","St. Clair","IL","Passenger","0","1","1","151","152","0.6578947368421052631578947368"
"2018-05-31T00:00:00.000","DeKalb","IN","Passenger","1","0","1","1","2","50.0"
"2018-05-31T00:00:00.000","Hamilton","IN","Passenger","1","0","1","47","48","2.083333333333333333333333333"
"2018-05-31T00:00:00.000","Marion","IN","Passenger","1","0","1","119","120","0.8333333333333333333333333333"
"2018-05-31T00:00:00.000","Hardin","KY","Passenger","0","1","1","119","120","0.8333333333333333333333333333"
"2018-05-31T00:00:00.000","Caddo","LA","Passenger","0","1","1","22","23","4.347826086956521739130434783"
"2018-05-31T00:00:00.000","Orleans","LA","Passenger","0","1","1","46","47","2.127659574468085106382978723"
"2018-05-31T00:00:00.000","Franklin","MA","Passenger","0","1","1","2","3","33.33333333333333333333333333"
"2018-05-31T00:00:00.000","Nantucket","MA","Passenger","1","0","1","3","4","25.00"
"2018-05-31T00:00:00.000","Norfolk","MA","Passenger","1","0","1","32","33","3.030303030303030303030303030"
"2018-05-31T00:00:00.000","Anne Arundel","MD","Passenger","0","2","2","455","457","0.4376367614879649890590809628"
"2018-05-31T00:00:00.000","Charles","MD","Passenger","0","1","1","84","85","1.176470588235294117647058824"
"2018-05-31T00:00:00.000","Frederick","MD","Passenger","0","1","1","92","93","1.075268817204301075268817204"
"2018-05-31T00:00:00.000","Howard","MD","Passenger","0","1","1","85","86","1.162790697674418604651162791"
"2018-05-31T00:00:00.000","Montgomery","MD","Passenger","1","1","2","291","293","0.6825938566552901023890784983"
"2018-05-31T00:00:00.000","Kent","MI","Passenger","0","1","1","29","30","3.333333333333333333333333333"
"2018-05-31T00:00:00.000","Washtenaw","MI","Passenger","1","0","1","33","34","2.941176470588235294117647059"
"2018-05-31T00:00:00.000","Dakota","MN","Passenger","0","1","1","34","35","2.857142857142857142857142857"
"2018-05-31T00:00:00.000","Kanabec","MN","Passenger","1","0","1","0","1","100"
"2018-05-31T00:00:00.000","Ramsey","MN","Passenger","1","0","1","39","40","2.500"
"2018-05-31T00:00:00.000","Flathead","MT","Passenger","1","0","1","49","50","2.00"
"2018-05-31T00:00:00.000","Gallatin","MT","Passenger","0","1","1","60","61","1.639344262295081967213114754"
"2018-05-31T00:00:00.000","Glacier","MT","Passenger","0","1","1","4","5","20.0"
"2018-05-31T00:00:00.000","Guilford","NC","Passenger","1","0","1","28","29","3.448275862068965517241379310"
"2018-05-31T00:00:00.000","Moore","NC","Passenger","0","1","1","196","197","0.5076142131979695431472081218"
"2018-05-31T00:00:00.000","Carroll","NH","Passenger","0","1","1","1","2","50.0"
"2018-05-31T00:00:00.000","Essex","NJ","Passenger","1","0","1","9","10","10.0"
"2018-05-31T00:00:00.000","Morris","NJ","Passenger","1","0","1","18","19","5.263157894736842105263157895"
"2018-05-31T00:00:00.000","Santa Fe","NM","Passenger","0","1","1","40","41","2.439024390243902439024390244"
"2018-05-31T00:00:00.000","Clark","NV","Passenger","1","2","3","738","741","0.4048582995951417004048582996"
"2018-05-31T00:00:00.000","Washoe","NV","Passenger","1","0","1","110","111","0.9009009009009009009009009009"
"2018-05-31T00:00:00.000","Jefferson","NY","Passenger","1","1","2","233","235","0.8510638297872340425531914894"
"2018-05-31T00:00:00.000","Nassau","NY","Passenger","1","0","1","35","36","2.777777777777777777777777778"
"2018-05-31T00:00:00.000","Queens","NY","Passenger","1","0","1","65","66","1.515151515151515151515151515"
"2018-05-31T00:00:00.000","Saratoga","NY","Passenger","1","1","2","65","67","2.985074626865671641791044776"
"2018-05-31T00:00:00.000","Garfield","OK","Passenger","1","0","1","19","20","5.00"
"2018-05-31T00:00:00.000","Jackson","OK","Passenger","1","0","1","45","46","2.173913043478260869565217391"
"2018-05-31T00:00:00.000","Oklahoma","OK","Passenger","0","1","1","115","116","0.8620689655172413793103448276"
"2018-05-31T00:00:00.000","Tulsa","OK","Passenger","0","1","1","48","49","2.040816326530612244897959184"
"2018-05-31T00:00:00.000","Clackamas","OR","Passenger","0","1","1","220","221","0.4524886877828054298642533937"
"2018-05-31T00:00:00.000","Deschutes","OR","Passenger","1","0","1","162","163","0.6134969325153374233128834356"
"2018-05-31T00:00:00.000","Douglas","OR","Passenger","1","0","1","53","54","1.851851851851851851851851852"
"2018-05-31T00:00:00.000","Klamath","OR","Passenger","1","0","1","29","30","3.333333333333333333333333333"
"2018-05-31T00:00:00.000","Lane","OR","Passenger","0","1","1","181","182","0.5494505494505494505494505495"
"2018-05-31T00:00:00.000","Multnomah","OR","Passenger","3","4","7","789","796","0.8793969849246231155778894472"
"2018-05-31T00:00:00.000","Washington","OR","Passenger","0","1","1","453","454","0.2202643171806167400881057269"
"2018-05-31T00:00:00.000","Allegheny","PA","Passenger","1","0","1","71","72","1.388888888888888888888888889"
"2018-05-31T00:00:00.000","Montgomery","PA","Passenger","2","0","2","30","32","6.2500"
"2018-05-31T00:00:00.000","Northampton","PA","Passenger","0","1","1","63","64","1.562500"
"2018-05-31T00:00:00.000","Newport","RI","Passenger","1","0","1","108","109","0.9174311926605504587155963303"
"2018-05-31T00:00:00.000","Beaufort","SC","Passenger","1","0","1","36","37","2.702702702702702702702702703"
"2018-05-31T00:00:00.000","Richland","SC","Passenger","0","1","1","169","170","0.5882352941176470588235294118"
"2018-05-31T00:00:00.000","Hamilton","TN","Passenger","1","0","1","21","22","4.545454545454545454545454545"
"2018-05-31T00:00:00.000","Shelby","TN","Passenger","0","1","1","106","107","0.9345794392523364485981308411"
"2018-05-31T00:00:00.000","Bexar","TX","Passenger","2","3","5","758","763","0.6553079947575360419397116645"
"2018-05-31T00:00:00.000","Dallas","TX","Passenger","0","1","1","182","183","0.5464480874316939890710382514"
"2018-05-31T00:00:00.000","El Paso","TX","Passenger","1","0","1","529","530","0.1886792452830188679245283019"
"2018-05-31T00:00:00.000","Montgomery","TX","Passenger","1","0","1","58","59","1.694915254237288135593220339"
"2018-05-31T00:00:00.000","Nueces","TX","Passenger","1","1","2","93","95","2.105263157894736842105263158"
"2018-05-31T00:00:00.000","Tarrant","TX","Passenger","1","0","1","208","209","0.4784688995215311004784688995"
"2018-05-31T00:00:00.000","Travis","TX","Passenger","0","1","1","187","188","0.5319148936170212765957446809"
"2018-05-31T00:00:00.000","Utah","UT","Passenger","0","1","1","130","131","0.7633587786259541984732824427"
"2018-05-31T00:00:00.000","Alexandria","VA","Passenger","1","0","1","163","164","0.6097560975609756097560975610"
"2018-05-31T00:00:00.000","Arlington","VA","Passenger","1","2","3","172","175","1.714285714285714285714285714"
"2018-05-31T00:00:00.000","Fairfax","VA","Passenger","2","3","5","833","838","0.5966587112171837708830548926"
"2018-05-31T00:00:00.000","Manassas","VA","Passenger","0","1","1","9","10","10.0"
"2018-05-31T00:00:00.000","Norfolk","VA","Passenger","1","2","3","329","332","0.9036144578313253012048192771"
"2018-05-31T00:00:00.000","Portsmouth","VA","Passenger","0","1","1","64","65","1.538461538461538461538461538"
"2018-05-31T00:00:00.000","Prince George","VA","Passenger","0","1","1","71","72","1.388888888888888888888888889"
"2018-05-31T00:00:00.000","Prince William","VA","Passenger","0","4","4","261","265","1.509433962264150943396226415"
"2018-05-31T00:00:00.000","Rockbridge","VA","Passenger","1","0","1","1","2","50.0"
"2018-05-31T00:00:00.000","Virginia Beach","VA","Passenger","2","1","3","684","687","0.4366812227074235807860262009"
"2018-05-31T00:00:00.000","Adams","WA","Passenger","5","5","10","12598","12608","0.07931472081218274111675126904"
"2018-05-31T00:00:00.000","Adams","WA","Truck","0","0","0","5155","5155","0"
"2018-05-31T00:00:00.000","Asotin","WA","Truck","0","0","0","6636","6636","0"
"2018-05-31T00:00:00.000","Asotin","WA","Passenger","8","7","15","12603","12618","0.1188777936281502615311459819"
"2018-05-31T00:00:00.000","Benton","WA","Passenger","200","202","402","131302","131704","0.3052299094940168863512118083"
"2018-05-31T00:00:00.000","Benton","WA","Truck","0","0","0","40995","40995","0"
"2018-05-31T00:00:00.000","Chelan","WA","Passenger","104","48","152","53507","53659","0.2832702808475744982202426434"
"2018-05-31T00:00:00.000","Chelan","WA","Truck","0","0","0","21829","21829","0"
"2018-05-31T00:00:00.000","Clallam","WA","Truck","0","0","0","21414","21414","0"
"2018-05-31T00:00:00.000","Clallam","WA","Passenger","126","115","241","49778","50019","0.4818169095743617425378356225"
"2018-05-31T00:00:00.000","Clark","WA","Truck","0","0","0","78932","78932","0"
"2018-05-31T00:00:00.000","Clark","WA","Passenger","1054","728","1782","307075","308857","0.5769660392997406566793046620"
"2018-05-31T00:00:00.000","Columbia","WA","Truck","0","0","0","1527","1527","0"
"2018-05-31T00:00:00.000","Columbia","WA","Passenger","2","1","3","2412","2415","0.1242236024844720496894409938"
"2018-05-31T00:00:00.000","Cowlitz","WA","Truck","0","0","0","28371","28371","0"
"2018-05-31T00:00:00.000","Cowlitz","WA","Passenger","68","84","152","71504","71656","0.2121245952886010941163335938"
"2018-05-31T00:00:00.000","Douglas","WA","Passenger","45","31","76","27546","27622","0.2751430019549634349431612483"
"2018-05-31T00:00:00.000","Douglas","WA","Truck","0","0","0","11905","11905","0"
"2018-05-31T00:00:00.000","Ferry","WA","Passenger","2","3","5","4418","4423","0.1130454442685959755821840380"
"2018-05-31T00:00:00.000","Ferry","WA","Truck","0","0","0","3505","3505","0"
"2018-05-31T00:00:00.000","Franklin","WA","Truck","0","0","0","18640","18640","0"
"2018-05-31T00:00:00.000","Franklin","WA","Passenger","46","64","110","57693","57803","0.1903015414424856841340414857"
"2018-05-31T00:00:00.000","Garfield","WA","Passenger","1","1","2","1326","1328","0.1506024096385542168674698795"
"2018-05-31T00:00:00.000","Garfield","WA","Truck","0","0","0","957","957","0"
"2018-05-31T00:00:00.000","Grant","WA","Passenger","32","47","79","63028","63107","0.1251842109433184908171835137"
"2018-05-31T00:00:00.000","Grant","WA","Truck","0","0","0","25862","25862","0"
"2018-05-31T00:00:00.000","Grays Harbor","WA","Truck","0","0","0","20185","20185","0"
"2018-05-31T00:00:00.000","Grays Harbor","WA","Passenger","59","62","121","46392","46513","0.2601423258013888590286586546"
"2018-05-31T00:00:00.000","Island","WA","Truck","0","0","0","20881","20881","0"
"2018-05-31T00:00:00.000","Island","WA","Passenger","201","183","384","62440","62824","0.6112313765439959251241563734"
"2018-05-31T00:00:00.000","Jefferson","WA","Passenger","149","97","246","24387","24633","0.9986603336986968700523687736"
"2018-05-31T00:00:00.000","Jefferson","WA","Truck","0","0","0","9543","9543","0"
"2018-05-31T00:00:00.000","King","WA","Truck","7","1","8","183219","183227","0.004366168741506437370038258554"
"2018-05-31T00:00:00.000","King","WA","Passenger","13114","5761","18875","1369471","1388346","1.359531413638963197934808758"
"2018-05-31T00:00:00.000","Kitsap","WA","Passenger","847","472","1319","177883","179202","0.7360408924007544558654479303"
"2018-05-31T00:00:00.000","Kitsap","WA","Truck","1","0","1","53114","53115","0.001882707333145062600018827073"
"2018-05-31T00:00:00.000","Kittitas","WA","Truck","0","0","0","14026","14026","0"
"2018-05-31T00:00:00.000","Kittitas","WA","Passenger","47","32","79","28908","28987","0.2725359643978335115741539311"
"2018-05-31T00:00:00.000","Klickitat","WA","Truck","0","0","0","8087","8087","0"
"2018-05-31T00:00:00.000","Klickitat","WA","Passenger","28","32","60","15103","15163","0.3957000593550089032513354877"
"2018-05-31T00:00:00.000","Lewis","WA","Passenger","85","63","148","57548","57696","0.2565169162506932889628397116"
"2018-05-31T00:00:00.000","Lewis","WA","Truck","0","0","0","25407","25407","0"
"2018-05-31T00:00:00.000","Lincoln","WA","Passenger","4","7","11","7644","7655","0.1436969301110385369039843240"
"2018-05-31T00:00:00.000","Lincoln","WA","Truck","0","0","0","4538","4538","0"
"2018-05-31T00:00:00.000","Mason","WA","Truck","0","0","0","19876","19876","0"
"2018-05-31T00:00:00.000","Mason","WA","Passenger","94","94","188","45569","45757","0.4108660969906243853399479861"
"2018-05-31T00:00:00.000","Okanogan","WA","Truck","0","0","0","16415","16415","0"
"2018-05-31T00:00:00.000","Okanogan","WA","Passenger","9","19","28","25885","25913","0.1080538725736117006907729711"
"2018-05-31T00:00:00.000","Pacific","WA","Passenger","26","20","46","15543","15589","0.2950798640066713708384117006"
"2018-05-31T00:00:00.000","Pacific","WA","Truck","0","0","0","7589","7589","0"
"2018-05-31T00:00:00.000","Pend Oreille","WA","Passenger","5","5","10","9513","9523","0.1050089257586894886065315552"
"2018-05-31T00:00:00.000","Pend Oreille","WA","Truck","0","0","0","5668","5668","0"
"2018-05-31T00:00:00.000","Pierce","WA","Truck","0","0","0","137566","137566","0"
"2018-05-31T00:00:00.000","Pierce","WA","Passenger","1388","1204","2592","530380","532972","0.4863294882282746560794938571"
"2018-05-31T00:00:00.000","San Juan","WA","Truck","0","0","0","5704","5704","0"
"2018-05-31T00:00:00.000","San Juan","WA","Passenger","141","58","199","14046","14245","1.396981396981396981396981397"
"2018-05-31T00:00:00.000","Skagit","WA","Truck","1","0","1","32051","32052","0.003119930113565456133782603270"
"2018-05-31T00:00:00.000","Skagit","WA","Passenger","231","179","410","90241","90651","0.4522840343735866123925825418"
"2018-05-31T00:00:00.000","Skamania","WA","Passenger","14","9","23","8705","8728","0.2635197066911090742438130156"
"2018-05-31T00:00:00.000","Skamania","WA","Truck","0","0","0","3917","3917","0"
"2018-05-31T00:00:00.000","Snohomish","WA","Passenger","2416","1315","3731","519974","523705","0.7124239791485664639443961772"
"2018-05-31T00:00:00.000","Snohomish","WA","Truck","1","0","1","121502","121503","0.0008230249458861098079882801248"
"2018-05-31T00:00:00.000","Spokane","WA","Passenger","357","332","689","302472","303161","0.2272719775960628181065506447"
"2018-05-31T00:00:00.000","Spokane","WA","Truck","1","0","1","92399","92400","0.001082251082251082251082251082"
"2018-05-31T00:00:00.000","Stevens","WA","Truck","0","0","0","18583","18583","0"
"2018-05-31T00:00:00.000","Stevens","WA","Passenger","13","27","40","31556","31596","0.1265983035827319913913153564"
"2018-05-31T00:00:00.000","Thurston","WA","Truck","0","0","0","54212","54212","0"
"2018-05-31T00:00:00.000","Thurston","WA","Passenger","624","494","1118","192352","193470","0.5778673696180286349304801778"
"2018-05-31T00:00:00.000","Wahkiakum","WA","Passenger","2","2","4","2900","2904","0.1377410468319559228650137741"
"2018-05-31T00:00:00.000","Wahkiakum","WA","Truck","0","0","0","1675","1675","0"
"2018-05-31T00:00:00.000","Walla Walla","WA","Passenger","35","42","77","35587","35664","0.2159039928218932256617317183"
"2018-05-31T00:00:00.000","Walla Walla","WA","Truck","0","0","0","13393","13393","0"
"2018-05-31T00:00:00.000","Whatcom","WA","Passenger","658","295","953","147180","148133","0.6433407815949180803737182127"
"2018-05-31T00:00:00.000","Whatcom","WA","Truck","2","0","2","42196","42198","0.004739561116640599080525143372"
"2018-05-31T00:00:00.000","Whitman","WA","Passenger","20","29","49","22591","22640","0.2164310954063604240282685512"
"2018-05-31T00:00:00.000","Whitman","WA","Truck","0","0","0","8474","8474","0"
"2018-05-31T00:00:00.000","Yakima","WA","Passenger","74","91","165","163651","163816","0.1007227621233579137568979831"
"2018-05-31T00:00:00.000","Yakima","WA","Truck","0","0","0","58344","58344","0"
"2018-05-31T00:00:00.000","Ozaukee","WI","Passenger","0","1","1","3","4","25.00"
"2018-05-31T00:00:00.000",,,"Passenger","3","0","3","242","245","1.224489795918367346938775510"
"2018-06-30T00:00:00.000","Juneau","AK","Passenger","0","1","1","46","47","2.127659574468085106382978723"
"2018-06-30T00:00:00.000","Dale","AL","Passenger","0","1","1","62","63","1.587301587301587301587301587"
"2018-06-30T00:00:00.000","Lee","AL","Passenger","1","0","1","35","36","2.777777777777777777777777778"
"2018-06-30T00:00:00.000","Cochise","AZ","Passenger","0","1","1","128","129","0.7751937984496124031007751938"
"2018-06-30T00:00:00.000","Maricopa","AZ","Passenger","3","2","5","1498","1503","0.3326679973386560212907518297"
"2018-06-30T00:00:00.000","Pima","AZ","Passenger","0","1","1","401","402","0.2487562189054726368159203980"
"2018-06-30T00:00:00.000","Pinal","AZ","Passenger","2","0","2","183","185","1.081081081081081081081081081"
"2018-06-30T00:00:00.000","Alameda","CA","Passenger","0","1","1","337","338","0.2958579881656804733727810651"
"2018-06-30T00:00:00.000","Contra Costa","CA","Passenger","0","1","1","478","479","0.2087682672233820459290187891"
"2018-06-30T00:00:00.000","Los Angeles","CA","Passenger","8","4","12","1138","1150","1.043478260869565217391304348"
"2018-06-30T00:00:00.000","Marin","CA","Passenger","1","0","1","54","55","1.818181818181818181818181818"
"2018-06-30T00:00:00.000","Monterey","CA","Passenger","0","1","1","186","187","0.5347593582887700534759358289"
"2018-06-30T00:00:00.000","Orange","CA","Passenger","3","1","4","554","558","0.7168458781362007168458781362"
"2018-06-30T00:00:00.000","Riverside","CA","Passenger","1","2","3","679","682","0.4398826979472140762463343109"
"2018-06-30T00:00:00.000","Sacramento","CA","Passenger","1","0","1","294","295","0.3389830508474576271186440678"
"2018-06-30T00:00:00.000","San Diego","CA","Passenger","7","2","9","2601","2610","0.3448275862068965517241379310"
"2018-06-30T00:00:00.000","San Francisco","CA","Passenger","1","1","2","124","126","1.587301587301587301587301587"
"2018-06-30T00:00:00.000","San Mateo","CA","Passenger","1","1","2","130","132","1.515151515151515151515151515"
"2018-06-30T00:00:00.000","Santa Clara","CA","Passenger","7","0","7","369","376","1.861702127659574468085106383"
"2018-06-30T00:00:00.000","Tuolumne","CA","Passenger","0","1","1","10","11","9.090909090909090909090909091"
"2018-06-30T00:00:00.000","Ventura","CA","Passenger","0","2","2","319","321","0.6230529595015576323987538941"
"2018-06-30T00:00:00.000","El Paso","CO","Passenger","2","1","3","750","753","0.3984063745019920318725099602"
"2018-06-30T00:00:00.000","Jefferson","CO","Passenger","0","1","1","65","66","1.515151515151515151515151515"
"2018-06-30T00:00:00.000","Larimer","CO","Passenger","0","1","1","59","60","1.666666666666666666666666667"
"2018-06-30T00:00:00.000","New London","CT","Passenger","0","1","1","268","269","0.3717472118959107806691449814"
"2018-06-30T00:00:00.000","District of Columbia","DC","Passenger","0","4","4","189","193","2.072538860103626943005181347"
"2018-06-30T00:00:00.000","Kent","DE","Passenger","0","1","1","74","75","1.333333333333333333333333333"
"2018-06-30T00:00:00.000","New Castle","DE","Passenger","1","0","1","25","26","3.846153846153846153846153846"
"2018-06-30T00:00:00.000","Brevard","FL","Passenger","0","1","1","89","90","1.111111111111111111111111111"
"2018-06-30T00:00:00.000","Broward","FL","Passenger","0","1","1","126","127","0.7874015748031496062992125984"
"2018-06-30T00:00:00.000","Clay","FL","Passenger","0","1","1","91","92","1.086956521739130434782608696"
"2018-06-30T00:00:00.000","Duval","FL","Passenger","1","1","2","378","380","0.5263157894736842105263157895"
"2018-06-30T00:00:00.000","Manatee","FL","Passenger","1","0","1","36","37","2.702702702702702702702702703"
"2018-06-30T00:00:00.000","Miami-Dade","FL","Passenger","0","1","1","112","113","0.8849557522123893805309734513"
"2018-06-30T00:00:00.000","Okaloosa","FL","Passenger","1","0","1","168","169","0.5917159763313609467455621302"
"2018-06-30T00:00:00.000","Orange","FL","Passenger","2","1","3","172","175","1.714285714285714285714285714"
"2018-06-30T00:00:00.000","Palm Beach","FL","Passenger","0","1","1","74","75","1.333333333333333333333333333"
"2018-06-30T00:00:00.000","Polk","FL","Passenger","1","0","1","66","67","1.492537313432835820895522388"
"2018-06-30T00:00:00.000","Santa Rosa","FL","Passenger","1","0","1","98","99","1.010101010101010101010101010"
"2018-06-30T00:00:00.000","St. Lucie","FL","Passenger","1","0","1","25","26","3.846153846153846153846153846"
"2018-06-30T00:00:00.000","Sumter","FL","Passenger","0","1","1","9","10","10.0"
"2018-06-30T00:00:00.000","Volusia","FL","Passenger","0","1","1","31","32","3.12500"
"2018-06-30T00:00:00.000","Bryan","GA","Passenger","1","0","1","51","52","1.923076923076923076923076923"
"2018-06-30T00:00:00.000","Camden","GA","Passenger","0","1","1","165","166","0.6024096385542168674698795181"
"2018-06-30T00:00:00.000","Columbia","GA","Passenger","1","1","2","163","165","1.212121212121212121212121212"
"2018-06-30T00:00:00.000","DeKalb","GA","Passenger","1","0","1","77","78","1.282051282051282051282051282"
"2018-06-30T00:00:00.000","Fulton","GA","Passenger","1","1","2","96","98","2.040816326530612244897959184"
"2018-06-30T00:00:00.000","Gwinnett","GA","Passenger","0","1","1","84","85","1.176470588235294117647058824"
"2018-06-30T00:00:00.000","Liberty","GA","Passenger","1","0","1","144","145","0.6896551724137931034482758621"
"2018-06-30T00:00:00.000","Lumpkin","GA","Passenger","1","0","1","7","8","12.500"
"2018-06-30T00:00:00.000","Honolulu","HI","Passenger","2","1","3","515","518","0.5791505791505791505791505792"
"2018-06-30T00:00:00.000","Maui","HI","Passenger","1","0","1","56","57","1.754385964912280701754385965"
"2018-06-30T00:00:00.000","Ada","ID","Passenger","0","2","2","313","315","0.6349206349206349206349206349"
"2018-06-30T00:00:00.000","Canyon","ID","Passenger","0","1","1","83","84","1.190476190476190476190476190"
"2018-06-30T00:00:00.000","Kootenai","ID","Passenger","0","1","1","207","208","0.4807692307692307692307692308"
"2018-06-30T00:00:00.000","Latah","ID","Passenger","0","1","1","72","73","1.369863013698630136986301370"
"2018-06-30T00:00:00.000","Madison","ID","Passenger","1","0","1","38","39","2.564102564102564102564102564"
"2018-06-30T00:00:00.000","Twin Falls","ID","Passenger","0","1","1","22","23","4.347826086956521739130434783"
"2018-06-30T00:00:00.000","Cook","IL","Passenger","1","0","1","255","256","0.39062500"
"2018-06-30T00:00:00.000","DuPage","IL","Passenger","1","0","1","60","61","1.639344262295081967213114754"
"2018-06-30T00:00:00.000","Monroe","IL","Passenger","1","0","1","4","5","20.0"
"2018-06-30T00:00:00.000","Sangamon","IL","Passenger","1","0","1","11","12","8.333333333333333333333333333"
"2018-06-30T00:00:00.000","St. Clair","IL","Passenger","0","1","1","152","153","0.6535947712418300653594771242"
"2018-06-30T00:00:00.000","DeKalb","IN","Passenger","1","0","1","1","2","50.0"
"2018-06-30T00:00:00.000","Hamilton","IN","Passenger","1","0","1","47","48","2.083333333333333333333333333"
"2018-06-30T00:00:00.000","Marion","IN","Passenger","1","0","1","118","119","0.8403361344537815126050420168"
"2018-06-30T00:00:00.000","Hardin","KY","Passenger","0","1","1","120","121","0.8264462809917355371900826446"
"2018-06-30T00:00:00.000","Caddo","LA","Passenger","0","1","1","23","24","4.166666666666666666666666667"
"2018-06-30T00:00:00.000","Orleans","LA","Passenger","0","1","1","46","47","2.127659574468085106382978723"
"2018-06-30T00:00:00.000","Franklin","MA","Passenger","0","1","1","1","2","50.0"
"2018-06-30T00:00:00.000","Nantucket","MA","Passenger","1","0","1","3","4","25.00"
"2018-06-30T00:00:00.000","Norfolk","MA","Passenger","1","0","1","33","34","2.941176470588235294117647059"
"2018-06-30T00:00:00.000","Anne Arundel","MD","Passenger","0","1","1","457","458","0.2183406113537117903930131004"
"2018-06-30T00:00:00.000","Charles","MD","Passenger","0","1","1","82","83","1.204819277108433734939759036"
"2018-06-30T00:00:00.000","Frederick","MD","Passenger","0","1","1","90","91","1.098901098901098901098901099"
"2018-06-30T00:00:00.000","Howard","MD","Passenger","0","1","1","88","89","1.123595505617977528089887640"
"2018-06-30T00:00:00.000","Montgomery","MD","Passenger","1","1","2","287","289","0.6920415224913494809688581315"
"2018-06-30T00:00:00.000","St. Mary's","MD","Passenger","1","0","1","212","213","0.4694835680751173708920187793"
"2018-06-30T00:00:00.000","Kent","MI","Passenger","0","1","1","26","27","3.703703703703703703703703704"
"2018-06-30T00:00:00.000","Washtenaw","MI","Passenger","1","0","1","33","34","2.941176470588235294117647059"
"2018-06-30T00:00:00.000","Dakota","MN","Passenger","0","1","1","35","36","2.777777777777777777777777778"
"2018-06-30T00:00:00.000","Hennepin","MN","Passenger","1","0","1","105","106","0.9433962264150943396226415094"
"2018-06-30T00:00:00.000","Kanabec","MN","Passenger","1","0","1","0","1","100"
"2018-06-30T00:00:00.000","Ramsey","MN","Passenger","1","0","1","38","39","2.564102564102564102564102564"
"2018-06-30T00:00:00.000","Flathead","MT","Passenger","1","0","1","49","50","2.00"
"2018-06-30T00:00:00.000","Gallatin","MT","Passenger","0","1","1","60","61","1.639344262295081967213114754"
"2018-06-30T00:00:00.000","Glacier","MT","Passenger","0","1","1","4","5","20.0"
"2018-06-30T00:00:00.000","Guilford","NC","Passenger","1","0","1","27","28","3.571428571428571428571428571"
"2018-06-30T00:00:00.000","Moore","NC","Passenger","0","1","1","194","195","0.5128205128205128205128205128"
"2018-06-30T00:00:00.000","Carroll","NH","Passenger","0","1","1","1","2","50.0"
"2018-06-30T00:00:00.000","Camden","NJ","Passenger","0","1","1","32","33","3.030303030303030303030303030"
"2018-06-30T00:00:00.000","Essex","NJ","Passenger","1","0","1","10","11","9.090909090909090909090909091"
"2018-06-30T00:00:00.000","Morris","NJ","Passenger","1","0","1","18","19","5.263157894736842105263157895"
"2018-06-30T00:00:00.000","Santa Fe","NM","Passenger","0","1","1","41","42","2.380952380952380952380952381"
"2018-06-30T00:00:00.000","Clark","NV","Passenger","1","2","3","736","739","0.4059539918809201623815967524"
"2018-06-30T00:00:00.000","Washoe","NV","Passenger","1","0","1","107","108","0.9259259259259259259259259259"
"2018-06-30T00:00:00.000","Jefferson","NY","Passenger","0","1","1","229","230","0.4347826086956521739130434783"
"2018-06-30T00:00:00.000","Nassau","NY","Passenger","2","0","2","36","38","5.263157894736842105263157895"
"2018-06-30T00:00:00.000","Queens","NY","Passenger","1","0","1","63","64","1.562500"
"2018-06-30T00:00:00.000","Saratoga","NY","Passenger","1","1","2","65","67","2.985074626865671641791044776"
"2018-06-30T00:00:00.000","Garfield","OK","Passenger","1","0","1","18","19","5.263157894736842105263157895"
"2018-06-30T00:00:00.000","Jackson","OK","Passenger","1","0","1","43","44","2.272727272727272727272727273"
"2018-06-30T00:00:00.000","Oklahoma","OK","Passenger","0","1","1","115","116","0.8620689655172413793103448276"
"2018-06-30T00:00:00.000","Tulsa","OK","Passenger","0","1","1","48","49","2.040816326530612244897959184"
"2018-06-30T00:00:00.000","Clackamas","OR","Passenger","0","1","1","219","220","0.4545454545454545454545454545"
"2018-06-30T00:00:00.000","Deschutes","OR","Passenger","1","0","1","161","162","0.6172839506172839506172839506"
"2018-06-30T00:00:00.000","Douglas","OR","Passenger","1","0","1","52","53","1.886792452830188679245283019"
"2018-06-30T00:00:00.000","Klamath","OR","Passenger","1","0","1","30","31","3.225806451612903225806451613"
"2018-06-30T00:00:00.000","Lane","OR","Passenger","0","1","1","176","177","0.5649717514124293785310734463"
"2018-06-30T00:00:00.000","Multnomah","OR","Passenger","3","4","7","784","791","0.8849557522123893805309734513"
"2018-06-30T00:00:00.000","Washington","OR","Passenger","0","1","1","453","454","0.2202643171806167400881057269"
"2018-06-30T00:00:00.000","Allegheny","PA","Passenger","1","0","1","73","74","1.351351351351351351351351351"
"2018-06-30T00:00:00.000","Montgomery","PA","Passenger","2","0","2","28","30","6.666666666666666666666666667"
"2018-06-30T00:00:00.000","Northampton","PA","Passenger","0","1","1","64","65","1.538461538461538461538461538"
"2018-06-30T00:00:00.000","Newport","RI","Passenger","1","0","1","104","105","0.9523809523809523809523809524"
"2018-06-30T00:00:00.000","Beaufort","SC","Passenger","1","0","1","37","38","2.631578947368421052631578947"
"2018-06-30T00:00:00.000","Richland","SC","Passenger","0","1","1","169","170","0.5882352941176470588235294118"
"2018-06-30T00:00:00.000","Shelby","TN","Passenger","0","1","1","105","106","0.9433962264150943396226415094"
"2018-06-30T00:00:00.000","Bexar","TX","Passenger","2","4","6","741","747","0.8032128514056224899598393574"
"2018-06-30T00:00:00.000","Dallas","TX","Passenger","0","1","1","184","185","0.5405405405405405405405405405"
"2018-06-30T00:00:00.000","El Paso","TX","Passenger","1","0","1","524","525","0.1904761904761904761904761905"
"2018-06-30T00:00:00.000","Montgomery","TX","Passenger","1","0","1","57","58","1.724137931034482758620689655"
"2018-06-30T00:00:00.000","Nueces","TX","Passenger","1","1","2","90","92","2.173913043478260869565217391"
"2018-06-30T00:00:00.000","Tarrant","TX","Passenger","1","0","1","210","211","0.4739336492890995260663507109"
"2018-06-30T00:00:00.000","Travis","TX","Passenger","0","1","1","182","183","0.5464480874316939890710382514"
"2018-06-30T00:00:00.000","Utah","UT","Passenger","0","1","1","129","130","0.7692307692307692307692307692"
"2018-06-30T00:00:00.000","Alexandria","VA","Passenger","1","0","1","166","167","0.5988023952095808383233532934"
"2018-06-30T00:00:00.000","Arlington","VA","Passenger","1","2","3","172","175","1.714285714285714285714285714"
"2018-06-30T00:00:00.000","Fairfax","VA","Passenger","2","3","5","828","833","0.6002400960384153661464585834"
"2018-06-30T00:00:00.000","Manassas","VA","Passenger","0","1","1","9","10","10.0"
"2018-06-30T00:00:00.000","Norfolk","VA","Passenger","2","2","4","334","338","1.183431952662721893491124260"
"2018-06-30T00:00:00.000","Portsmouth","VA","Passenger","0","1","1","63","64","1.562500"
"2018-06-30T00:00:00.000","Prince George","VA","Passenger","0","1","1","72","73","1.369863013698630136986301370"
"2018-06-30T00:00:00.000","Prince William","VA","Passenger","0","4","4","257","261","1.532567049808429118773946360"
"2018-06-30T00:00:00.000","Rockbridge","VA","Passenger","1","0","1","1","2","50.0"
"2018-06-30T00:00:00.000","Virginia Beach","VA","Passenger","2","1","3","682","685","0.4379562043795620437956204380"
"2018-06-30T00:00:00.000","Adams","WA","Passenger","5","5","10","12617","12627","0.07919537499010057812623742773"
"2018-06-30T00:00:00.000","Adams","WA","Truck","0","0","0","5163","5163","0"
"2018-06-30T00:00:00.000","Asotin","WA","Passenger","9","7","16","12604","12620","0.1267828843106180665610142631"
"2018-06-30T00:00:00.000","Asotin","WA","Truck","0","0","0","6621","6621","0"
"2018-06-30T00:00:00.000","Benton","WA","Passenger","204","206","410","131482","131892","0.3108604009340975950019713099"
"2018-06-30T00:00:00.000","Benton","WA","Truck","0","0","0","41036","41036","0"
"2018-06-30T00:00:00.000","Chelan","WA","Truck","0","0","0","21878","21878","0"
"2018-06-30T00:00:00.000","Chelan","WA","Passenger","111","52","163","53567","53730","0.3033686953284943234691978411"
"2018-06-30T00:00:00.000","Clallam","WA","Passenger","131","117","248","49911","50159","0.4944277198508742199804621304"
"2018-06-30T00:00:00.000","Clallam","WA","Truck","0","0","0","21444","21444","0"
"2018-06-30T00:00:00.000","Clark","WA","Passenger","1101","751","1852","307893","309745","0.5979111850070219051154982324"
"2018-06-30T00:00:00.000","Clark","WA","Truck","0","0","0","79135","79135","0"
"2018-06-30T00:00:00.000","Columbia","WA","Passenger","2","2","4","2424","2428","0.1647446457990115321252059308"
"2018-06-30T00:00:00.000","Columbia","WA","Truck","0","0","0","1528","1528","0"
"2018-06-30T00:00:00.000","Cowlitz","WA","Passenger","65","83","148","71718","71866","0.2059388306013970444994851529"
"2018-06-30T00:00:00.000","Cowlitz","WA","Truck","0","0","0","28471","28471","0"
"2018-06-30T00:00:00.000","Douglas","WA","Truck","0","0","0","11951","11951","0"
"2018-06-30T00:00:00.000","Douglas","WA","Passenger","44","31","75","27652","27727","0.2704944638799725898943268294"
"2018-06-30T00:00:00.000","Ferry","WA","Passenger","3","3","6","4426","4432","0.1353790613718411552346570397"
"2018-06-30T00:00:00.000","Ferry","WA","Truck","0","0","0","3514","3514","0"
"2018-06-30T00:00:00.000","Franklin","WA","Passenger","47","67","114","57859","57973","0.1966432649681748400117295983"
"2018-06-30T00:00:00.000","Franklin","WA","Truck","0","0","0","18659","18659","0"
"2018-06-30T00:00:00.000","Garfield","WA","Truck","0","0","0","951","951","0"
"2018-06-30T00:00:00.000","Garfield","WA","Passenger","1","1","2","1316","1318","0.1517450682852807283763277693"
"2018-06-30T00:00:00.000","Grant","WA","Truck","0","0","0","25920","25920","0"
"2018-06-30T00:00:00.000","Grant","WA","Passenger","33","48","81","63157","63238","0.1280875423005155128245675069"
"2018-06-30T00:00:00.000","Grays Harbor","WA","Passenger","61","65","126","46554","46680","0.2699228791773778920308483290"
"2018-06-30T00:00:00.000","Grays Harbor","WA","Truck","0","0","0","20224","20224","0"
"2018-06-30T00:00:00.000","Island","WA","Passenger","210","195","405","62525","62930","0.6435722231050373430796122676"
"2018-06-30T00:00:00.000","Island","WA","Truck","0","0","0","20954","20954","0"
"2018-06-30T00:00:00.000","Jefferson","WA","Passenger","155","103","258","24450","24708","1.044196211753278290432248664"
"2018-06-30T00:00:00.000","Jefferson","WA","Truck","0","0","0","9552","9552","0"
"2018-06-30T00:00:00.000","King","WA","Truck","7","1","8","183114","183122","0.004368672251286027893972324461"
"2018-06-30T00:00:00.000","King","WA","Passenger","13533","5928","19461","1371090","1390551","1.399517169812541934815767275"
"2018-06-30T00:00:00.000","Kitsap","WA","Truck","1","0","1","53227","53228","0.001878710453144961298564665214"
"2018-06-30T00:00:00.000","Kitsap","WA","Passenger","864","480","1344","178507","179851","0.7472852527925894212431401549"
"2018-06-30T00:00:00.000","Kittitas","WA","Passenger","50","32","82","28930","29012","0.2826416655177168068385495657"
"2018-06-30T00:00:00.000","Kittitas","WA","Truck","0","0","0","14061","14061","0"
"2018-06-30T00:00:00.000","Klickitat","WA","Passenger","28","32","60","15163","15223","0.3941404453787032779347040662"
"2018-06-30T00:00:00.000","Klickitat","WA","Truck","0","0","0","8120","8120","0"
"2018-06-30T00:00:00.000","Lewis","WA","Passenger","87","67","154","57667","57821","0.2663392193147818266719703914"
"2018-06-30T00:00:00.000","Lewis","WA","Truck","0","0","0","25482","25482","0"
"2018-06-30T00:00:00.000","Lincoln","WA","Passenger","4","7","11","7686","7697","0.1429128231778615044822658179"
"2018-06-30T00:00:00.000","Lincoln","WA","Truck","0","0","0","4560","4560","0"
"2018-06-30T00:00:00.000","Mason","WA","Passenger","100","93","193","45688","45881","0.4206534295242039188335040649"
"2018-06-30T00:00:00.000","Mason","WA","Truck","0","0","0","19957","19957","0"
"2018-06-30T00:00:00.000","Okanogan","WA","Passenger","10","19","29","25956","25985","0.1116028477968058495285741774"
"2018-06-30T00:00:00.000","Okanogan","WA","Truck","0","0","0","16438","16438","0"
"2018-06-30T00:00:00.000","Pacific","WA","Passenger","27","21","48","15564","15612","0.3074558032282859338970023059"
"2018-06-30T00:00:00.000","Pacific","WA","Truck","0","0","0","7601","7601","0"
"2018-06-30T00:00:00.000","Pend Oreille","WA","Passenger","6","5","11","9550","9561","0.1150507269114109402782135760"
"2018-06-30T00:00:00.000","Pend Oreille","WA","Truck","0","0","0","5678","5678","0"
"2018-06-30T00:00:00.000","Pierce","WA","Passenger","1428","1253","2681","532196","534877","0.5012367329311224823651045007"
"2018-06-30T00:00:00.000","Pierce","WA","Truck","0","0","0","137855","137855","0"
"2018-06-30T00:00:00.000","San Juan","WA","Passenger","145","63","208","14069","14277","1.456888702108286054493240877"
"2018-06-30T00:00:00.000","San Juan","WA","Truck","0","0","0","5715","5715","0"
"2018-06-30T00:00:00.000","Skagit","WA","Passenger","239","182","421","90474","90895","0.4631717916277022938555476099"
"2018-06-30T00:00:00.000","Skagit","WA","Truck","1","0","1","32050","32051","0.003120027456241614926211350660"
"2018-06-30T00:00:00.000","Skamania","WA","Passenger","13","9","22","8661","8683","0.2533686513877692041920995048"
"2018-06-30T00:00:00.000","Skamania","WA","Truck","0","0","0","3946","3946","0"
"2018-06-30T00:00:00.000","Snohomish","WA","Passenger","2486","1354","3840","521441","525281","0.7310372924206281970983149971"
"2018-06-30T00:00:00.000","Snohomish","WA","Truck","1","0","1","121678","121679","0.0008218344989685977037944098817"
"2018-06-30T00:00:00.000","Spokane","WA","Truck","1","0","1","92665","92666","0.001079144454276649472298361859"
"2018-06-30T00:00:00.000","Spokane","WA","Passenger","373","345","718","303152","303870","0.2362852535623786487642741962"
"2018-06-30T00:00:00.000","Stevens","WA","Passenger","13","27","40","31628","31668","0.1263104711380573449538966780"
"2018-06-30T00:00:00.000","Stevens","WA","Truck","0","0","0","18604","18604","0"
"2018-06-30T00:00:00.000","Thurston","WA","Passenger","648","508","1156","193001","194157","0.5953944488223448034322738814"
"2018-06-30T00:00:00.000","Thurston","WA","Truck","0","0","0","54338","54338","0"
"2018-06-30T00:00:00.000","Wahkiakum","WA","Truck","0","0","0","1676","1676","0"
"2018-06-30T00:00:00.000","Wahkiakum","WA","Passenger","2","2","4","2914","2918","0.1370801919122686771761480466"
"2018-06-30T00:00:00.000","Walla Walla","WA","Passenger","35","43","78","35677","35755","0.2181513075094392392672353517"
"2018-06-30T00:00:00.000","Walla Walla","WA","Truck","0","0","0","13420","13420","0"
"2018-06-30T00:00:00.000","Whatcom","WA","Truck","2","0","2","42290","42292","0.004729026766291497209874207888"
"2018-06-30T00:00:00.000","Whatcom","WA","Passenger","677","315","992","147642","148634","0.6674112248879798700162816045"
"2018-06-30T00:00:00.000","Whitman","WA","Truck","0","0","0","8497","8497","0"
"2018-06-30T00:00:00.000","Whitman","WA","Passenger","20","30","50","22616","22666","0.2205947233742168887320215300"
"2018-06-30T00:00:00.000","Yakima","WA","Truck","0","0","0","58492","58492","0"
"2018-06-30T00:00:00.000","Yakima","WA","Passenger","72","96","168","163786","163954","0.1024677653488173512082657331"
"2018-06-30T00:00:00.000","Ozaukee","WI","Passenger","0","1","1","3","4","25.00"
"2018-06-30T00:00:00.000",,,"Passenger","2","0","2","245","247","0.8097165991902834008097165992"
"2018-07-31T00:00:00.000","Juneau","AK","Passenger","0","1","1","47","48","2.083333333333333333333333333"
"2018-07-31T00:00:00.000","Dale","AL","Passenger","0","1","1","64","65","1.538461538461538461538461538"
"2018-07-31T00:00:00.000","Lee","AL","Passenger","1","0","1","37","38","2.631578947368421052631578947"
"2018-07-31T00:00:00.000","Cochise","AZ","Passenger","0","1","1","125","126","0.7936507936507936507936507937"
"2018-07-31T00:00:00.000","Maricopa","AZ","Passenger","3","2","5","1485","1490","0.3355704697986577181208053691"
"2018-07-31T00:00:00.000","Pima","AZ","Passenger","0","1","1","399","400","0.2500"
"2018-07-31T00:00:00.000","Pinal","AZ","Passenger","2","0","2","184","186","1.075268817204301075268817204"
"2018-07-31T00:00:00.000","Alameda","CA","Passenger","0","1","1","333","334","0.2994011976047904191616766467"
"2018-07-31T00:00:00.000","Contra Costa","CA","Passenger","0","1","1","475","476","0.2100840336134453781512605042"
"2018-07-31T00:00:00.000","Los Angeles","CA","Passenger","8","4","12","1125","1137","1.055408970976253298153034301"
"2018-07-31T00:00:00.000","Marin","CA","Passenger","1","0","1","54","55","1.818181818181818181818181818"
"2018-07-31T00:00:00.000","Monterey","CA","Passenger","0","1","1","186","187","0.5347593582887700534759358289"
"2018-07-31T00:00:00.000","Orange","CA","Passenger","3","1","4","550","554","0.7220216606498194945848375451"
"2018-07-31T00:00:00.000","Riverside","CA","Passenger","1","2","3","674","677","0.4431314623338257016248153619"
"2018-07-31T00:00:00.000","San Diego","CA","Passenger","7","2","9","2591","2600","0.3461538461538461538461538462"
"2018-07-31T00:00:00.000","San Francisco","CA","Passenger","1","1","2","119","121","1.652892561983471074380165289"
"2018-07-31T00:00:00.000","San Mateo","CA","Passenger","1","1","2","130","132","1.515151515151515151515151515"
"2018-07-31T00:00:00.000","Santa Clara","CA","Passenger","7","0","7","366","373","1.876675603217158176943699732"
"2018-07-31T00:00:00.000","Tuolumne","CA","Passenger","0","1","1","10","11","9.090909090909090909090909091"
"2018-07-31T00:00:00.000","Ventura","CA","Passenger","0","2","2","310","312","0.6410256410256410256410256410"
"2018-07-31T00:00:00.000","El Paso","CO","Passenger","2","1","3","752","755","0.3973509933774834437086092715"
"2018-07-31T00:00:00.000","Jefferson","CO","Passenger","0","1","1","66","67","1.492537313432835820895522388"
"2018-07-31T00:00:00.000","Larimer","CO","Passenger","0","1","1","59","60","1.666666666666666666666666667"
"2018-07-31T00:00:00.000","New London","CT","Passenger","0","1","1","266","267","0.3745318352059925093632958801"
"2018-07-31T00:00:00.000","District of Columbia","DC","Passenger","0","4","4","193","197","2.030456852791878172588832487"
"2018-07-31T00:00:00.000","Kent","DE","Passenger","0","1","1","74","75","1.333333333333333333333333333"
"2018-07-31T00:00:00.000","New Castle","DE","Passenger","1","0","1","25","26","3.846153846153846153846153846"
"2018-07-31T00:00:00.000","Brevard","FL","Passenger","0","1","1","86","87","1.149425287356321839080459770"
"2018-07-31T00:00:00.000","Broward","FL","Passenger","0","1","1","126","127","0.7874015748031496062992125984"
"2018-07-31T00:00:00.000","Clay","FL","Passenger","0","1","1","89","90","1.111111111111111111111111111"
"2018-07-31T00:00:00.000","Duval","FL","Passenger","1","1","2","379","381","0.5249343832020997375328083990"
"2018-07-31T00:00:00.000","Manatee","FL","Passenger","1","0","1","36","37","2.702702702702702702702702703"
"2018-07-31T00:00:00.000","Miami-Dade","FL","Passenger","0","1","1","112","113","0.8849557522123893805309734513"
"2018-07-31T00:00:00.000","Orange","FL","Passenger","2","1","3","171","174","1.724137931034482758620689655"
"2018-07-31T00:00:00.000","Palm Beach","FL","Passenger","0","1","1","75","76","1.315789473684210526315789474"
"2018-07-31T00:00:00.000","Polk","FL","Passenger","1","0","1","65","66","1.515151515151515151515151515"
"2018-07-31T00:00:00.000","Santa Rosa","FL","Passenger","1","0","1","95","96","1.041666666666666666666666667"
"2018-07-31T00:00:00.000","St. Lucie","FL","Passenger","1","0","1","26","27","3.703703703703703703703703704"
"2018-07-31T00:00:00.000","Sumter","FL","Passenger","0","1","1","10","11","9.090909090909090909090909091"
"2018-07-31T00:00:00.000","Volusia","FL","Passenger","0","1","1","30","31","3.225806451612903225806451613"
"2018-07-31T00:00:00.000","Bryan","GA","Passenger","1","0","1","50","51","1.960784313725490196078431373"
"2018-07-31T00:00:00.000","Camden","GA","Passenger","0","1","1","164","165","0.6060606060606060606060606061"
"2018-07-31T00:00:00.000","Columbia","GA","Passenger","1","1","2","158","160","1.2500"
"2018-07-31T00:00:00.000","DeKalb","GA","Passenger","1","0","1","76","77","1.298701298701298701298701299"
"2018-07-31T00:00:00.000","Fulton","GA","Passenger","1","2","3","101","104","2.884615384615384615384615385"
"2018-07-31T00:00:00.000","Gwinnett","GA","Passenger","0","1","1","85","86","1.162790697674418604651162791"
"2018-07-31T00:00:00.000","Liberty","GA","Passenger","1","0","1","145","146","0.6849315068493150684931506849"
"2018-07-31T00:00:00.000","Lumpkin","GA","Passenger","1","0","1","7","8","12.500"
"2018-07-31T00:00:00.000","Honolulu","HI","Passenger","2","1","3","520","523","0.5736137667304015296367112811"
"2018-07-31T00:00:00.000","Maui","HI","Passenger","1","0","1","56","57","1.754385964912280701754385965"
"2018-07-31T00:00:00.000","Ada","ID","Passenger","0","2","2","311","313","0.6389776357827476038338658147"
"2018-07-31T00:00:00.000","Kootenai","ID","Passenger","0","1","1","207","208","0.4807692307692307692307692308"
"2018-07-31T00:00:00.000","Latah","ID","Passenger","0","1","1","70","71","1.408450704225352112676056338"
"2018-07-31T00:00:00.000","Madison","ID","Passenger","1","0","1","39","40","2.500"
"2018-07-31T00:00:00.000","Twin Falls","ID","Passenger","0","1","1","23","24","4.166666666666666666666666667"
"2018-07-31T00:00:00.000","Cook","IL","Passenger","1","0","1","247","248","0.4032258064516129032258064516"
"2018-07-31T00:00:00.000","DuPage","IL","Passenger","1","0","1","59","60","1.666666666666666666666666667"
"2018-07-31T00:00:00.000","Monroe","IL","Passenger","1","0","1","4","5","20.0"
"2018-07-31T00:00:00.000","Sangamon","IL","Passenger","1","0","1","11","12","8.333333333333333333333333333"
"2018-07-31T00:00:00.000","St. Clair","IL","Passenger","0","1","1","151","152","0.6578947368421052631578947368"
"2018-07-31T00:00:00.000","DeKalb","IN","Passenger","1","0","1","1","2","50.0"
"2018-07-31T00:00:00.000","Hamilton","IN","Passenger","1","0","1","47","48","2.083333333333333333333333333"
"2018-07-31T00:00:00.000","Marion","IN","Passenger","1","0","1","119","120","0.8333333333333333333333333333"
"2018-07-31T00:00:00.000","Hardin","KY","Passenger","0","1","1","120","121","0.8264462809917355371900826446"
"2018-07-31T00:00:00.000","Caddo","LA","Passenger","0","1","1","22","23","4.347826086956521739130434783"
"2018-07-31T00:00:00.000","Orleans","LA","Passenger","0","1","1","46","47","2.127659574468085106382978723"
"2018-07-31T00:00:00.000","Franklin","MA","Passenger","0","1","1","1","2","50.0"
"2018-07-31T00:00:00.000","Nantucket","MA","Passenger","1","0","1","3","4","25.00"
"2018-07-31T00:00:00.000","Norfolk","MA","Passenger","1","0","1","33","34","2.941176470588235294117647059"
"2018-07-31T00:00:00.000","Anne Arundel","MD","Passenger","0","1","1","458","459","0.2178649237472766884531590414"
"2018-07-31T00:00:00.000","Charles","MD","Passenger","0","1","1","82","83","1.204819277108433734939759036"
"2018-07-31T00:00:00.000","Frederick","MD","Passenger","0","1","1","90","91","1.098901098901098901098901099"
"2018-07-31T00:00:00.000","Howard","MD","Passenger","0","1","1","87","88","1.136363636363636363636363636"
"2018-07-31T00:00:00.000","Montgomery","MD","Passenger","1","1","2","290","292","0.6849315068493150684931506849"
"2018-07-31T00:00:00.000","St. Mary's","MD","Passenger","1","0","1","213","214","0.4672897196261682242990654206"
"2018-07-31T00:00:00.000","Kent","MI","Passenger","0","1","1","27","28","3.571428571428571428571428571"
"2018-07-31T00:00:00.000","Washtenaw","MI","Passenger","1","0","1","32","33","3.030303030303030303030303030"
"2018-07-31T00:00:00.000","Dakota","MN","Passenger","0","1","1","32","33","3.030303030303030303030303030"
"2018-07-31T00:00:00.000","Hennepin","MN","Passenger","1","0","1","106","107","0.9345794392523364485981308411"
"2018-07-31T00:00:00.000","Kanabec","MN","Passenger","1","0","1","0","1","100"
"2018-07-31T00:00:00.000","Ramsey","MN","Passenger","1","0","1","39","40","2.500"
"2018-07-31T00:00:00.000","Flathead","MT","Passenger","1","0","1","48","49","2.040816326530612244897959184"
"2018-07-31T00:00:00.000","Gallatin","MT","Passenger","0","1","1","57","58","1.724137931034482758620689655"
"2018-07-31T00:00:00.000","Glacier","MT","Passenger","0","1","1","4","5","20.0"
"2018-07-31T00:00:00.000","Guilford","NC","Passenger","1","0","1","25","26","3.846153846153846153846153846"
"2018-07-31T00:00:00.000","Moore","NC","Passenger","0","1","1","197","198","0.5050505050505050505050505051"
"2018-07-31T00:00:00.000","Douglas","NE","Passenger","0","1","1","72","73","1.369863013698630136986301370"
"2018-07-31T00:00:00.000","Carroll","NH","Passenger","0","1","1","1","2","50.0"
"2018-07-31T00:00:00.000","Camden","NJ","Passenger","0","1","1","31","32","3.12500"
"2018-07-31T00:00:00.000","Essex","NJ","Passenger","1","0","1","10","11","9.090909090909090909090909091"
"2018-07-31T00:00:00.000","Morris","NJ","Passenger","1","0","1","16","17","5.882352941176470588235294118"
"2018-07-31T00:00:00.000","Santa Fe","NM","Passenger","0","1","1","42","43","2.325581395348837209302325581"
"2018-07-31T00:00:00.000","Carson City","NV","Passenger","1","0","1","13","14","7.142857142857142857142857143"
"2018-07-31T00:00:00.000","Clark","NV","Passenger","1","2","3","734","737","0.4070556309362279511533242877"
"2018-07-31T00:00:00.000","Washoe","NV","Passenger","1","0","1","108","109","0.9174311926605504587155963303"
"2018-07-31T00:00:00.000","Jefferson","NY","Passenger","0","1","1","232","233","0.4291845493562231759656652361"
"2018-07-31T00:00:00.000","Nassau","NY","Passenger","2","0","2","36","38","5.263157894736842105263157895"
"2018-07-31T00:00:00.000","Queens","NY","Passenger","1","0","1","63","64","1.562500"
"2018-07-31T00:00:00.000","Saratoga","NY","Passenger","1","1","2","64","66","3.030303030303030303030303030"
"2018-07-31T00:00:00.000","Garfield","OK","Passenger","1","0","1","17","18","5.555555555555555555555555556"
"2018-07-31T00:00:00.000","Jackson","OK","Passenger","1","0","1","43","44","2.272727272727272727272727273"
"2018-07-31T00:00:00.000","Oklahoma","OK","Passenger","0","1","1","111","112","0.8928571428571428571428571429"
"2018-07-31T00:00:00.000","Tulsa","OK","Passenger","1","1","2","47","49","4.081632653061224489795918367"
"2018-07-31T00:00:00.000","Clackamas","OR","Passenger","0","1","1","210","211","0.4739336492890995260663507109"
"2018-07-31T00:00:00.000","Deschutes","OR","Passenger","1","0","1","158","159","0.6289308176100628930817610063"
"2018-07-31T00:00:00.000","Douglas","OR","Passenger","1","0","1","52","53","1.886792452830188679245283019"
"2018-07-31T00:00:00.000","Klamath","OR","Passenger","1","0","1","30","31","3.225806451612903225806451613"
"2018-07-31T00:00:00.000","Lane","OR","Passenger","0","1","1","176","177","0.5649717514124293785310734463"
"2018-07-31T00:00:00.000","Multnomah","OR","Passenger","3","4","7","773","780","0.8974358974358974358974358974"
"2018-07-31T00:00:00.000","Washington","OR","Passenger","0","1","1","450","451","0.2217294900221729490022172949"
"2018-07-31T00:00:00.000","Allegheny","PA","Passenger","1","0","1","73","74","1.351351351351351351351351351"
"2018-07-31T00:00:00.000","Montgomery","PA","Passenger","2","0","2","28","30","6.666666666666666666666666667"
"2018-07-31T00:00:00.000","San Juan","PR","Passenger","0","1","1","4","5","20.0"
"2018-07-31T00:00:00.000","Newport","RI","Passenger","1","0","1","102","103","0.9708737864077669902912621359"
"2018-07-31T00:00:00.000","Beaufort","SC","Passenger","1","0","1","36","37","2.702702702702702702702702703"
"2018-07-31T00:00:00.000","Richland","SC","Passenger","0","1","1","169","170","0.5882352941176470588235294118"
"2018-07-31T00:00:00.000","Shelby","TN","Passenger","0","1","1","105","106","0.9433962264150943396226415094"
"2018-07-31T00:00:00.000","Bexar","TX","Passenger","2","4","6","731","737","0.8141112618724559023066485753"
"2018-07-31T00:00:00.000","Dallas","TX","Passenger","0","1","1","186","187","0.5347593582887700534759358289"
"2018-07-31T00:00:00.000","El Paso","TX","Passenger","1","0","1","514","515","0.1941747572815533980582524272"
"2018-07-31T00:00:00.000","Montgomery","TX","Passenger","1","0","1","56","57","1.754385964912280701754385965"
"2018-07-31T00:00:00.000","Nueces","TX","Passenger","1","1","2","90","92","2.173913043478260869565217391"
"2018-07-31T00:00:00.000","Tarrant","TX","Passenger","1","0","1","209","210","0.4761904761904761904761904762"
"2018-07-31T00:00:00.000","Travis","TX","Passenger","0","1","1","184","185","0.5405405405405405405405405405"
"2018-07-31T00:00:00.000","Utah","UT","Passenger","0","1","1","130","131","0.7633587786259541984732824427"
"2018-07-31T00:00:00.000","Alexandria","VA","Passenger","1","0","1","160","161","0.6211180124223602484472049689"
"2018-07-31T00:00:00.000","Arlington","VA","Passenger","1","2","3","175","178","1.685393258426966292134831461"
"2018-07-31T00:00:00.000","Fairfax","VA","Passenger","2","3","5","834","839","0.5959475566150178784266984505"
"2018-07-31T00:00:00.000","Manassas","VA","Passenger","0","1","1","9","10","10.0"
"2018-07-31T00:00:00.000","Norfolk","VA","Passenger","2","2","4","333","337","1.186943620178041543026706231"
"2018-07-31T00:00:00.000","Portsmouth","VA","Passenger","0","1","1","62","63","1.587301587301587301587301587"
"2018-07-31T00:00:00.000","Prince George","VA","Passenger","0","1","1","74","75","1.333333333333333333333333333"
"2018-07-31T00:00:00.000","Prince William","VA","Passenger","0","4","4","259","263","1.520912547528517110266159696"
"2018-07-31T00:00:00.000","Rockbridge","VA","Passenger","1","0","1","1","2","50.0"
"2018-07-31T00:00:00.000","Virginia Beach","VA","Passenger","2","1","3","685","688","0.4360465116279069767441860465"
"2018-07-31T00:00:00.000","Adams","WA","Truck","0","0","0","5159","5159","0"
"2018-07-31T00:00:00.000","Adams","WA","Passenger","5","5","10","12641","12651","0.07904513477195478618291044186"
"2018-07-31T00:00:00.000","Asotin","WA","Passenger","11","9","20","12638","12658","0.1580028440511929214725865066"
"2018-07-31T00:00:00.000","Asotin","WA","Truck","0","0","0","6632","6632","0"
"2018-07-31T00:00:00.000","Benton","WA","Truck","0","0","0","41100","41100","0"
"2018-07-31T00:00:00.000","Benton","WA","Passenger","205","204","409","131740","132149","0.3094991259865757591809245624"
"2018-07-31T00:00:00.000","Chelan","WA","Truck","0","0","0","21956","21956","0"
"2018-07-31T00:00:00.000","Chelan","WA","Passenger","113","51","164","53588","53752","0.3051049263283226670635511237"
"2018-07-31T00:00:00.000","Clallam","WA","Passenger","133","116","249","49982","50231","0.4957098206286954271266747626"
"2018-07-31T00:00:00.000","Clallam","WA","Truck","0","0","0","21480","21480","0"
"2018-07-31T00:00:00.000","Clark","WA","Truck","0","0","0","79252","79252","0"
"2018-07-31T00:00:00.000","Clark","WA","Passenger","1133","776","1909","308581","310490","0.6148346162517311346581210345"
"2018-07-31T00:00:00.000","Columbia","WA","Passenger","2","2","4","2419","2423","0.1650846058605035080478745357"
"2018-07-31T00:00:00.000","Columbia","WA","Truck","0","0","0","1531","1531","0"
"2018-07-31T00:00:00.000","Cowlitz","WA","Passenger","67","86","153","71856","72009","0.2124734408198975128108986377"
"2018-07-31T00:00:00.000","Cowlitz","WA","Truck","0","0","0","28570","28570","0"
"2018-07-31T00:00:00.000","Douglas","WA","Passenger","44","32","76","27721","27797","0.2734107997265892002734107997"
"2018-07-31T00:00:00.000","Douglas","WA","Truck","0","0","0","11974","11974","0"
"2018-07-31T00:00:00.000","Ferry","WA","Truck","0","0","0","3537","3537","0"
"2018-07-31T00:00:00.000","Ferry","WA","Passenger","3","3","6","4425","4431","0.1354096140825998645903859174"
"2018-07-31T00:00:00.000","Franklin","WA","Passenger","46","67","113","58179","58292","0.1938516434502161531599533384"
"2018-07-31T00:00:00.000","Franklin","WA","Truck","0","0","0","18738","18738","0"
"2018-07-31T00:00:00.000","Garfield","WA","Truck","0","0","0","957","957","0"
"2018-07-31T00:00:00.000","Garfield","WA","Passenger","1","1","2","1320","1322","0.1512859304084720121028744327"
"2018-07-31T00:00:00.000","Grant","WA","Truck","0","0","0","25943","25943","0"
"2018-07-31T00:00:00.000","Grant","WA","Passenger","35","50","85","63285","63370","0.1341328704434274893482720530"
"2018-07-31T00:00:00.000","Grays Harbor","WA","Passenger","63","69","132","46738","46870","0.2816300405376573501173458502"
"2018-07-31T00:00:00.000","Grays Harbor","WA","Truck","0","0","0","20224","20224","0"
"2018-07-31T00:00:00.000","Island","WA","Passenger","219","201","420","62578","62998","0.6666878313597257055779548557"
"2018-07-31T00:00:00.000","Island","WA","Truck","0","0","0","20991","20991","0"
"2018-07-31T00:00:00.000","Jefferson","WA","Passenger","158","105","263","24577","24840","1.058776167471819645732689211"
"2018-07-31T00:00:00.000","Jefferson","WA","Truck","0","0","0","9592","9592","0"
"2018-07-31T00:00:00.000","King","WA","Truck","7","1","8","183043","183051","0.004370366728398096705289782629"
"2018-07-31T00:00:00.000","King","WA","Passenger","13844","6053","19897","1372395","1392292","1.429082405127660002355827657"
"2018-07-31T00:00:00.000","Kitsap","WA","Truck","1","0","1","53396","53397","0.001872764387512407064067269697"
"2018-07-31T00:00:00.000","Kitsap","WA","Passenger","880","493","1373","178827","180200","0.7619311875693673695893451720"
"2018-07-31T00:00:00.000","Kittitas","WA","Passenger","51","32","83","28996","29079","0.2854293476391897933216410468"
"2018-07-31T00:00:00.000","Kittitas","WA","Truck","0","0","0","14058","14058","0"
"2018-07-31T00:00:00.000","Klickitat","WA","Passenger","28","33","61","15216","15277","0.3992930549191595208483340970"
"2018-07-31T00:00:00.000","Klickitat","WA","Truck","0","0","0","8129","8129","0"
"2018-07-31T00:00:00.000","Lewis","WA","Truck","0","0","0","25584","25584","0"
"2018-07-31T00:00:00.000","Lewis","WA","Passenger","90","67","157","57796","57953","0.2709091850292478387658965023"
"2018-07-31T00:00:00.000","Lincoln","WA","Passenger","5","7","12","7750","7762","0.1545993300695696985313063643"
"2018-07-31T00:00:00.000","Lincoln","WA","Truck","0","0","0","4558","4558","0"
"2018-07-31T00:00:00.000","Mason","WA","Passenger","105","94","199","45842","46041","0.4322234530092743424339175952"
"2018-07-31T00:00:00.000","Mason","WA","Truck","0","0","0","20050","20050","0"
"2018-07-31T00:00:00.000","Okanogan","WA","Passenger","10","20","30","26027","26057","0.1151322101546609356410945235"
"2018-07-31T00:00:00.000","Okanogan","WA","Truck","0","0","0","16430","16430","0"
"2018-07-31T00:00:00.000","Pacific","WA","Passenger","29","22","51","15613","15664","0.3255873340143003064351378958"
"2018-07-31T00:00:00.000","Pacific","WA","Truck","0","0","0","7612","7612","0"
"2018-07-31T00:00:00.000","Pend Oreille","WA","Truck","0","0","0","5695","5695","0"
"2018-07-31T00:00:00.000","Pend Oreille","WA","Passenger","6","5","11","9580","9591","0.1146908560108434991137524763"
"2018-07-31T00:00:00.000","Pierce","WA","Passenger","1464","1276","2740","533421","536161","0.5110405270058806962833924885"
"2018-07-31T00:00:00.000","Pierce","WA","Truck","0","0","0","138107","138107","0"
"2018-07-31T00:00:00.000","San Juan","WA","Passenger","149","64","213","14115","14328","1.486599664991624790619765494"
"2018-07-31T00:00:00.000","San Juan","WA","Truck","0","0","0","5732","5732","0"
"2018-07-31T00:00:00.000","Skagit","WA","Passenger","248","187","435","90698","91133","0.4773243501256405473319214774"
"2018-07-31T00:00:00.000","Skagit","WA","Truck","1","0","1","32131","32132","0.003112162330387152993900161832"
"2018-07-31T00:00:00.000","Skamania","WA","Passenger","15","9","24","8636","8660","0.2771362586605080831408775982"
"2018-07-31T00:00:00.000","Skamania","WA","Truck","0","0","0","3960","3960","0"
"2018-07-31T00:00:00.000","Snohomish","WA","Truck","1","0","1","121704","121705","0.0008216589293784150199252290374"
"2018-07-31T00:00:00.000","Snohomish","WA","Passenger","2540","1388","3928","522594","526522","0.7460277063446541644983495466"
"2018-07-31T00:00:00.000","Spokane","WA","Truck","1","0","1","92897","92898","0.001076449439169842192512217701"
"2018-07-31T00:00:00.000","Spokane","WA","Passenger","380","348","728","304040","304768","0.2388702225955480890382192356"
"2018-07-31T00:00:00.000","Stevens","WA","Truck","0","0","0","18645","18645","0"
"2018-07-31T00:00:00.000","Stevens","WA","Passenger","13","27","40","31641","31681","0.1262586408257315110002840819"
"2018-07-31T00:00:00.000","Thurston","WA","Passenger","655","524","1179","193731","194910","0.6048945667231029706018162229"
"2018-07-31T00:00:00.000","Thurston","WA","Truck","0","0","0","54424","54424","0"
"2018-07-31T00:00:00.000","Wahkiakum","WA","Truck","0","0","0","1682","1682","0"
"2018-07-31T00:00:00.000","Wahkiakum","WA","Passenger","2","1","3","2937","2940","0.1020408163265306122448979592"
"2018-07-31T00:00:00.000","Walla Walla","WA","Passenger","35","44","79","35756","35835","0.2204548625645318822380354402"
"2018-07-31T00:00:00.000","Walla Walla","WA","Truck","0","0","0","13471","13471","0"
"2018-07-31T00:00:00.000","Whatcom","WA","Passenger","683","332","1015","147970","148985","0.6812766385877772930160754438"
"2018-07-31T00:00:00.000","Whatcom","WA","Truck","2","0","2","42319","42321","0.004725786252687790931216181092"
"2018-07-31T00:00:00.000","Whitman","WA","Truck","0","0","0","8499","8499","0"
"2018-07-31T00:00:00.000","Whitman","WA","Passenger","20","30","50","22672","22722","0.2200510518440278144529530851"
"2018-07-31T00:00:00.000","Yakima","WA","Passenger","77","101","178","163972","164150","0.1084374048126713371915930551"
"2018-07-31T00:00:00.000","Yakima","WA","Truck","0","0","0","58546","58546","0"
"2018-07-31T00:00:00.000","Ozaukee","WI","Passenger","0","1","1","3","4","25.00"
"2018-07-31T00:00:00.000",,,"Passenger","2","0","2","249","251","0.7968127490039840637450199203"
"2018-08-31T00:00:00.000","Juneau","AK","Passenger","0","1","1","43","44","2.272727272727272727272727273"
"2018-08-31T00:00:00.000","Dale","AL","Passenger","0","1","1","61","62","1.612903225806451612903225806"
"2018-08-31T00:00:00.000","Lee","AL","Passenger","1","0","1","37","38","2.631578947368421052631578947"
"2018-08-31T00:00:00.000","Cochise","AZ","Passenger","0","1","1","123","124","0.8064516129032258064516129032"
"2018-08-31T00:00:00.000","Maricopa","AZ","Passenger","3","2","5","1474","1479","0.3380662609871534820824881677"
"2018-08-31T00:00:00.000","Pima","AZ","Passenger","0","1","1","401","402","0.2487562189054726368159203980"
"2018-08-31T00:00:00.000","Pinal","AZ","Passenger","2","0","2","183","185","1.081081081081081081081081081"
"2018-08-31T00:00:00.000","Alameda","CA","Passenger","0","1","1","331","332","0.3012048192771084337349397590"
"2018-08-31T00:00:00.000","Contra Costa","CA","Passenger","0","1","1","467","468","0.2136752136752136752136752137"
"2018-08-31T00:00:00.000","Fresno","CA","Passenger","1","0","1","193","194","0.5154639175257731958762886598"
"2018-08-31T00:00:00.000","Los Angeles","CA","Passenger","8","4","12","1121","1133","1.059135039717563989408649603"
"2018-08-31T00:00:00.000","Monterey","CA","Passenger","0","1","1","186","187","0.5347593582887700534759358289"
"2018-08-31T00:00:00.000","Orange","CA","Passenger","3","1","4","550","554","0.7220216606498194945848375451"
"2018-08-31T00:00:00.000","Riverside","CA","Passenger","1","2","3","674","677","0.4431314623338257016248153619"
"2018-08-31T00:00:00.000","San Diego","CA","Passenger","7","3","10","2594","2604","0.3840245775729646697388632873"
"2018-08-31T00:00:00.000","San Francisco","CA","Passenger","1","1","2","115","117","1.709401709401709401709401709"
"2018-08-31T00:00:00.000","San Mateo","CA","Passenger","1","1","2","132","134","1.492537313432835820895522388"
"2018-08-31T00:00:00.000","Santa Clara","CA","Passenger","8","0","8","370","378","2.116402116402116402116402116"
"2018-08-31T00:00:00.000","Tuolumne","CA","Passenger","0","1","1","11","12","8.333333333333333333333333333"
"2018-08-31T00:00:00.000","Ventura","CA","Passenger","0","2","2","313","315","0.6349206349206349206349206349"
"2018-08-31T00:00:00.000","El Paso","CO","Passenger","3","1","4","756","760","0.5263157894736842105263157895"
"2018-08-31T00:00:00.000","Jefferson","CO","Passenger","0","1","1","66","67","1.492537313432835820895522388"
"2018-08-31T00:00:00.000","Larimer","CO","Passenger","1","1","2","61","63","3.174603174603174603174603175"
"2018-08-31T00:00:00.000","New London","CT","Passenger","0","1","1","271","272","0.3676470588235294117647058824"
"2018-08-31T00:00:00.000","District of Columbia","DC","Passenger","0","4","4","193","197","2.030456852791878172588832487"
"2018-08-31T00:00:00.000","Kent","DE","Passenger","0","1","1","75","76","1.315789473684210526315789474"
"2018-08-31T00:00:00.000","New Castle","DE","Passenger","1","0","1","26","27","3.703703703703703703703703704"
"2018-08-31T00:00:00.000","Brevard","FL","Passenger","0","1","1","86","87","1.149425287356321839080459770"
"2018-08-31T00:00:00.000","Broward","FL","Passenger","0","1","1","129","130","0.7692307692307692307692307692"
"2018-08-31T00:00:00.000","Clay","FL","Passenger","0","1","1","89","90","1.111111111111111111111111111"
"2018-08-31T00:00:00.000","Duval","FL","Passenger","1","1","2","375","377","0.5305039787798408488063660477"
"2018-08-31T00:00:00.000","Manatee","FL","Passenger","1","0","1","36","37","2.702702702702702702702702703"
"2018-08-31T00:00:00.000","Miami-Dade","FL","Passenger","0","1","1","112","113","0.8849557522123893805309734513"
"2018-08-31T00:00:00.000","Orange","FL","Passenger","2","1","3","166","169","1.775147928994082840236686391"
"2018-08-31T00:00:00.000","Palm Beach","FL","Passenger","0","1","1","76","77","1.298701298701298701298701299"
"2018-08-31T00:00:00.000","Polk","FL","Passenger","1","0","1","64","65","1.538461538461538461538461538"
"2018-08-31T00:00:00.000","Santa Rosa","FL","Passenger","1","0","1","93","94","1.063829787234042553191489362"
"2018-08-31T00:00:00.000","St. Lucie","FL","Passenger","1","0","1","27","28","3.571428571428571428571428571"
"2018-08-31T00:00:00.000","Sumter","FL","Passenger","0","1","1","10","11","9.090909090909090909090909091"
"2018-08-31T00:00:00.000","Volusia","FL","Passenger","0","1","1","32","33","3.030303030303030303030303030"
"2018-08-31T00:00:00.000","Bryan","GA","Passenger","1","0","1","53","54","1.851851851851851851851851852"
"2018-08-31T00:00:00.000","Camden","GA","Passenger","0","1","1","163","164","0.6097560975609756097560975610"
"2018-08-31T00:00:00.000","Columbia","GA","Passenger","1","1","2","159","161","1.242236024844720496894409938"
"2018-08-31T00:00:00.000","DeKalb","GA","Passenger","1","0","1","76","77","1.298701298701298701298701299"
"2018-08-31T00:00:00.000","Fulton","GA","Passenger","1","2","3","101","104","2.884615384615384615384615385"
"2018-08-31T00:00:00.000","Gwinnett","GA","Passenger","0","1","1","85","86","1.162790697674418604651162791"
"2018-08-31T00:00:00.000","Houston","GA","Passenger","1","0","1","57","58","1.724137931034482758620689655"
"2018-08-31T00:00:00.000","Liberty","GA","Passenger","1","0","1","147","148","0.6756756756756756756756756757"
"2018-08-31T00:00:00.000","Lumpkin","GA","Passenger","1","0","1","7","8","12.500"
"2018-08-31T00:00:00.000","Honolulu","HI","Passenger","2","1","3","521","524","0.5725190839694656488549618321"
"2018-08-31T00:00:00.000","Maui","HI","Passenger","1","0","1","55","56","1.785714285714285714285714286"
"2018-08-31T00:00:00.000","Ada","ID","Passenger","0","2","2","304","306","0.6535947712418300653594771242"
"2018-08-31T00:00:00.000","Kootenai","ID","Passenger","0","1","1","208","209","0.4784688995215311004784688995"
"2018-08-31T00:00:00.000","Latah","ID","Passenger","0","1","1","73","74","1.351351351351351351351351351"
"2018-08-31T00:00:00.000","Madison","ID","Passenger","1","0","1","35","36","2.777777777777777777777777778"
"2018-08-31T00:00:00.000","Twin Falls","ID","Passenger","0","1","1","23","24","4.166666666666666666666666667"
"2018-08-31T00:00:00.000","Cook","IL","Passenger","1","0","1","242","243","0.4115226337448559670781893004"
"2018-08-31T00:00:00.000","DuPage","IL","Passenger","1","0","1","54","55","1.818181818181818181818181818"
"2018-08-31T00:00:00.000","Monroe","IL","Passenger","1","0","1","4","5","20.0"
"2018-08-31T00:00:00.000","Sangamon","IL","Passenger","1","0","1","11","12","8.333333333333333333333333333"
"2018-08-31T00:00:00.000","St. Clair","IL","Passenger","0","1","1","155","156","0.6410256410256410256410256410"
"2018-08-31T00:00:00.000","DeKalb","IN","Passenger","1","0","1","1","2","50.0"
"2018-08-31T00:00:00.000","Hamilton","IN","Passenger","1","0","1","47","48","2.083333333333333333333333333"
"2018-08-31T00:00:00.000","Marion","IN","Passenger","1","0","1","120","121","0.8264462809917355371900826446"
"2018-08-31T00:00:00.000","Hardin","KY","Passenger","0","1","1","120","121","0.8264462809917355371900826446"
"2018-08-31T00:00:00.000","Caddo","LA","Passenger","0","1","1","23","24","4.166666666666666666666666667"
"2018-08-31T00:00:00.000","Franklin","MA","Passenger","0","1","1","1","2","50.0"
"2018-08-31T00:00:00.000","Middlesex","MA","Passenger","0","1","1","138","139","0.7194244604316546762589928058"
"2018-08-31T00:00:00.000","Nantucket","MA","Passenger","1","0","1","3","4","25.00"
"2018-08-31T00:00:00.000","Norfolk","MA","Passenger","1","0","1","31","32","3.12500"
"2018-08-31T00:00:00.000","Suffolk","MA","Passenger","0","1","1","44","45","2.222222222222222222222222222"
"2018-08-31T00:00:00.000","Anne Arundel","MD","Passenger","0","1","1","459","460","0.2173913043478260869565217391"
"2018-08-31T00:00:00.000","Charles","MD","Passenger","0","1","1","82","83","1.204819277108433734939759036"
"2018-08-31T00:00:00.000","Frederick","MD","Passenger","0","1","1","88","89","1.123595505617977528089887640"
"2018-08-31T00:00:00.000","Howard","MD","Passenger","0","1","1","87","88","1.136363636363636363636363636"
"2018-08-31T00:00:00.000","Montgomery","MD","Passenger","1","1","2","289","291","0.6872852233676975945017182131"
"2018-08-31T00:00:00.000","St. Mary's","MD","Passenger","1","0","1","216","217","0.4608294930875576036866359447"
"2018-08-31T00:00:00.000","Kent","MI","Passenger","0","1","1","26","27","3.703703703703703703703703704"
"2018-08-31T00:00:00.000","Washtenaw","MI","Passenger","1","0","1","32","33","3.030303030303030303030303030"
"2018-08-31T00:00:00.000","Dakota","MN","Passenger","0","1","1","32","33","3.030303030303030303030303030"
"2018-08-31T00:00:00.000","Hennepin","MN","Passenger","1","0","1","108","109","0.9174311926605504587155963303"
"2018-08-31T00:00:00.000","Kanabec","MN","Passenger","1","0","1","0","1","100"
"2018-08-31T00:00:00.000","Ramsey","MN","Passenger","1","0","1","39","40","2.500"
"2018-08-31T00:00:00.000","Flathead","MT","Passenger","1","0","1","51","52","1.923076923076923076923076923"
"2018-08-31T00:00:00.000","Gallatin","MT","Passenger","0","1","1","56","57","1.754385964912280701754385965"
"2018-08-31T00:00:00.000","Glacier","MT","Passenger","0","1","1","4","5","20.0"
"2018-08-31T00:00:00.000","Cumberland","NC","Passenger","0","1","1","555","556","0.1798561151079136690647482014"
"2018-08-31T00:00:00.000","Guilford","NC","Passenger","1","0","1","25","26","3.846153846153846153846153846"
"2018-08-31T00:00:00.000","Moore","NC","Passenger","0","1","1","199","200","0.500"
"2018-08-31T00:00:00.000","Douglas","NE","Passenger","0","1","1","71","72","1.388888888888888888888888889"
"2018-08-31T00:00:00.000","Carroll","NH","Passenger","0","1","1","1","2","50.0"
"2018-08-31T00:00:00.000","Camden","NJ","Passenger","0","1","1","31","32","3.12500"
"2018-08-31T00:00:00.000","Essex","NJ","Passenger","1","0","1","10","11","9.090909090909090909090909091"
"2018-08-31T00:00:00.000","Morris","NJ","Passenger","1","0","1","16","17","5.882352941176470588235294118"
"2018-08-31T00:00:00.000","Santa Fe","NM","Passenger","0","1","1","43","44","2.272727272727272727272727273"
"2018-08-31T00:00:00.000","Carson City","NV","Passenger","1","0","1","13","14","7.142857142857142857142857143"
"2018-08-31T00:00:00.000","Clark","NV","Passenger","1","2","3","728","731","0.4103967168262653898768809850"
"2018-08-31T00:00:00.000","Washoe","NV","Passenger","1","0","1","102","103","0.9708737864077669902912621359"
"2018-08-31T00:00:00.000","Jefferson","NY","Passenger","0","1","1","230","231","0.4329004329004329004329004329"
"2018-08-31T00:00:00.000","Nassau","NY","Passenger","2","0","2","35","37","5.405405405405405405405405405"
"2018-08-31T00:00:00.000","Queens","NY","Passenger","1","0","1","63","64","1.562500"
"2018-08-31T00:00:00.000","Saratoga","NY","Passenger","1","0","1","63","64","1.562500"
"2018-08-31T00:00:00.000","Garfield","OK","Passenger","1","0","1","17","18","5.555555555555555555555555556"
"2018-08-31T00:00:00.000","Jackson","OK","Passenger","1","0","1","43","44","2.272727272727272727272727273"
"2018-08-31T00:00:00.000","Oklahoma","OK","Passenger","0","1","1","112","113","0.8849557522123893805309734513"
"2018-08-31T00:00:00.000","Tulsa","OK","Passenger","1","1","2","47","49","4.081632653061224489795918367"
"2018-08-31T00:00:00.000","Clackamas","OR","Passenger","0","1","1","213","214","0.4672897196261682242990654206"
"2018-08-31T00:00:00.000","Deschutes","OR","Passenger","2","0","2","156","158","1.265822784810126582278481013"
"2018-08-31T00:00:00.000","Douglas","OR","Passenger","1","0","1","50","51","1.960784313725490196078431373"
"2018-08-31T00:00:00.000","Klamath","OR","Passenger","1","0","1","29","30","3.333333333333333333333333333"
"2018-08-31T00:00:00.000","Lane","OR","Passenger","0","1","1","172","173","0.5780346820809248554913294798"
"2018-08-31T00:00:00.000","Marion","OR","Passenger","1","0","1","119","120","0.8333333333333333333333333333"
"2018-08-31T00:00:00.000","Multnomah","OR","Passenger","3","5","8","757","765","1.045751633986928104575163399"
"2018-08-31T00:00:00.000","Washington","OR","Passenger","0","1","1","443","444","0.2252252252252252252252252252"
"2018-08-31T00:00:00.000","Allegheny","PA","Passenger","1","0","1","74","75","1.333333333333333333333333333"
"2018-08-31T00:00:00.000","Montgomery","PA","Passenger","2","0","2","30","32","6.2500"
"2018-08-31T00:00:00.000","San Juan","PR","Passenger","0","1","1","4","5","20.0"
"2018-08-31T00:00:00.000","Newport","RI","Passenger","1","0","1","101","102","0.9803921568627450980392156863"
"2018-08-31T00:00:00.000","Beaufort","SC","Passenger","1","0","1","37","38","2.631578947368421052631578947"
"2018-08-31T00:00:00.000","Richland","SC","Passenger","0","1","1","171","172","0.5813953488372093023255813953"
"2018-08-31T00:00:00.000","Shelby","TN","Passenger","0","1","1","104","105","0.9523809523809523809523809524"
"2018-08-31T00:00:00.000","Bexar","TX","Passenger","3","4","7","729","736","0.9510869565217391304347826087"
"2018-08-31T00:00:00.000","Dallas","TX","Passenger","0","1","1","189","190","0.5263157894736842105263157895"
"2018-08-31T00:00:00.000","El Paso","TX","Passenger","1","0","1","511","512","0.195312500"
"2018-08-31T00:00:00.000","Montgomery","TX","Passenger","2","0","2","55","57","3.508771929824561403508771930"
"2018-08-31T00:00:00.000","Nueces","TX","Passenger","1","1","2","89","91","2.197802197802197802197802198"
"2018-08-31T00:00:00.000","Tarrant","TX","Passenger","1","0","1","203","204","0.4901960784313725490196078431"
"2018-08-31T00:00:00.000","Travis","TX","Passenger","0","1","1","188","189","0.5291005291005291005291005291"
"2018-08-31T00:00:00.000","Utah","UT","Passenger","0","1","1","133","134","0.7462686567164179104477611940"
"2018-08-31T00:00:00.000","Alexandria","VA","Passenger","1","0","1","161","162","0.6172839506172839506172839506"
"2018-08-31T00:00:00.000","Arlington","VA","Passenger","1","1","2","172","174","1.149425287356321839080459770"
"2018-08-31T00:00:00.000","Fairfax","VA","Passenger","2","3","5","817","822","0.6082725060827250608272506083"
"2018-08-31T00:00:00.000","Manassas","VA","Passenger","0","1","1","9","10","10.0"
"2018-08-31T00:00:00.000","Norfolk","VA","Passenger","2","2","4","340","344","1.162790697674418604651162791"
"2018-08-31T00:00:00.000","Portsmouth","VA","Passenger","0","1","1","65","66","1.515151515151515151515151515"
"2018-08-31T00:00:00.000","Prince George","VA","Passenger","0","1","1","76","77","1.298701298701298701298701299"
"2018-08-31T00:00:00.000","Prince William","VA","Passenger","0","4","4","256","260","1.538461538461538461538461538"
"2018-08-31T00:00:00.000","Rockbridge","VA","Passenger","1","0","1","1","2","50.0"
"2018-08-31T00:00:00.000","Virginia Beach","VA","Passenger","2","1","3","689","692","0.4335260115606936416184971098"
"2018-08-31T00:00:00.000","Adams","WA","Truck","0","0","0","5172","5172","0"
"2018-08-31T00:00:00.000","Adams","WA","Passenger","5","5","10","12682","12692","0.07878978884336589977938859124"
"2018-08-31T00:00:00.000","Asotin","WA","Truck","0","0","0","6653","6653","0"
"2018-08-31T00:00:00.000","Asotin","WA","Passenger","12","9","21","12664","12685","0.1655498620417816318486401261"
"2018-08-31T00:00:00.000","Benton","WA","Truck","0","0","0","41239","41239","0"
"2018-08-31T00:00:00.000","Benton","WA","Passenger","201","206","407","132217","132624","0.3068826155145373386415731693"
"2018-08-31T00:00:00.000","Chelan","WA","Truck","0","0","0","21989","21989","0"
"2018-08-31T00:00:00.000","Chelan","WA","Passenger","115","54","169","53737","53906","0.3135087003302044299335880978"
"2018-08-31T00:00:00.000","Clallam","WA","Truck","0","0","0","21478","21478","0"
"2018-08-31T00:00:00.000","Clallam","WA","Passenger","134","120","254","50122","50376","0.5042083531840558996347467048"
"2018-08-31T00:00:00.000","Clark","WA","Truck","0","0","0","79313","79313","0"
"2018-08-31T00:00:00.000","Clark","WA","Passenger","1161","795","1956","309145","311101","0.6287347195926724761411888744"
"2018-08-31T00:00:00.000","Columbia","WA","Passenger","2","2","4","2415","2419","0.1653575857792476229847044233"
"2018-08-31T00:00:00.000","Columbia","WA","Truck","0","0","0","1536","1536","0"
"2018-08-31T00:00:00.000","Cowlitz","WA","Passenger","72","90","162","71979","72141","0.2245602362041003035721711648"
"2018-08-31T00:00:00.000","Cowlitz","WA","Truck","0","0","0","28616","28616","0"
"2018-08-31T00:00:00.000","Douglas","WA","Passenger","46","31","77","27795","27872","0.2762629161882893226176808266"
"2018-08-31T00:00:00.000","Douglas","WA","Truck","0","0","0","12031","12031","0"
"2018-08-31T00:00:00.000","Ferry","WA","Truck","0","0","0","3553","3553","0"
"2018-08-31T00:00:00.000","Ferry","WA","Passenger","2","2","4","4421","4425","0.09039548022598870056497175141"
"2018-08-31T00:00:00.000","Franklin","WA","Truck","0","0","0","18792","18792","0"
"2018-08-31T00:00:00.000","Franklin","WA","Passenger","44","66","110","58374","58484","0.1880856302578483003898502154"
"2018-08-31T00:00:00.000","Garfield","WA","Passenger","1","1","2","1318","1320","0.1515151515151515151515151515"
"2018-08-31T00:00:00.000","Garfield","WA","Truck","0","0","0","957","957","0"
"2018-08-31T00:00:00.000","Grant","WA","Passenger","36","52","88","63561","63649","0.1382582601454853964712721331"
"2018-08-31T00:00:00.000","Grant","WA","Truck","0","0","0","26008","26008","0"
"2018-08-31T00:00:00.000","Grays Harbor","WA","Passenger","64","71","135","46968","47103","0.2866059486656900834341761671"
"2018-08-31T00:00:00.000","Grays Harbor","WA","Truck","0","0","0","20305","20305","0"
"2018-08-31T00:00:00.000","Island","WA","Passenger","229","210","439","62724","63163","0.6950271519718822728496113231"
"2018-08-31T00:00:00.000","Island","WA","Truck","0","0","0","21051","21051","0"
"2018-08-31T00:00:00.000","Jefferson","WA","Truck","0","0","0","9627","9627","0"
"2018-08-31T00:00:00.000","Jefferson","WA","Passenger","163","107","270","24678","24948","1.082251082251082251082251082"
"2018-08-31T00:00:00.000","King","WA","Passenger","14171","6190","20361","1373689","1394050","1.460564542161328503281804813"
"2018-08-31T00:00:00.000","King","WA","Truck","7","1","8","183056","183064","0.004370056373727221081151946860"
"2018-08-31T00:00:00.000","Kitsap","WA","Passenger","898","507","1405","179307","180712","0.7774801894727522245340652530"
"2018-08-31T00:00:00.000","Kitsap","WA","Truck","1","0","1","53464","53465","0.001870382493219863462077994950"
"2018-08-31T00:00:00.000","Kittitas","WA","Truck","0","0","0","14117","14117","0"
"2018-08-31T00:00:00.000","Kittitas","WA","Passenger","54","34","88","29127","29215","0.3012151292144446346055108677"
"2018-08-31T00:00:00.000","Klickitat","WA","Passenger","28","34","62","15279","15341","0.4041457532103513460660973861"
"2018-08-31T00:00:00.000","Klickitat","WA","Truck","0","0","0","8162","8162","0"
"2018-08-31T00:00:00.000","Lewis","WA","Truck","0","0","0","25609","25609","0"
"2018-08-31T00:00:00.000","Lewis","WA","Passenger","90","69","159","57852","58011","0.2740859492165278998810570409"
"2018-08-31T00:00:00.000","Lincoln","WA","Passenger","5","7","12","7751","7763","0.1545794151745459229679247714"
"2018-08-31T00:00:00.000","Lincoln","WA","Truck","0","0","0","4573","4573","0"
"2018-08-31T00:00:00.000","Mason","WA","Passenger","110","98","208","46026","46234","0.4498853657481507115975256305"
"2018-08-31T00:00:00.000","Mason","WA","Truck","0","0","0","20083","20083","0"
"2018-08-31T00:00:00.000","Okanogan","WA","Truck","0","0","0","16474","16474","0"
"2018-08-31T00:00:00.000","Okanogan","WA","Passenger","11","20","31","26064","26095","0.1187967043494922398926997509"
"2018-08-31T00:00:00.000","Pacific","WA","Passenger","30","23","53","15671","15724","0.3370643602136860849656575935"
"2018-08-31T00:00:00.000","Pacific","WA","Truck","0","0","0","7625","7625","0"
"2018-08-31T00:00:00.000","Pend Oreille","WA","Passenger","6","5","11","9586","9597","0.1146191518182765447535688236"
"2018-08-31T00:00:00.000","Pend Oreille","WA","Truck","0","0","0","5715","5715","0"
"2018-08-31T00:00:00.000","Pierce","WA","Passenger","1505","1306","2811","534770","537581","0.5228979446818246924649494681"
"2018-08-31T00:00:00.000","Pierce","WA","Truck","0","0","0","138343","138343","0"
"2018-08-31T00:00:00.000","San Juan","WA","Truck","0","0","0","5756","5756","0"
"2018-08-31T00:00:00.000","San Juan","WA","Passenger","152","68","220","14152","14372","1.530754244364041191205121069"
"2018-08-31T00:00:00.000","Skagit","WA","Passenger","252","185","437","90816","91253","0.4788883653140170734112851084"
"2018-08-31T00:00:00.000","Skagit","WA","Truck","1","0","1","32241","32242","0.003101544569195459338750697848"
"2018-08-31T00:00:00.000","Skamania","WA","Truck","0","0","0","3948","3948","0"
"2018-08-31T00:00:00.000","Skamania","WA","Passenger","16","10","26","8671","8697","0.2989536621823617339312406577"
"2018-08-31T00:00:00.000","Snohomish","WA","Passenger","2608","1404","4012","523558","527570","0.7604678052201603578672024565"
"2018-08-31T00:00:00.000","Snohomish","WA","Truck","1","0","1","121739","121740","0.0008214227041235419747001807130"
"2018-08-31T00:00:00.000","Spokane","WA","Truck","1","0","1","93060","93061","0.001074563995658761457538603712"
"2018-08-31T00:00:00.000","Spokane","WA","Passenger","391","364","755","304773","305528","0.2471131942080594904558665654"
"2018-08-31T00:00:00.000","Stevens","WA","Truck","0","0","0","18673","18673","0"
"2018-08-31T00:00:00.000","Stevens","WA","Passenger","14","28","42","31678","31720","0.1324085750315258511979823455"
"2018-08-31T00:00:00.000","Thurston","WA","Passenger","681","546","1227","194234","195461","0.6277467116202209136349450786"
"2018-08-31T00:00:00.000","Thurston","WA","Truck","0","0","0","54572","54572","0"
"2018-08-31T00:00:00.000","Wahkiakum","WA","Passenger","2","2","4","2959","2963","0.1349983125210934863314208572"
"2018-08-31T00:00:00.000","Wahkiakum","WA","Truck","0","0","0","1692","1692","0"
"2018-08-31T00:00:00.000","Walla Walla","WA","Truck","0","0","0","13502","13502","0"
"2018-08-31T00:00:00.000","Walla Walla","WA","Passenger","35","48","83","35889","35972","0.2307350161236517291226509507"
"2018-08-31T00:00:00.000","Whatcom","WA","Passenger","699","335","1034","148255","149289","0.6926163347600961892704753867"
"2018-08-31T00:00:00.000","Whatcom","WA","Truck","2","0","2","42399","42401","0.004716869885144218296738284474"
"2018-08-31T00:00:00.000","Whitman","WA","Truck","0","0","0","8510","8510","0"
"2018-08-31T00:00:00.000","Whitman","WA","Passenger","21","32","53","22693","22746","0.2330080014068407632111140420"
"2018-08-31T00:00:00.000","Yakima","WA","Passenger","79","100","179","164216","164395","0.1088840901487271510690714438"
"2018-08-31T00:00:00.000","Yakima","WA","Truck","0","0","0","58620","58620","0"
"2018-08-31T00:00:00.000","Ozaukee","WI","Passenger","0","1","1","4","5","20.0"
"2018-08-31T00:00:00.000",,,"Passenger","2","0","2","252","254","0.7874015748031496062992125984"
"2018-09-30T00:00:00.000","Juneau","AK","Passenger","0","1","1","42","43","2.325581395348837209302325581"
"2018-09-30T00:00:00.000","Dale","AL","Passenger","0","1","1","61","62","1.612903225806451612903225806"
"2018-09-30T00:00:00.000","Lee","AL","Passenger","1","0","1","37","38","2.631578947368421052631578947"
"2018-09-30T00:00:00.000","Cochise","AZ","Passenger","0","1","1","126","127","0.7874015748031496062992125984"
"2018-09-30T00:00:00.000","Maricopa","AZ","Passenger","3","2","5","1471","1476","0.3387533875338753387533875339"
"2018-09-30T00:00:00.000","Pima","AZ","Passenger","0","1","1","398","399","0.2506265664160401002506265664"
"2018-09-30T00:00:00.000","Pinal","AZ","Passenger","2","0","2","180","182","1.098901098901098901098901099"
"2018-09-30T00:00:00.000","Alameda","CA","Passenger","0","2","2","325","327","0.6116207951070336391437308869"
"2018-09-30T00:00:00.000","Contra Costa","CA","Passenger","0","1","1","450","451","0.2217294900221729490022172949"
"2018-09-30T00:00:00.000","Fresno","CA","Passenger","1","0","1","189","190","0.5263157894736842105263157895"
"2018-09-30T00:00:00.000","Los Angeles","CA","Passenger","8","5","13","1115","1128","1.152482269503546099290780142"
"2018-09-30T00:00:00.000","Monterey","CA","Passenger","0","1","1","190","191","0.5235602094240837696335078534"
"2018-09-30T00:00:00.000","Orange","CA","Passenger","3","1","4","543","547","0.7312614259597806215722120658"
"2018-09-30T00:00:00.000","Riverside","CA","Passenger","1","2","3","670","673","0.4457652303120356612184249629"
"2018-09-30T00:00:00.000","San Diego","CA","Passenger","7","3","10","2583","2593","0.3856536829926725800231392210"
"2018-09-30T00:00:00.000","San Francisco","CA","Passenger","1","1","2","110","112","1.785714285714285714285714286"
"2018-09-30T00:00:00.000","San Mateo","CA","Passenger","1","1","2","130","132","1.515151515151515151515151515"
"2018-09-30T00:00:00.000","Santa Clara","CA","Passenger","8","0","8","366","374","2.139037433155080213903743316"
"2018-09-30T00:00:00.000","Tuolumne","CA","Passenger","0","1","1","11","12","8.333333333333333333333333333"
"2018-09-30T00:00:00.000","Ventura","CA","Passenger","0","2","2","308","310","0.6451612903225806451612903226"
"2018-09-30T00:00:00.000","Denver","CO","Passenger","1","0","1","130","131","0.7633587786259541984732824427"
"2018-09-30T00:00:00.000","El Paso","CO","Passenger","3","1","4","759","763","0.5242463958060288335517693316"
"2018-09-30T00:00:00.000","Jefferson","CO","Passenger","0","1","1","65","66","1.515151515151515151515151515"
"2018-09-30T00:00:00.000","Larimer","CO","Passenger","1","1","2","60","62","3.225806451612903225806451613"
"2018-09-30T00:00:00.000","New London","CT","Passenger","0","1","1","270","271","0.3690036900369003690036900369"
"2018-09-30T00:00:00.000","District of Columbia","DC","Passenger","0","4","4","197","201","1.990049751243781094527363184"
"2018-09-30T00:00:00.000","Kent","DE","Passenger","0","1","1","74","75","1.333333333333333333333333333"
"2018-09-30T00:00:00.000","New Castle","DE","Passenger","1","0","1","27","28","3.571428571428571428571428571"
"2018-09-30T00:00:00.000","Brevard","FL","Passenger","0","1","1","86","87","1.149425287356321839080459770"
"2018-09-30T00:00:00.000","Broward","FL","Passenger","0","1","1","130","131","0.7633587786259541984732824427"
"2018-09-30T00:00:00.000","Clay","FL","Passenger","0","1","1","87","88","1.136363636363636363636363636"
"2018-09-30T00:00:00.000","Duval","FL","Passenger","1","1","2","378","380","0.5263157894736842105263157895"
"2018-09-30T00:00:00.000","Manatee","FL","Passenger","1","0","1","36","37","2.702702702702702702702702703"
"2018-09-30T00:00:00.000","Miami-Dade","FL","Passenger","0","1","1","112","113","0.8849557522123893805309734513"
"2018-09-30T00:00:00.000","Orange","FL","Passenger","2","1","3","163","166","1.807228915662650602409638554"
"2018-09-30T00:00:00.000","Palm Beach","FL","Passenger","0","1","1","78","79","1.265822784810126582278481013"
"2018-09-30T00:00:00.000","Polk","FL","Passenger","1","0","1","63","64","1.562500"
"2018-09-30T00:00:00.000","Santa Rosa","FL","Passenger","1","0","1","91","92","1.086956521739130434782608696"
"2018-09-30T00:00:00.000","St. Lucie","FL","Passenger","1","0","1","27","28","3.571428571428571428571428571"
"2018-09-30T00:00:00.000","Sumter","FL","Passenger","0","1","1","10","11","9.090909090909090909090909091"
"2018-09-30T00:00:00.000","Volusia","FL","Passenger","0","1","1","36","37","2.702702702702702702702702703"
"2018-09-30T00:00:00.000","Bryan","GA","Passenger","1","0","1","54","55","1.818181818181818181818181818"
"2018-09-30T00:00:00.000","Camden","GA","Passenger","0","1","1","161","162","0.6172839506172839506172839506"
"2018-09-30T00:00:00.000","Columbia","GA","Passenger","1","1","2","156","158","1.265822784810126582278481013"
"2018-09-30T00:00:00.000","DeKalb","GA","Passenger","1","0","1","75","76","1.315789473684210526315789474"
"2018-09-30T00:00:00.000","Fulton","GA","Passenger","1","2","3","102","105","2.857142857142857142857142857"
"2018-09-30T00:00:00.000","Gwinnett","GA","Passenger","0","1","1","87","88","1.136363636363636363636363636"
"2018-09-30T00:00:00.000","Houston","GA","Passenger","1","0","1","57","58","1.724137931034482758620689655"
"2018-09-30T00:00:00.000","Liberty","GA","Passenger","1","0","1","147","148","0.6756756756756756756756756757"
"2018-09-30T00:00:00.000","Lumpkin","GA","Passenger","1","0","1","7","8","12.500"
"2018-09-30T00:00:00.000","Honolulu","HI","Passenger","2","1","3","517","520","0.5769230769230769230769230769"
"2018-09-30T00:00:00.000","Maui","HI","Passenger","1","0","1","54","55","1.818181818181818181818181818"
"2018-09-30T00:00:00.000","Ada","ID","Passenger","0","2","2","306","308","0.6493506493506493506493506494"
"2018-09-30T00:00:00.000","Kootenai","ID","Passenger","0","1","1","204","205","0.4878048780487804878048780488"
"2018-09-30T00:00:00.000","Latah","ID","Passenger","0","1","1","71","72","1.388888888888888888888888889"
"2018-09-30T00:00:00.000","Madison","ID","Passenger","1","0","1","37","38","2.631578947368421052631578947"
"2018-09-30T00:00:00.000","Twin Falls","ID","Passenger","0","1","1","21","22","4.545454545454545454545454545"
"2018-09-30T00:00:00.000","Cook","IL","Passenger","1","0","1","246","247","0.4048582995951417004048582996"
"2018-09-30T00:00:00.000","DuPage","IL","Passenger","1","0","1","53","54","1.851851851851851851851851852"
"2018-09-30T00:00:00.000","Monroe","IL","Passenger","1","0","1","4","5","20.0"
"2018-09-30T00:00:00.000","Sangamon","IL","Passenger","1","0","1","11","12","8.333333333333333333333333333"
"2018-09-30T00:00:00.000","St. Clair","IL","Passenger","0","1","1","157","158","0.6329113924050632911392405063"
"2018-09-30T00:00:00.000","DeKalb","IN","Passenger","1","0","1","1","2","50.0"
"2018-09-30T00:00:00.000","Hamilton","IN","Passenger","1","0","1","48","49","2.040816326530612244897959184"
"2018-09-30T00:00:00.000","Marion","IN","Passenger","1","0","1","119","120","0.8333333333333333333333333333"
"2018-09-30T00:00:00.000","Hardin","KY","Passenger","0","1","1","121","122","0.8196721311475409836065573770"
"2018-09-30T00:00:00.000","Oldham","KY","Passenger","0","1","1","5","6","16.66666666666666666666666667"
"2018-09-30T00:00:00.000","Caddo","LA","Passenger","0","1","1","24","25","4.00"
"2018-09-30T00:00:00.000","Franklin","MA","Passenger","0","1","1","1","2","50.0"
"2018-09-30T00:00:00.000","Middlesex","MA","Passenger","0","1","1","138","139","0.7194244604316546762589928058"
"2018-09-30T00:00:00.000","Nantucket","MA","Passenger","1","0","1","3","4","25.00"
"2018-09-30T00:00:00.000","Norfolk","MA","Passenger","1","0","1","31","32","3.12500"
"2018-09-30T00:00:00.000","Suffolk","MA","Passenger","0","1","1","46","47","2.127659574468085106382978723"
"2018-09-30T00:00:00.000","Anne Arundel","MD","Passenger","0","1","1","457","458","0.2183406113537117903930131004"
"2018-09-30T00:00:00.000","Charles","MD","Passenger","0","1","1","82","83","1.204819277108433734939759036"
"2018-09-30T00:00:00.000","Frederick","MD","Passenger","0","1","1","91","92","1.086956521739130434782608696"
"2018-09-30T00:00:00.000","Howard","MD","Passenger","0","1","1","89","90","1.111111111111111111111111111"
"2018-09-30T00:00:00.000","Montgomery","MD","Passenger","1","1","2","291","293","0.6825938566552901023890784983"
"2018-09-30T00:00:00.000","St. Mary's","MD","Passenger","1","0","1","215","216","0.4629629629629629629629629630"
"2018-09-30T00:00:00.000","Kent","MI","Passenger","0","1","1","26","27","3.703703703703703703703703704"
"2018-09-30T00:00:00.000","Washtenaw","MI","Passenger","1","0","1","31","32","3.12500"
"2018-09-30T00:00:00.000","Dakota","MN","Passenger","0","1","1","30","31","3.225806451612903225806451613"
"2018-09-30T00:00:00.000","Hennepin","MN","Passenger","1","0","1","107","108","0.9259259259259259259259259259"
"2018-09-30T00:00:00.000","Kanabec","MN","Passenger","1","0","1","0","1","100"
"2018-09-30T00:00:00.000","Ramsey","MN","Passenger","1","0","1","40","41","2.439024390243902439024390244"
"2018-09-30T00:00:00.000","Flathead","MT","Passenger","1","0","1","49","50","2.00"
"2018-09-30T00:00:00.000","Gallatin","MT","Passenger","0","1","1","57","58","1.724137931034482758620689655"
"2018-09-30T00:00:00.000","Glacier","MT","Passenger","0","1","1","4","5","20.0"
"2018-09-30T00:00:00.000","Cumberland","NC","Passenger","0","1","1","548","549","0.1821493624772313296903460838"
"2018-09-30T00:00:00.000","Guilford","NC","Passenger","1","0","1","24","25","4.00"
"2018-09-30T00:00:00.000","Mecklenburg","NC","Passenger","1","0","1","79","80","1.2500"
"2018-09-30T00:00:00.000","Moore","NC","Passenger","0","1","1","197","198","0.5050505050505050505050505051"
"2018-09-30T00:00:00.000","Douglas","NE","Passenger","0","1","1","69","70","1.428571428571428571428571429"
"2018-09-30T00:00:00.000","Carroll","NH","Passenger","0","1","1","1","2","50.0"
"2018-09-30T00:00:00.000","Camden","NJ","Passenger","0","1","1","26","27","3.703703703703703703703703704"
"2018-09-30T00:00:00.000","Morris","NJ","Passenger","1","0","1","17","18","5.555555555555555555555555556"
"2018-09-30T00:00:00.000","Santa Fe","NM","Passenger","0","1","1","42","43","2.325581395348837209302325581"
"2018-09-30T00:00:00.000","Carson City","NV","Passenger","1","0","1","13","14","7.142857142857142857142857143"
"2018-09-30T00:00:00.000","Clark","NV","Passenger","1","2","3","724","727","0.4126547455295735900962861073"
"2018-09-30T00:00:00.000","Washoe","NV","Passenger","1","0","1","99","100","1.00"
"2018-09-30T00:00:00.000","Jefferson","NY","Passenger","0","1","1","231","232","0.4310344827586206896551724138"
"2018-09-30T00:00:00.000","Nassau","NY","Passenger","2","0","2","36","38","5.263157894736842105263157895"
"2018-09-30T00:00:00.000","Queens","NY","Passenger","1","0","1","63","64","1.562500"
"2018-09-30T00:00:00.000","Saratoga","NY","Passenger","1","0","1","62","63","1.587301587301587301587301587"
"2018-09-30T00:00:00.000","Garfield","OK","Passenger","1","0","1","16","17","5.882352941176470588235294118"
"2018-09-30T00:00:00.000","Jackson","OK","Passenger","1","0","1","45","46","2.173913043478260869565217391"
"2018-09-30T00:00:00.000","Oklahoma","OK","Passenger","0","1","1","110","111","0.9009009009009009009009009009"
"2018-09-30T00:00:00.000","Tulsa","OK","Passenger","1","1","2","47","49","4.081632653061224489795918367"
"2018-09-30T00:00:00.000","Clackamas","OR","Passenger","0","1","1","211","212","0.4716981132075471698113207547"
"2018-09-30T00:00:00.000","Deschutes","OR","Passenger","2","0","2","155","157","1.273885350318471337579617834"
"2018-09-30T00:00:00.000","Douglas","OR","Passenger","1","0","1","48","49","2.040816326530612244897959184"
"2018-09-30T00:00:00.000","Klamath","OR","Passenger","1","0","1","29","30","3.333333333333333333333333333"
"2018-09-30T00:00:00.000","Lane","OR","Passenger","0","1","1","168","169","0.5917159763313609467455621302"
"2018-09-30T00:00:00.000","Marion","OR","Passenger","1","0","1","119","120","0.8333333333333333333333333333"
"2018-09-30T00:00:00.000","Multnomah","OR","Passenger","3","4","7","752","759","0.9222661396574440052700922266"
"2018-09-30T00:00:00.000","Washington","OR","Passenger","0","1","1","441","442","0.2262443438914027149321266968"
"2018-09-30T00:00:00.000","Allegheny","PA","Passenger","1","0","1","75","76","1.315789473684210526315789474"
"2018-09-30T00:00:00.000","Montgomery","PA","Passenger","2","0","2","30","32","6.2500"
"2018-09-30T00:00:00.000","San Juan","PR","Passenger","0","1","1","4","5","20.0"
"2018-09-30T00:00:00.000","Newport","RI","Passenger","1","0","1","100","101","0.9900990099009900990099009901"
"2018-09-30T00:00:00.000","Beaufort","SC","Passenger","1","0","1","36","37","2.702702702702702702702702703"
"2018-09-30T00:00:00.000","Richland","SC","Passenger","0","1","1","167","168","0.5952380952380952380952380952"
"2018-09-30T00:00:00.000","Shelby","TN","Passenger","0","1","1","105","106","0.9433962264150943396226415094"
"2018-09-30T00:00:00.000","Bexar","TX","Passenger","3","4","7","722","729","0.9602194787379972565157750343"
"2018-09-30T00:00:00.000","Dallas","TX","Passenger","0","1","1","188","189","0.5291005291005291005291005291"
"2018-09-30T00:00:00.000","El Paso","TX","Passenger","1","0","1","502","503","0.1988071570576540755467196819"
"2018-09-30T00:00:00.000","Guadalupe","TX","Passenger","1","0","1","74","75","1.333333333333333333333333333"
"2018-09-30T00:00:00.000","Montgomery","TX","Passenger","2","0","2","55","57","3.508771929824561403508771930"
"2018-09-30T00:00:00.000","Nueces","TX","Passenger","1","1","2","89","91","2.197802197802197802197802198"
"2018-09-30T00:00:00.000","Tarrant","TX","Passenger","1","0","1","199","200","0.500"
"2018-09-30T00:00:00.000","Utah","UT","Passenger","0","1","1","134","135","0.7407407407407407407407407407"
"2018-09-30T00:00:00.000","Alexandria","VA","Passenger","1","0","1","158","159","0.6289308176100628930817610063"
"2018-09-30T00:00:00.000","Arlington","VA","Passenger","1","1","2","169","171","1.169590643274853801169590643"
"2018-09-30T00:00:00.000","Fairfax","VA","Passenger","2","3","5","811","816","0.6127450980392156862745098039"
"2018-09-30T00:00:00.000","Manassas","VA","Passenger","0","1","1","9","10","10.0"
"2018-09-30T00:00:00.000","Norfolk","VA","Passenger","2","2","4","337","341","1.173020527859237536656891496"
"2018-09-30T00:00:00.000","Portsmouth","VA","Passenger","0","1","1","66","67","1.492537313432835820895522388"
"2018-09-30T00:00:00.000","Prince George","VA","Passenger","0","1","1","74","75","1.333333333333333333333333333"
"2018-09-30T00:00:00.000","Prince William","VA","Passenger","0","4","4","256","260","1.538461538461538461538461538"
"2018-09-30T00:00:00.000","Rockbridge","VA","Passenger","1","0","1","1","2","50.0"
"2018-09-30T00:00:00.000","Virginia Beach","VA","Passenger","2","1","3","688","691","0.4341534008683068017366136035"
"2018-09-30T00:00:00.000","Adams","WA","Passenger","5","5","10","12683","12693","0.07878358150161506342078310880"
"2018-09-30T00:00:00.000","Adams","WA","Truck","0","0","0","5157","5157","0"
"2018-09-30T00:00:00.000","Asotin","WA","Truck","0","0","0","6635","6635","0"
"2018-09-30T00:00:00.000","Asotin","WA","Passenger","12","9","21","12678","12699","0.1653673517599811008740845736"
"2018-09-30T00:00:00.000","Benton","WA","Passenger","200","217","417","132442","132859","0.3138665803596293815247743849"
"2018-09-30T00:00:00.000","Benton","WA","Truck","0","0","0","41355","41355","0"
"2018-09-30T00:00:00.000","Chelan","WA","Truck","0","0","0","22033","22033","0"
"2018-09-30T00:00:00.000","Chelan","WA","Passenger","118","58","176","53818","53994","0.3259621439419194725339852576"
"2018-09-30T00:00:00.000","Clallam","WA","Truck","0","0","0","21494","21494","0"
"2018-09-30T00:00:00.000","Clallam","WA","Passenger","135","127","262","50171","50433","0.5195011202982174369956179486"
"2018-09-30T00:00:00.000","Clark","WA","Passenger","1182","814","1996","309642","311638","0.6404867185644882844839204462"
"2018-09-30T00:00:00.000","Clark","WA","Truck","0","0","0","79374","79374","0"
"2018-09-30T00:00:00.000","Columbia","WA","Truck","0","0","0","1522","1522","0"
"2018-09-30T00:00:00.000","Columbia","WA","Passenger","2","2","4","2429","2433","0.1644060830250719276613234690"
"2018-09-30T00:00:00.000","Cowlitz","WA","Truck","0","0","0","28609","28609","0"
"2018-09-30T00:00:00.000","Cowlitz","WA","Passenger","74","94","168","72014","72182","0.2327450056800864481449668893"
"2018-09-30T00:00:00.000","Douglas","WA","Passenger","49","33","82","27853","27935","0.2935385716842670485054591015"
"2018-09-30T00:00:00.000","Douglas","WA","Truck","0","0","0","12015","12015","0"
"2018-09-30T00:00:00.000","Ferry","WA","Passenger","2","2","4","4407","4411","0.09068238494672409884379959193"
"2018-09-30T00:00:00.000","Ferry","WA","Truck","0","0","0","3562","3562","0"
"2018-09-30T00:00:00.000","Franklin","WA","Passenger","45","66","111","58514","58625","0.1893390191897654584221748401"
"2018-09-30T00:00:00.000","Franklin","WA","Truck","0","0","0","18873","18873","0"
"2018-09-30T00:00:00.000","Garfield","WA","Truck","0","0","0","967","967","0"
"2018-09-30T00:00:00.000","Garfield","WA","Passenger","1","1","2","1320","1322","0.1512859304084720121028744327"
"2018-09-30T00:00:00.000","Grant","WA","Passenger","36","53","89","63783","63872","0.1393411823647294589178356713"
"2018-09-30T00:00:00.000","Grant","WA","Truck","0","0","0","26069","26069","0"
"2018-09-30T00:00:00.000","Grays Harbor","WA","Truck","0","0","0","20303","20303","0"
"2018-09-30T00:00:00.000","Grays Harbor","WA","Passenger","66","71","137","47144","47281","0.2897569848353461221209365284"
"2018-09-30T00:00:00.000","Island","WA","Truck","0","0","0","21099","21099","0"
"2018-09-30T00:00:00.000","Island","WA","Passenger","241","214","455","62872","63327","0.7184929019217711244808691395"
"2018-09-30T00:00:00.000","Jefferson","WA","Truck","0","0","0","9648","9648","0"
"2018-09-30T00:00:00.000","Jefferson","WA","Passenger","163","105","268","24692","24960","1.073717948717948717948717949"
"2018-09-30T00:00:00.000","King","WA","Passenger","14572","6335","20907","1373936","1394843","1.498878368389847459534872383"
"2018-09-30T00:00:00.000","King","WA","Truck","7","1","8","182928","182936","0.004373114094546726724100231775"
"2018-09-30T00:00:00.000","Kitsap","WA","Passenger","911","518","1429","179440","180869","0.7900745843676915336514272761"
"2018-09-30T00:00:00.000","Kitsap","WA","Truck","1","0","1","53566","53567","0.001866820990535217577986446880"
"2018-09-30T00:00:00.000","Kittitas","WA","Passenger","59","36","95","29206","29301","0.3242210163475649295245896045"
"2018-09-30T00:00:00.000","Kittitas","WA","Truck","0","0","0","14108","14108","0"
"2018-09-30T00:00:00.000","Klickitat","WA","Passenger","28","34","62","15358","15420","0.4020752269779507133592736706"
"2018-09-30T00:00:00.000","Klickitat","WA","Truck","0","0","0","8141","8141","0"
"2018-09-30T00:00:00.000","Lewis","WA","Truck","0","0","0","25572","25572","0"
"2018-09-30T00:00:00.000","Lewis","WA","Passenger","91","73","164","57919","58083","0.2823545615756761875247490660"
"2018-09-30T00:00:00.000","Lincoln","WA","Truck","0","0","0","4581","4581","0"
"2018-09-30T00:00:00.000","Lincoln","WA","Passenger","4","7","11","7751","7762","0.1417160525637722236536975006"
"2018-09-30T00:00:00.000","Mason","WA","Truck","0","0","0","20091","20091","0"
"2018-09-30T00:00:00.000","Mason","WA","Passenger","112","101","213","46168","46381","0.4592397749078286367262456609"
"2018-09-30T00:00:00.000","Okanogan","WA","Passenger","11","20","31","26059","26090","0.1188194710617094672288233039"
"2018-09-30T00:00:00.000","Okanogan","WA","Truck","0","0","0","16502","16502","0"
"2018-09-30T00:00:00.000","Pacific","WA","Truck","0","0","0","7633","7633","0"
"2018-09-30T00:00:00.000","Pacific","WA","Passenger","29","23","52","15727","15779","0.3295519361176246910450598897"
"2018-09-30T00:00:00.000","Pend Oreille","WA","Truck","0","0","0","5741","5741","0"
"2018-09-30T00:00:00.000","Pend Oreille","WA","Passenger","6","5","11","9591","9602","0.1145594667777546344511560092"
"2018-09-30T00:00:00.000","Pierce","WA","Truck","0","0","0","138505","138505","0"
"2018-09-30T00:00:00.000","Pierce","WA","Passenger","1527","1347","2874","535496","538370","0.5338336088563627245203113101"
"2018-09-30T00:00:00.000","San Juan","WA","Passenger","161","70","231","14183","14414","1.602608574996531150270570279"
"2018-09-30T00:00:00.000","San Juan","WA","Truck","0","0","0","5763","5763","0"
"2018-09-30T00:00:00.000","Skagit","WA","Truck","1","0","1","32273","32274","0.003098469356138067794509512301"
"2018-09-30T00:00:00.000","Skagit","WA","Passenger","252","192","444","90843","91287","0.4863781261296789247099806106"
"2018-09-30T00:00:00.000","Skamania","WA","Truck","0","0","0","3967","3967","0"
"2018-09-30T00:00:00.000","Skamania","WA","Passenger","17","11","28","8711","8739","0.3204027920814738528435747797"
"2018-09-30T00:00:00.000","Snohomish","WA","Truck","1","0","1","121803","121804","0.0008209911004564710518537979048"
"2018-09-30T00:00:00.000","Snohomish","WA","Passenger","2652","1425","4077","524490","528567","0.7713307868255112407698550988"
"2018-09-30T00:00:00.000","Spokane","WA","Truck","1","0","1","93217","93218","0.001072754189105108455448518526"
"2018-09-30T00:00:00.000","Spokane","WA","Passenger","392","373","765","305176","305941","0.2500482119101395367080580896"
"2018-09-30T00:00:00.000","Stevens","WA","Passenger","15","29","44","31693","31737","0.1386394429215111699278444718"
"2018-09-30T00:00:00.000","Stevens","WA","Truck","0","0","0","18676","18676","0"
"2018-09-30T00:00:00.000","Thurston","WA","Passenger","699","556","1255","194587","195842","0.6408227040165030994373014981"
"2018-09-30T00:00:00.000","Thurston","WA","Truck","0","0","0","54648","54648","0"
"2018-09-30T00:00:00.000","Wahkiakum","WA","Truck","0","0","0","1693","1693","0"
"2018-09-30T00:00:00.000","Wahkiakum","WA","Passenger","2","2","4","2978","2982","0.1341381623071763916834339370"
"2018-09-30T00:00:00.000","Walla Walla","WA","Truck","0","0","0","13497","13497","0"
"2018-09-30T00:00:00.000","Walla Walla","WA","Passenger","37","50","87","35945","36032","0.2414520426287744227353463588"
"2018-09-30T00:00:00.000","Whatcom","WA","Passenger","711","349","1060","148495","149555","0.7087693490689044164354250944"
"2018-09-30T00:00:00.000","Whatcom","WA","Truck","2","0","2","42439","42441","0.004712424306684573879032068047"
"2018-09-30T00:00:00.000","Whitman","WA","Passenger","21","34","55","22706","22761","0.2416414041562321514871930056"
"2018-09-30T00:00:00.000","Whitman","WA","Truck","0","0","0","8522","8522","0"
"2018-09-30T00:00:00.000","Yakima","WA","Truck","0","0","0","58693","58693","0"
"2018-09-30T00:00:00.000","Yakima","WA","Passenger","78","101","179","164246","164425","0.1088642238102478333586741676"
"2018-09-30T00:00:00.000","Ozaukee","WI","Passenger","0","1","1","4","5","20.0"
"2018-09-30T00:00:00.000",,,"Passenger","2","0","2","249","251","0.7968127490039840637450199203"
"2018-10-31T00:00:00.000","Juneau","AK","Passenger","0","1","1","42","43","2.325581395348837209302325581"
"2018-10-31T00:00:00.000","Dale","AL","Passenger","0","1","1","62","63","1.587301587301587301587301587"
"2018-10-31T00:00:00.000","Lee","AL","Passenger","1","0","1","36","37","2.702702702702702702702702703"
"2018-10-31T00:00:00.000","Cochise","AZ","Passenger","0","1","1","127","128","0.7812500"
"2018-10-31T00:00:00.000","Maricopa","AZ","Passenger","4","2","6","1467","1473","0.4073319755600814663951120163"
"2018-10-31T00:00:00.000","Pima","AZ","Passenger","0","1","1","394","395","0.2531645569620253164556962025"
"2018-10-31T00:00:00.000","Pinal","AZ","Passenger","2","0","2","183","185","1.081081081081081081081081081"
"2018-10-31T00:00:00.000","Alameda","CA","Passenger","0","2","2","324","326","0.6134969325153374233128834356"
"2018-10-31T00:00:00.000","Contra Costa","CA","Passenger","0","1","1","446","447","0.2237136465324384787472035794"
"2018-10-31T00:00:00.000","Fresno","CA","Passenger","1","0","1","183","184","0.5434782608695652173913043478"
"2018-10-31T00:00:00.000","Los Angeles","CA","Passenger","7","5","12","1118","1130","1.061946902654867256637168142"
"2018-10-31T00:00:00.000","Monterey","CA","Passenger","0","1","1","191","192","0.5208333333333333333333333333"
"2018-10-31T00:00:00.000","Orange","CA","Passenger","4","1","5","542","547","0.9140767824497257769652650823"
"2018-10-31T00:00:00.000","Riverside","CA","Passenger","1","2","3","660","663","0.4524886877828054298642533937"
"2018-10-31T00:00:00.000","San Diego","CA","Passenger","7","3","10","2585","2595","0.3853564547206165703275529865"
"2018-10-31T00:00:00.000","San Francisco","CA","Passenger","1","1","2","108","110","1.818181818181818181818181818"
"2018-10-31T00:00:00.000","San Mateo","CA","Passenger","1","1","2","126","128","1.562500"
"2018-10-31T00:00:00.000","Santa Barbara","CA","Passenger","1","0","1","101","102","0.9803921568627450980392156863"
"2018-10-31T00:00:00.000","Santa Clara","CA","Passenger","8","0","8","365","373","2.144772117962466487935656836"
"2018-10-31T00:00:00.000","Santa Cruz","CA","Passenger","1","0","1","40","41","2.439024390243902439024390244"
"2018-10-31T00:00:00.000","Shasta","CA","Passenger","1","0","1","43","44","2.272727272727272727272727273"
"2018-10-31T00:00:00.000","Tuolumne","CA","Passenger","0","1","1","11","12","8.333333333333333333333333333"
"2018-10-31T00:00:00.000","Ventura","CA","Passenger","0","2","2","313","315","0.6349206349206349206349206349"
"2018-10-31T00:00:00.000","Denver","CO","Passenger","1","0","1","125","126","0.7936507936507936507936507937"
"2018-10-31T00:00:00.000","El Paso","CO","Passenger","3","1","4","754","758","0.5277044854881266490765171504"
"2018-10-31T00:00:00.000","Jefferson","CO","Passenger","0","1","1","65","66","1.515151515151515151515151515"
"2018-10-31T00:00:00.000","Larimer","CO","Passenger","1","1","2","59","61","3.278688524590163934426229508"
"2018-10-31T00:00:00.000","New London","CT","Passenger","0","1","1","271","272","0.3676470588235294117647058824"
"2018-10-31T00:00:00.000","District of Columbia","DC","Passenger","0","4","4","193","197","2.030456852791878172588832487"
"2018-10-31T00:00:00.000","Kent","DE","Passenger","0","1","1","75","76","1.315789473684210526315789474"
"2018-10-31T00:00:00.000","New Castle","DE","Passenger","1","0","1","27","28","3.571428571428571428571428571"
"2018-10-31T00:00:00.000","Brevard","FL","Passenger","0","1","1","85","86","1.162790697674418604651162791"
"2018-10-31T00:00:00.000","Broward","FL","Passenger","1","1","2","131","133","1.503759398496240601503759398"
"2018-10-31T00:00:00.000","Clay","FL","Passenger","0","1","1","87","88","1.136363636363636363636363636"
"2018-10-31T00:00:00.000","Duval","FL","Passenger","1","1","2","378","380","0.5263157894736842105263157895"
"2018-10-31T00:00:00.000","Manatee","FL","Passenger","1","0","1","38","39","2.564102564102564102564102564"
"2018-10-31T00:00:00.000","Miami-Dade","FL","Passenger","0","1","1","112","113","0.8849557522123893805309734513"
"2018-10-31T00:00:00.000","Orange","FL","Passenger","2","1","3","162","165","1.818181818181818181818181818"
"2018-10-31T00:00:00.000","Palm Beach","FL","Passenger","0","1","1","80","81","1.234567901234567901234567901"
"2018-10-31T00:00:00.000","Polk","FL","Passenger","1","0","1","62","63","1.587301587301587301587301587"
"2018-10-31T00:00:00.000","Santa Rosa","FL","Passenger","1","0","1","90","91","1.098901098901098901098901099"
"2018-10-31T00:00:00.000","St. Lucie","FL","Passenger","1","0","1","26","27","3.703703703703703703703703704"
"2018-10-31T00:00:00.000","Sumter","FL","Passenger","0","1","1","10","11","9.090909090909090909090909091"
"2018-10-31T00:00:00.000","Volusia","FL","Passenger","0","1","1","34","35","2.857142857142857142857142857"
"2018-10-31T00:00:00.000","Bryan","GA","Passenger","1","0","1","53","54","1.851851851851851851851851852"
"2018-10-31T00:00:00.000","Camden","GA","Passenger","0","1","1","159","160","0.62500"
"2018-10-31T00:00:00.000","Columbia","GA","Passenger","1","1","2","156","158","1.265822784810126582278481013"
"2018-10-31T00:00:00.000","DeKalb","GA","Passenger","1","0","1","75","76","1.315789473684210526315789474"
"2018-10-31T00:00:00.000","Fulton","GA","Passenger","1","2","3","102","105","2.857142857142857142857142857"
"2018-10-31T00:00:00.000","Gwinnett","GA","Passenger","0","1","1","82","83","1.204819277108433734939759036"
"2018-10-31T00:00:00.000","Houston","GA","Passenger","1","0","1","56","57","1.754385964912280701754385965"
"2018-10-31T00:00:00.000","Liberty","GA","Passenger","1","0","1","147","148","0.6756756756756756756756756757"
"2018-10-31T00:00:00.000","Lumpkin","GA","Passenger","1","0","1","7","8","12.500"
"2018-10-31T00:00:00.000","Honolulu","HI","Passenger","2","1","3","509","512","0.585937500"
"2018-10-31T00:00:00.000","Maui","HI","Passenger","1","0","1","52","53","1.886792452830188679245283019"
"2018-10-31T00:00:00.000","Ada","ID","Passenger","0","2","2","303","305","0.6557377049180327868852459016"
"2018-10-31T00:00:00.000","Kootenai","ID","Passenger","1","1","2","205","207","0.9661835748792270531400966184"
"2018-10-31T00:00:00.000","Madison","ID","Passenger","1","0","1","37","38","2.631578947368421052631578947"
"2018-10-31T00:00:00.000","Twin Falls","ID","Passenger","0","1","1","20","21","4.761904761904761904761904762"
"2018-10-31T00:00:00.000","Cook","IL","Passenger","1","0","1","241","242","0.4132231404958677685950413223"
"2018-10-31T00:00:00.000","DuPage","IL","Passenger","1","0","1","53","54","1.851851851851851851851851852"
"2018-10-31T00:00:00.000","Monroe","IL","Passenger","1","0","1","3","4","25.00"
"2018-10-31T00:00:00.000","Sangamon","IL","Passenger","1","0","1","11","12","8.333333333333333333333333333"
"2018-10-31T00:00:00.000","St. Clair","IL","Passenger","0","1","1","161","162","0.6172839506172839506172839506"
"2018-10-31T00:00:00.000","DeKalb","IN","Passenger","1","0","1","1","2","50.0"
"2018-10-31T00:00:00.000","Hamilton","IN","Passenger","1","0","1","48","49","2.040816326530612244897959184"
"2018-10-31T00:00:00.000","Marion","IN","Passenger","1","0","1","120","121","0.8264462809917355371900826446"
"2018-10-31T00:00:00.000","Hardin","KY","Passenger","0","1","1","116","117","0.8547008547008547008547008547"
"2018-10-31T00:00:00.000","Oldham","KY","Passenger","0","1","1","5","6","16.66666666666666666666666667"
"2018-10-31T00:00:00.000","Caddo","LA","Passenger","0","1","1","25","26","3.846153846153846153846153846"
"2018-10-31T00:00:00.000","Franklin","MA","Passenger","0","1","1","1","2","50.0"
"2018-10-31T00:00:00.000","Middlesex","MA","Passenger","0","1","1","137","138","0.7246376811594202898550724638"
"2018-10-31T00:00:00.000","Nantucket","MA","Passenger","1","0","1","3","4","25.00"
"2018-10-31T00:00:00.000","Norfolk","MA","Passenger","1","0","1","30","31","3.225806451612903225806451613"
"2018-10-31T00:00:00.000","Suffolk","MA","Passenger","0","1","1","46","47","2.127659574468085106382978723"
"2018-10-31T00:00:00.000","Anne Arundel","MD","Passenger","0","1","1","457","458","0.2183406113537117903930131004"
"2018-10-31T00:00:00.000","Charles","MD","Passenger","0","1","1","81","82","1.219512195121951219512195122"
"2018-10-31T00:00:00.000","Frederick","MD","Passenger","0","1","1","87","88","1.136363636363636363636363636"
"2018-10-31T00:00:00.000","Howard","MD","Passenger","0","1","1","90","91","1.098901098901098901098901099"
"2018-10-31T00:00:00.000","Montgomery","MD","Passenger","1","1","2","287","289","0.6920415224913494809688581315"
"2018-10-31T00:00:00.000","St. Mary's","MD","Passenger","1","0","1","217","218","0.4587155963302752293577981651"
"2018-10-31T00:00:00.000","Kent","MI","Passenger","0","1","1","24","25","4.00"
"2018-10-31T00:00:00.000","Washtenaw","MI","Passenger","1","0","1","31","32","3.12500"
"2018-10-31T00:00:00.000","Dakota","MN","Passenger","0","1","1","30","31","3.225806451612903225806451613"
"2018-10-31T00:00:00.000","Hennepin","MN","Passenger","2","0","2","108","110","1.818181818181818181818181818"
"2018-10-31T00:00:00.000","Kanabec","MN","Passenger","1","0","1","0","1","100"
"2018-10-31T00:00:00.000","Ramsey","MN","Passenger","1","0","1","41","42","2.380952380952380952380952381"
"2018-10-31T00:00:00.000","Flathead","MT","Passenger","1","0","1","51","52","1.923076923076923076923076923"
"2018-10-31T00:00:00.000","Gallatin","MT","Passenger","0","1","1","58","59","1.694915254237288135593220339"
"2018-10-31T00:00:00.000","Glacier","MT","Passenger","0","1","1","4","5","20.0"
"2018-10-31T00:00:00.000","Cumberland","NC","Passenger","0","1","1","545","546","0.1831501831501831501831501832"
"2018-10-31T00:00:00.000","Guilford","NC","Passenger","1","0","1","26","27","3.703703703703703703703703704"
"2018-10-31T00:00:00.000","Mecklenburg","NC","Passenger","1","0","1","78","79","1.265822784810126582278481013"
"2018-10-31T00:00:00.000","Moore","NC","Passenger","0","1","1","198","199","0.5025125628140703517587939698"
"2018-10-31T00:00:00.000","Douglas","NE","Passenger","0","1","1","69","70","1.428571428571428571428571429"
"2018-10-31T00:00:00.000","Carroll","NH","Passenger","0","1","1","1","2","50.0"
"2018-10-31T00:00:00.000","Camden","NJ","Passenger","0","1","1","26","27","3.703703703703703703703703704"
"2018-10-31T00:00:00.000","Morris","NJ","Passenger","1","0","1","17","18","5.555555555555555555555555556"
"2018-10-31T00:00:00.000","Santa Fe","NM","Passenger","0","1","1","41","42","2.380952380952380952380952381"
"2018-10-31T00:00:00.000","Valencia","NM","Passenger","1","0","1","9","10","10.0"
"2018-10-31T00:00:00.000","Carson City","NV","Passenger","1","0","1","13","14","7.142857142857142857142857143"
"2018-10-31T00:00:00.000","Clark","NV","Passenger","2","2","4","720","724","0.5524861878453038674033149171"
"2018-10-31T00:00:00.000","Washoe","NV","Passenger","1","0","1","97","98","1.020408163265306122448979592"
"2018-10-31T00:00:00.000","Jefferson","NY","Passenger","0","1","1","229","230","0.4347826086956521739130434783"
"2018-10-31T00:00:00.000","Nassau","NY","Passenger","2","0","2","34","36","5.555555555555555555555555556"
"2018-10-31T00:00:00.000","Saratoga","NY","Passenger","1","0","1","60","61","1.639344262295081967213114754"
"2018-10-31T00:00:00.000","Garfield","OK","Passenger","1","0","1","15","16","6.2500"
"2018-10-31T00:00:00.000","Jackson","OK","Passenger","1","0","1","47","48","2.083333333333333333333333333"
"2018-10-31T00:00:00.000","Oklahoma","OK","Passenger","0","1","1","108","109","0.9174311926605504587155963303"
"2018-10-31T00:00:00.000","Rogers","OK","Passenger","1","0","1","6","7","14.28571428571428571428571429"
"2018-10-31T00:00:00.000","Tulsa","OK","Passenger","1","1","2","46","48","4.166666666666666666666666667"
"2018-10-31T00:00:00.000","Clackamas","OR","Passenger","0","1","1","209","210","0.4761904761904761904761904762"
"2018-10-31T00:00:00.000","Deschutes","OR","Passenger","2","0","2","154","156","1.282051282051282051282051282"
"2018-10-31T00:00:00.000","Douglas","OR","Passenger","1","0","1","47","48","2.083333333333333333333333333"
"2018-10-31T00:00:00.000","Klamath","OR","Passenger","1","0","1","28","29","3.448275862068965517241379310"
"2018-10-31T00:00:00.000","Lane","OR","Passenger","0","1","1","165","166","0.6024096385542168674698795181"
"2018-10-31T00:00:00.000","Marion","OR","Passenger","1","0","1","118","119","0.8403361344537815126050420168"
"2018-10-31T00:00:00.000","Multnomah","OR","Passenger","3","4","7","736","743","0.9421265141318977119784656797"
"2018-10-31T00:00:00.000","Washington","OR","Passenger","0","1","1","447","448","0.2232142857142857142857142857"
"2018-10-31T00:00:00.000","Allegheny","PA","Passenger","1","0","1","78","79","1.265822784810126582278481013"
"2018-10-31T00:00:00.000","Montgomery","PA","Passenger","2","0","2","30","32","6.2500"
"2018-10-31T00:00:00.000","San Juan","PR","Passenger","0","1","1","4","5","20.0"
"2018-10-31T00:00:00.000","Newport","RI","Passenger","1","0","1","102","103","0.9708737864077669902912621359"
"2018-10-31T00:00:00.000","Beaufort","SC","Passenger","1","0","1","34","35","2.857142857142857142857142857"
"2018-10-31T00:00:00.000","Richland","SC","Passenger","0","1","1","166","167","0.5988023952095808383233532934"
"2018-10-31T00:00:00.000","Shelby","TN","Passenger","0","1","1","105","106","0.9433962264150943396226415094"
"2018-10-31T00:00:00.000","Bexar","TX","Passenger","3","4","7","722","729","0.9602194787379972565157750343"
"2018-10-31T00:00:00.000","Dallas","TX","Passenger","0","1","1","189","190","0.5263157894736842105263157895"
"2018-10-31T00:00:00.000","El Paso","TX","Passenger","1","0","1","503","504","0.1984126984126984126984126984"
"2018-10-31T00:00:00.000","Guadalupe","TX","Passenger","1","0","1","71","72","1.388888888888888888888888889"
"2018-10-31T00:00:00.000","Montgomery","TX","Passenger","2","0","2","55","57","3.508771929824561403508771930"
"2018-10-31T00:00:00.000","Nueces","TX","Passenger","1","1","2","91","93","2.150537634408602150537634409"
"2018-10-31T00:00:00.000","Tarrant","TX","Passenger","1","0","1","194","195","0.5128205128205128205128205128"
"2018-10-31T00:00:00.000","Utah","UT","Passenger","0","1","1","133","134","0.7462686567164179104477611940"
"2018-10-31T00:00:00.000","Albemarle","VA","Passenger","1","0","1","28","29","3.448275862068965517241379310"
"2018-10-31T00:00:00.000","Alexandria","VA","Passenger","1","0","1","160","161","0.6211180124223602484472049689"
"2018-10-31T00:00:00.000","Arlington","VA","Passenger","1","1","2","165","167","1.197604790419161676646706587"
"2018-10-31T00:00:00.000","Fairfax","VA","Passenger","1","3","4","812","816","0.4901960784313725490196078431"
"2018-10-31T00:00:00.000","Manassas","VA","Passenger","0","1","1","9","10","10.0"
"2018-10-31T00:00:00.000","Norfolk","VA","Passenger","2","2","4","342","346","1.156069364161849710982658960"
"2018-10-31T00:00:00.000","Portsmouth","VA","Passenger","0","1","1","67","68","1.470588235294117647058823529"
"2018-10-31T00:00:00.000","Prince George","VA","Passenger","0","1","1","76","77","1.298701298701298701298701299"
"2018-10-31T00:00:00.000","Prince William","VA","Passenger","0","4","4","254","258","1.550387596899224806201550388"
"2018-10-31T00:00:00.000","Rockbridge","VA","Passenger","1","0","1","1","2","50.0"
"2018-10-31T00:00:00.000","Virginia Beach","VA","Passenger","2","1","3","687","690","0.4347826086956521739130434783"
"2018-10-31T00:00:00.000","Adams","WA","Passenger","5","5","10","12722","12732","0.07854225573358466855168080427"
"2018-10-31T00:00:00.000","Adams","WA","Truck","0","0","0","5150","5150","0"
"2018-10-31T00:00:00.000","Asotin","WA","Passenger","13","10","23","12715","12738","0.1805620976605432563981786780"
"2018-10-31T00:00:00.000","Asotin","WA","Truck","0","0","0","6640","6640","0"
"2018-10-31T00:00:00.000","Benton","WA","Passenger","204","225","429","132584","133013","0.3225248659905422778224684805"
"2018-10-31T00:00:00.000","Benton","WA","Truck","0","0","0","41436","41436","0"
"2018-10-31T00:00:00.000","Chelan","WA","Passenger","127","58","185","53943","54128","0.3417824416198640260124150163"
"2018-10-31T00:00:00.000","Chelan","WA","Truck","0","0","0","22065","22065","0"
"2018-10-31T00:00:00.000","Clallam","WA","Passenger","143","124","267","50307","50574","0.5279392573258986831178075691"
"2018-10-31T00:00:00.000","Clallam","WA","Truck","0","0","0","21572","21572","0"
"2018-10-31T00:00:00.000","Clark","WA","Passenger","1243","847","2090","310343","312433","0.6689434214695630743231348801"
"2018-10-31T00:00:00.000","Clark","WA","Truck","0","0","0","79587","79587","0"
"2018-10-31T00:00:00.000","Columbia","WA","Truck","0","0","0","1519","1519","0"
"2018-10-31T00:00:00.000","Columbia","WA","Passenger","2","2","4","2432","2436","0.1642036124794745484400656814"
"2018-10-31T00:00:00.000","Cowlitz","WA","Passenger","80","96","176","72144","72320","0.2433628318584070796460176991"
"2018-10-31T00:00:00.000","Cowlitz","WA","Truck","0","0","0","28675","28675","0"
"2018-10-31T00:00:00.000","Douglas","WA","Passenger","48","33","81","27898","27979","0.2895028414167768683655598842"
"2018-10-31T00:00:00.000","Douglas","WA","Truck","0","0","0","12079","12079","0"
"2018-10-31T00:00:00.000","Ferry","WA","Passenger","3","2","5","4407","4412","0.1133272892112420670897552131"
"2018-10-31T00:00:00.000","Ferry","WA","Truck","0","0","0","3568","3568","0"
"2018-10-31T00:00:00.000","Franklin","WA","Truck","0","0","0","18951","18951","0"
"2018-10-31T00:00:00.000","Franklin","WA","Passenger","43","67","110","58752","58862","0.1868777819306173762359416941"
"2018-10-31T00:00:00.000","Garfield","WA","Passenger","1","1","2","1330","1332","0.1501501501501501501501501502"
"2018-10-31T00:00:00.000","Garfield","WA","Truck","0","0","0","961","961","0"
"2018-10-31T00:00:00.000","Grant","WA","Passenger","35","54","89","63934","64023","0.1390125423675866485481779985"
"2018-10-31T00:00:00.000","Grant","WA","Truck","0","0","0","26087","26087","0"
"2018-10-31T00:00:00.000","Grays Harbor","WA","Truck","0","0","0","20283","20283","0"
"2018-10-31T00:00:00.000","Grays Harbor","WA","Passenger","71","72","143","47257","47400","0.3016877637130801687763713080"
"2018-10-31T00:00:00.000","Island","WA","Passenger","258","222","480","63052","63532","0.7555247749165774727696279040"
"2018-10-31T00:00:00.000","Island","WA","Truck","0","0","0","21128","21128","0"
"2018-10-31T00:00:00.000","Jefferson","WA","Passenger","173","107","280","24781","25061","1.117273851801604086030086589"
"2018-10-31T00:00:00.000","Jefferson","WA","Truck","0","0","0","9616","9616","0"
"2018-10-31T00:00:00.000","King","WA","Truck","7","1","8","182893","182901","0.004373950935205384333601237828"
"2018-10-31T00:00:00.000","King","WA","Passenger","15411","6477","21888","1376282","1398170","1.565474870723874779175636725"
"2018-10-31T00:00:00.000","Kitsap","WA","Passenger","950","526","1476","179905","181381","0.8137566779320877048863993472"
"2018-10-31T00:00:00.000","Kitsap","WA","Truck","1","0","1","53651","53652","0.001863863416088869007679117274"
"2018-10-31T00:00:00.000","Kittitas","WA","Truck","0","0","0","14129","14129","0"
"2018-10-31T00:00:00.000","Kittitas","WA","Passenger","61","35","96","29285","29381","0.3267417718934004969197780879"
"2018-10-31T00:00:00.000","Klickitat","WA","Passenger","28","34","62","15385","15447","0.4013724347769793487408558296"
"2018-10-31T00:00:00.000","Klickitat","WA","Truck","0","0","0","8158","8158","0"
"2018-10-31T00:00:00.000","Lewis","WA","Passenger","95","77","172","58027","58199","0.2955377240158765614529459269"
"2018-10-31T00:00:00.000","Lewis","WA","Truck","0","0","0","25615","25615","0"
"2018-10-31T00:00:00.000","Lincoln","WA","Truck","0","0","0","4609","4609","0"
"2018-10-31T00:00:00.000","Lincoln","WA","Passenger","4","7","11","7743","7754","0.1418622646376063966984782048"
"2018-10-31T00:00:00.000","Mason","WA","Truck","0","0","0","20174","20174","0"
"2018-10-31T00:00:00.000","Mason","WA","Passenger","119","109","228","46337","46565","0.4896381402340813916031354021"
"2018-10-31T00:00:00.000","Okanogan","WA","Truck","0","0","0","16505","16505","0"
"2018-10-31T00:00:00.000","Okanogan","WA","Passenger","16","21","37","26110","26147","0.1415076299384250583240907179"
"2018-10-31T00:00:00.000","Pacific","WA","Truck","0","0","0","7631","7631","0"
"2018-10-31T00:00:00.000","Pacific","WA","Passenger","31","24","55","15758","15813","0.3478150888509454246506039335"
"2018-10-31T00:00:00.000","Pend Oreille","WA","Truck","0","0","0","5749","5749","0"
"2018-10-31T00:00:00.000","Pend Oreille","WA","Passenger","7","5","12","9590","9602","0.1249739637575505103103520100"
"2018-10-31T00:00:00.000","Pierce","WA","Passenger","1608","1385","2993","537094","540087","0.5541699763186301466245253080"
"2018-10-31T00:00:00.000","Pierce","WA","Truck","0","0","0","138826","138826","0"
"2018-10-31T00:00:00.000","San Juan","WA","Truck","0","0","0","5789","5789","0"
"2018-10-31T00:00:00.000","San Juan","WA","Passenger","169","71","240","14212","14452","1.660669803487406587323553833"
"2018-10-31T00:00:00.000","Skagit","WA","Passenger","270","196","466","90997","91463","0.5094956430469151460153286028"
"2018-10-31T00:00:00.000","Skagit","WA","Truck","1","0","1","32346","32347","0.003091476798466627507960552756"
"2018-10-31T00:00:00.000","Skamania","WA","Passenger","20","12","32","8729","8761","0.3652551078643990412053418560"
"2018-10-31T00:00:00.000","Skamania","WA","Truck","0","0","0","3984","3984","0"
"2018-10-31T00:00:00.000","Snohomish","WA","Passenger","2772","1472","4244","525888","530132","0.8005553333886654644503633057"
"2018-10-31T00:00:00.000","Snohomish","WA","Truck","1","0","1","121890","121891","0.0008204051160463036647496533788"
"2018-10-31T00:00:00.000","Spokane","WA","Passenger","416","381","797","306239","307036","0.2595786813272710691905835146"
"2018-10-31T00:00:00.000","Spokane","WA","Truck","1","0","1","93464","93465","0.001069919221098807040068474830"
"2018-10-31T00:00:00.000","Stevens","WA","Passenger","16","30","46","31804","31850","0.1444270015698587127158555730"
"2018-10-31T00:00:00.000","Stevens","WA","Truck","0","0","0","18717","18717","0"
"2018-10-31T00:00:00.000","Thurston","WA","Truck","0","0","0","54809","54809","0"
"2018-10-31T00:00:00.000","Thurston","WA","Passenger","742","580","1322","195061","196383","0.6731743582693002958504554875"
"2018-10-31T00:00:00.000","Wahkiakum","WA","Passenger","2","2","4","2982","2986","0.1339584728734092431346282652"
"2018-10-31T00:00:00.000","Wahkiakum","WA","Truck","0","0","0","1703","1703","0"
"2018-10-31T00:00:00.000","Walla Walla","WA","Passenger","37","50","87","36015","36102","0.2409838790094731593817517035"
"2018-10-31T00:00:00.000","Walla Walla","WA","Truck","0","0","0","13512","13512","0"
"2018-10-31T00:00:00.000","Whatcom","WA","Truck","2","0","2","42562","42564","0.004698806503148200357109294239"
"2018-10-31T00:00:00.000","Whatcom","WA","Passenger","745","355","1100","148800","149900","0.7338225483655770513675783856"
"2018-10-31T00:00:00.000","Whitman","WA","Passenger","20","35","55","22763","22818","0.2410377771934437724603383294"
"2018-10-31T00:00:00.000","Whitman","WA","Truck","0","0","0","8536","8536","0"
"2018-10-31T00:00:00.000","Yakima","WA","Truck","0","0","0","58759","58759","0"
"2018-10-31T00:00:00.000","Yakima","WA","Passenger","81","104","185","164428","164613","0.1123848055742863564846032816"
"2018-10-31T00:00:00.000","Ozaukee","WI","Passenger","0","1","1","4","5","20.0"
"2018-10-31T00:00:00.000",,,"Passenger","3","0","3","248","251","1.195219123505976095617529880"
"2018-11-30T00:00:00.000","Juneau","AK","Passenger","0","1","1","42","43","2.325581395348837209302325581"
"2018-11-30T00:00:00.000","Dale","AL","Passenger","0","1","1","61","62","1.612903225806451612903225806"
"2018-11-30T00:00:00.000","Lee","AL","Passenger","1","0","1","36","37","2.702702702702702702702702703"
"2018-11-30T00:00:00.000","Cochise","AZ","Passenger","0","1","1","125","126","0.7936507936507936507936507937"
"2018-11-30T00:00:00.000","Maricopa","AZ","Passenger","4","3","7","1443","1450","0.4827586206896551724137931034"
"2018-11-30T00:00:00.000","Pima","AZ","Passenger","0","1","1","388","389","0.2570694087403598971722365039"
"2018-11-30T00:00:00.000","Pinal","AZ","Passenger","2","0","2","180","182","1.098901098901098901098901099"
"2018-11-30T00:00:00.000","Alameda","CA","Passenger","0","2","2","318","320","0.62500"
"2018-11-30T00:00:00.000","Contra Costa","CA","Passenger","0","1","1","441","442","0.2262443438914027149321266968"
"2018-11-30T00:00:00.000","Fresno","CA","Passenger","1","0","1","187","188","0.5319148936170212765957446809"
"2018-11-30T00:00:00.000","Los Angeles","CA","Passenger","8","5","13","1109","1122","1.158645276292335115864527629"
"2018-11-30T00:00:00.000","Monterey","CA","Passenger","0","1","1","193","194","0.5154639175257731958762886598"
"2018-11-30T00:00:00.000","Orange","CA","Passenger","4","2","6","539","545","1.100917431192660550458715596"
"2018-11-30T00:00:00.000","Riverside","CA","Passenger","1","2","3","664","667","0.4497751124437781109445277361"
"2018-11-30T00:00:00.000","San Diego","CA","Passenger","7","3","10","2591","2601","0.3844675124951941560938100730"
"2018-11-30T00:00:00.000","San Francisco","CA","Passenger","2","1","3","112","115","2.608695652173913043478260870"
"2018-11-30T00:00:00.000","San Mateo","CA","Passenger","2","1","3","125","128","2.3437500"
"2018-11-30T00:00:00.000","Santa Barbara","CA","Passenger","1","0","1","99","100","1.00"
"2018-11-30T00:00:00.000","Santa Clara","CA","Passenger","8","1","9","365","374","2.406417112299465240641711230"
"2018-11-30T00:00:00.000","Santa Cruz","CA","Passenger","1","0","1","40","41","2.439024390243902439024390244"
"2018-11-30T00:00:00.000","Shasta","CA","Passenger","1","0","1","42","43","2.325581395348837209302325581"
"2018-11-30T00:00:00.000","Tuolumne","CA","Passenger","0","1","1","11","12","8.333333333333333333333333333"
"2018-11-30T00:00:00.000","Ventura","CA","Passenger","0","2","2","318","320","0.62500"
"2018-11-30T00:00:00.000","Denver","CO","Passenger","1","0","1","126","127","0.7874015748031496062992125984"
"2018-11-30T00:00:00.000","El Paso","CO","Passenger","3","1","4","760","764","0.5235602094240837696335078534"
"2018-11-30T00:00:00.000","Jefferson","CO","Passenger","0","2","2","65","67","2.985074626865671641791044776"
"2018-11-30T00:00:00.000","Larimer","CO","Passenger","1","1","2","59","61","3.278688524590163934426229508"
"2018-11-30T00:00:00.000","New London","CT","Passenger","0","1","1","270","271","0.3690036900369003690036900369"
"2018-11-30T00:00:00.000","District of Columbia","DC","Passenger","1","4","5","194","199","2.512562814070351758793969849"
"2018-11-30T00:00:00.000","Kent","DE","Passenger","0","1","1","75","76","1.315789473684210526315789474"
"2018-11-30T00:00:00.000","New Castle","DE","Passenger","1","0","1","25","26","3.846153846153846153846153846"
"2018-11-30T00:00:00.000","Brevard","FL","Passenger","0","1","1","88","89","1.123595505617977528089887640"
"2018-11-30T00:00:00.000","Broward","FL","Passenger","1","1","2","128","130","1.538461538461538461538461538"
"2018-11-30T00:00:00.000","Clay","FL","Passenger","0","1","1","84","85","1.176470588235294117647058824"
"2018-11-30T00:00:00.000","Duval","FL","Passenger","1","1","2","377","379","0.5277044854881266490765171504"
"2018-11-30T00:00:00.000","Manatee","FL","Passenger","1","0","1","38","39","2.564102564102564102564102564"
"2018-11-30T00:00:00.000","Miami-Dade","FL","Passenger","0","1","1","113","114","0.8771929824561403508771929825"
"2018-11-30T00:00:00.000","Orange","FL","Passenger","2","1","3","162","165","1.818181818181818181818181818"
"2018-11-30T00:00:00.000","Palm Beach","FL","Passenger","0","1","1","82","83","1.204819277108433734939759036"
"2018-11-30T00:00:00.000","Polk","FL","Passenger","1","0","1","63","64","1.562500"
"2018-11-30T00:00:00.000","Santa Rosa","FL","Passenger","1","0","1","89","90","1.111111111111111111111111111"
"2018-11-30T00:00:00.000","St. Lucie","FL","Passenger","1","0","1","26","27","3.703703703703703703703703704"
"2018-11-30T00:00:00.000","Sumter","FL","Passenger","0","1","1","10","11","9.090909090909090909090909091"
"2018-11-30T00:00:00.000","Volusia","FL","Passenger","0","1","1","33","34","2.941176470588235294117647059"
"2018-11-30T00:00:00.000","Bryan","GA","Passenger","1","0","1","53","54","1.851851851851851851851851852"
"2018-11-30T00:00:00.000","Camden","GA","Passenger","0","1","1","160","161","0.6211180124223602484472049689"
"2018-11-30T00:00:00.000","Columbia","GA","Passenger","1","1","2","156","158","1.265822784810126582278481013"
"2018-11-30T00:00:00.000","DeKalb","GA","Passenger","1","0","1","75","76","1.315789473684210526315789474"
"2018-11-30T00:00:00.000","Fulton","GA","Passenger","1","2","3","102","105","2.857142857142857142857142857"
"2018-11-30T00:00:00.000","Gwinnett","GA","Passenger","0","1","1","80","81","1.234567901234567901234567901"
"2018-11-30T00:00:00.000","Houston","GA","Passenger","1","0","1","55","56","1.785714285714285714285714286"
"2018-11-30T00:00:00.000","Liberty","GA","Passenger","1","0","1","148","149","0.6711409395973154362416107383"
"2018-11-30T00:00:00.000","Lumpkin","GA","Passenger","1","0","1","7","8","12.500"
"2018-11-30T00:00:00.000","Honolulu","HI","Passenger","2","2","4","510","514","0.7782101167315175097276264591"
"2018-11-30T00:00:00.000","Maui","HI","Passenger","1","0","1","50","51","1.960784313725490196078431373"
"2018-11-30T00:00:00.000","Ada","ID","Passenger","0","2","2","304","306","0.6535947712418300653594771242"
"2018-11-30T00:00:00.000","Kootenai","ID","Passenger","1","1","2","206","208","0.9615384615384615384615384615"
"2018-11-30T00:00:00.000","Madison","ID","Passenger","1","0","1","37","38","2.631578947368421052631578947"
"2018-11-30T00:00:00.000","Twin Falls","ID","Passenger","0","1","1","21","22","4.545454545454545454545454545"
"2018-11-30T00:00:00.000","Cook","IL","Passenger","1","0","1","239","240","0.4166666666666666666666666667"
"2018-11-30T00:00:00.000","DuPage","IL","Passenger","1","0","1","54","55","1.818181818181818181818181818"
"2018-11-30T00:00:00.000","Monroe","IL","Passenger","1","0","1","3","4","25.00"
"2018-11-30T00:00:00.000","Sangamon","IL","Passenger","1","0","1","9","10","10.0"
"2018-11-30T00:00:00.000","St. Clair","IL","Passenger","0","1","1","163","164","0.6097560975609756097560975610"
"2018-11-30T00:00:00.000","DeKalb","IN","Passenger","1","0","1","1","2","50.0"
"2018-11-30T00:00:00.000","Hamilton","IN","Passenger","1","0","1","47","48","2.083333333333333333333333333"
"2018-11-30T00:00:00.000","Marion","IN","Passenger","1","0","1","121","122","0.8196721311475409836065573770"
"2018-11-30T00:00:00.000","Hardin","KY","Passenger","0","1","1","111","112","0.8928571428571428571428571429"
"2018-11-30T00:00:00.000","Oldham","KY","Passenger","0","1","1","5","6","16.66666666666666666666666667"
"2018-11-30T00:00:00.000","Caddo","LA","Passenger","0","1","1","24","25","4.00"
"2018-11-30T00:00:00.000","Franklin","MA","Passenger","0","1","1","1","2","50.0"
"2018-11-30T00:00:00.000","Middlesex","MA","Passenger","0","1","1","133","134","0.7462686567164179104477611940"
"2018-11-30T00:00:00.000","Nantucket","MA","Passenger","1","0","1","3","4","25.00"
"2018-11-30T00:00:00.000","Norfolk","MA","Passenger","1","0","1","29","30","3.333333333333333333333333333"
"2018-11-30T00:00:00.000","Suffolk","MA","Passenger","0","1","1","46","47","2.127659574468085106382978723"
"2018-11-30T00:00:00.000","Anne Arundel","MD","Passenger","0","2","2","457","459","0.4357298474945533769063180828"
"2018-11-30T00:00:00.000","Charles","MD","Passenger","0","1","1","78","79","1.265822784810126582278481013"
"2018-11-30T00:00:00.000","Frederick","MD","Passenger","0","1","1","86","87","1.149425287356321839080459770"
"2018-11-30T00:00:00.000","Howard","MD","Passenger","0","1","1","89","90","1.111111111111111111111111111"
"2018-11-30T00:00:00.000","Montgomery","MD","Passenger","1","1","2","283","285","0.7017543859649122807017543860"
"2018-11-30T00:00:00.000","St. Mary's","MD","Passenger","1","0","1","215","216","0.4629629629629629629629629630"
"2018-11-30T00:00:00.000","Kent","MI","Passenger","0","1","1","22","23","4.347826086956521739130434783"
"2018-11-30T00:00:00.000","Washtenaw","MI","Passenger","1","0","1","32","33","3.030303030303030303030303030"
"2018-11-30T00:00:00.000","Dakota","MN","Passenger","0","1","1","31","32","3.12500"
"2018-11-30T00:00:00.000","Hennepin","MN","Passenger","2","0","2","105","107","1.869158878504672897196261682"
"2018-11-30T00:00:00.000","Kanabec","MN","Passenger","1","0","1","0","1","100"
"2018-11-30T00:00:00.000","Ramsey","MN","Passenger","1","0","1","41","42","2.380952380952380952380952381"
"2018-11-30T00:00:00.000","Flathead","MT","Passenger","1","0","1","53","54","1.851851851851851851851851852"
"2018-11-30T00:00:00.000","Gallatin","MT","Passenger","0","1","1","57","58","1.724137931034482758620689655"
"2018-11-30T00:00:00.000","Glacier","MT","Passenger","0","1","1","4","5","20.0"
"2018-11-30T00:00:00.000","Cumberland","NC","Passenger","0","1","1","542","543","0.1841620626151012891344383057"
"2018-11-30T00:00:00.000","Guilford","NC","Passenger","1","0","1","24","25","4.00"
"2018-11-30T00:00:00.000","Mecklenburg","NC","Passenger","1","0","1","76","77","1.298701298701298701298701299"
"2018-11-30T00:00:00.000","Moore","NC","Passenger","0","1","1","196","197","0.5076142131979695431472081218"
"2018-11-30T00:00:00.000","Douglas","NE","Passenger","0","1","1","67","68","1.470588235294117647058823529"
"2018-11-30T00:00:00.000","Carroll","NH","Passenger","0","1","1","1","2","50.0"
"2018-11-30T00:00:00.000","Bergen","NJ","Passenger","1","0","1","27","28","3.571428571428571428571428571"
"2018-11-30T00:00:00.000","Camden","NJ","Passenger","0","1","1","25","26","3.846153846153846153846153846"
"2018-11-30T00:00:00.000","Morris","NJ","Passenger","1","0","1","18","19","5.263157894736842105263157895"
"2018-11-30T00:00:00.000","Santa Fe","NM","Passenger","0","1","1","41","42","2.380952380952380952380952381"
"2018-11-30T00:00:00.000","Valencia","NM","Passenger","1","0","1","9","10","10.0"
"2018-11-30T00:00:00.000","Carson City","NV","Passenger","1","0","1","14","15","6.666666666666666666666666667"
"2018-11-30T00:00:00.000","Clark","NV","Passenger","2","2","4","713","717","0.5578800557880055788005578801"
"2018-11-30T00:00:00.000","Washoe","NV","Passenger","1","0","1","96","97","1.030927835051546391752577320"
"2018-11-30T00:00:00.000","Jefferson","NY","Passenger","0","1","1","236","237","0.4219409282700421940928270042"
"2018-11-30T00:00:00.000","Nassau","NY","Passenger","2","0","2","34","36","5.555555555555555555555555556"
"2018-11-30T00:00:00.000","Saratoga","NY","Passenger","1","0","1","62","63","1.587301587301587301587301587"
"2018-11-30T00:00:00.000","Garfield","OK","Passenger","1","0","1","14","15","6.666666666666666666666666667"
"2018-11-30T00:00:00.000","Jackson","OK","Passenger","1","0","1","46","47","2.127659574468085106382978723"
"2018-11-30T00:00:00.000","Oklahoma","OK","Passenger","0","1","1","109","110","0.9090909090909090909090909091"
"2018-11-30T00:00:00.000","Rogers","OK","Passenger","1","0","1","6","7","14.28571428571428571428571429"
"2018-11-30T00:00:00.000","Tulsa","OK","Passenger","1","1","2","46","48","4.166666666666666666666666667"
"2018-11-30T00:00:00.000","Clackamas","OR","Passenger","1","1","2","213","215","0.9302325581395348837209302326"
"2018-11-30T00:00:00.000","Deschutes","OR","Passenger","2","0","2","158","160","1.2500"
"2018-11-30T00:00:00.000","Douglas","OR","Passenger","1","0","1","47","48","2.083333333333333333333333333"
"2018-11-30T00:00:00.000","Klamath","OR","Passenger","1","0","1","29","30","3.333333333333333333333333333"
"2018-11-30T00:00:00.000","Lane","OR","Passenger","0","1","1","164","165","0.6060606060606060606060606061"
"2018-11-30T00:00:00.000","Marion","OR","Passenger","1","0","1","116","117","0.8547008547008547008547008547"
"2018-11-30T00:00:00.000","Multnomah","OR","Passenger","3","4","7","734","741","0.9446693657219973009446693657"
"2018-11-30T00:00:00.000","Washington","OR","Passenger","0","1","1","441","442","0.2262443438914027149321266968"
"2018-11-30T00:00:00.000","Allegheny","PA","Passenger","1","0","1","79","80","1.2500"
"2018-11-30T00:00:00.000","Bucks","PA","Passenger","1","0","1","17","18","5.555555555555555555555555556"
"2018-11-30T00:00:00.000","Montgomery","PA","Passenger","2","0","2","29","31","6.451612903225806451612903226"
"2018-11-30T00:00:00.000","San Juan","PR","Passenger","0","1","1","5","6","16.66666666666666666666666667"
"2018-11-30T00:00:00.000","Newport","RI","Passenger","1","0","1","99","100","1.00"
"2018-11-30T00:00:00.000","Beaufort","SC","Passenger","1","0","1","33","34","2.941176470588235294117647059"
"2018-11-30T00:00:00.000","Richland","SC","Passenger","0","1","1","164","165","0.6060606060606060606060606061"
"2018-11-30T00:00:00.000","Shelby","TN","Passenger","0","1","1","104","105","0.9523809523809523809523809524"
"2018-11-30T00:00:00.000","Bexar","TX","Passenger","3","4","7","710","717","0.9762900976290097629009762901"
"2018-11-30T00:00:00.000","Dallas","TX","Passenger","0","1","1","190","191","0.5235602094240837696335078534"
"2018-11-30T00:00:00.000","El Paso","TX","Passenger","1","0","1","497","498","0.2008032128514056224899598394"
"2018-11-30T00:00:00.000","Guadalupe","TX","Passenger","1","0","1","71","72","1.388888888888888888888888889"
"2018-11-30T00:00:00.000","Montgomery","TX","Passenger","2","0","2","56","58","3.448275862068965517241379310"
"2018-11-30T00:00:00.000","Nueces","TX","Passenger","1","1","2","94","96","2.083333333333333333333333333"
"2018-11-30T00:00:00.000","Tarrant","TX","Passenger","1","0","1","195","196","0.5102040816326530612244897959"
"2018-11-30T00:00:00.000","Travis","TX","Passenger","0","1","1","190","191","0.5235602094240837696335078534"
"2018-11-30T00:00:00.000","Albemarle","VA","Passenger","1","0","1","28","29","3.448275862068965517241379310"
"2018-11-30T00:00:00.000","Alexandria","VA","Passenger","1","0","1","158","159","0.6289308176100628930817610063"
"2018-11-30T00:00:00.000","Arlington","VA","Passenger","1","1","2","164","166","1.204819277108433734939759036"
"2018-11-30T00:00:00.000","Fairfax","VA","Passenger","1","3","4","809","813","0.4920049200492004920049200492"
"2018-11-30T00:00:00.000","Goochland","VA","Passenger","0","1","1","227","228","0.4385964912280701754385964912"
"2018-11-30T00:00:00.000","Manassas","VA","Passenger","0","1","1","9","10","10.0"
"2018-11-30T00:00:00.000","Norfolk","VA","Passenger","2","2","4","346","350","1.142857142857142857142857143"
"2018-11-30T00:00:00.000","Portsmouth","VA","Passenger","0","1","1","69","70","1.428571428571428571428571429"
"2018-11-30T00:00:00.000","Prince William","VA","Passenger","0","4","4","253","257","1.556420233463035019455252918"
"2018-11-30T00:00:00.000","Rockbridge","VA","Passenger","1","0","1","1","2","50.0"
"2018-11-30T00:00:00.000","Virginia Beach","VA","Passenger","2","1","3","688","691","0.4341534008683068017366136035"
"2018-11-30T00:00:00.000","Adams","WA","Passenger","5","5","10","12751","12761","0.07836376459525115586552777995"
"2018-11-30T00:00:00.000","Adams","WA","Truck","0","0","0","5160","5160","0"
"2018-11-30T00:00:00.000","Asotin","WA","Truck","0","0","0","6624","6624","0"
"2018-11-30T00:00:00.000","Asotin","WA","Passenger","13","10","23","12728","12751","0.1803780095678770292526076386"
"2018-11-30T00:00:00.000","Benton","WA","Passenger","222","232","454","132804","133258","0.3406924912575605216947575380"
"2018-11-30T00:00:00.000","Benton","WA","Truck","0","0","0","41450","41450","0"
"2018-11-30T00:00:00.000","Chelan","WA","Passenger","136","59","195","54077","54272","0.3593012971698113207547169811"
"2018-11-30T00:00:00.000","Chelan","WA","Truck","0","0","0","22089","22089","0"
"2018-11-30T00:00:00.000","Clallam","WA","Passenger","155","126","281","50330","50611","0.5552152694078362411333504574"
"2018-11-30T00:00:00.000","Clallam","WA","Truck","0","0","0","21615","21615","0"
"2018-11-30T00:00:00.000","Clark","WA","Passenger","1283","863","2146","310916","313062","0.6854872197839405612945678492"
"2018-11-30T00:00:00.000","Clark","WA","Truck","0","0","0","79750","79750","0"
"2018-11-30T00:00:00.000","Columbia","WA","Truck","0","0","0","1517","1517","0"
"2018-11-30T00:00:00.000","Columbia","WA","Passenger","2","2","4","2437","2441","0.1638672675133142154854567800"
"2018-11-30T00:00:00.000","Cowlitz","WA","Truck","0","0","0","28731","28731","0"
"2018-11-30T00:00:00.000","Cowlitz","WA","Passenger","80","101","181","72362","72543","0.2495071888397226472574886619"
"2018-11-30T00:00:00.000","Douglas","WA","Truck","0","0","0","12125","12125","0"
"2018-11-30T00:00:00.000","Douglas","WA","Passenger","50","33","83","27971","28054","0.2958579881656804733727810651"
"2018-11-30T00:00:00.000","Ferry","WA","Passenger","3","2","5","4384","4389","0.1139211665527455001139211666"
"2018-11-30T00:00:00.000","Ferry","WA","Truck","0","0","0","3584","3584","0"
"2018-11-30T00:00:00.000","Franklin","WA","Passenger","46","65","111","58944","59055","0.1879603759207518415036830074"
"2018-11-30T00:00:00.000","Franklin","WA","Truck","0","0","0","18986","18986","0"
"2018-11-30T00:00:00.000","Garfield","WA","Passenger","1","1","2","1331","1333","0.1500375093773443360840210053"
"2018-11-30T00:00:00.000","Garfield","WA","Truck","0","0","0","965","965","0"
"2018-11-30T00:00:00.000","Grant","WA","Truck","0","0","0","26161","26161","0"
"2018-11-30T00:00:00.000","Grant","WA","Passenger","35","56","91","64045","64136","0.1418859922664338281152550829"
"2018-11-30T00:00:00.000","Grays Harbor","WA","Truck","0","0","0","20335","20335","0"
"2018-11-30T00:00:00.000","Grays Harbor","WA","Passenger","72","74","146","47359","47505","0.3073360698873802757604462688"
"2018-11-30T00:00:00.000","Island","WA","Truck","0","0","0","21175","21175","0"
"2018-11-30T00:00:00.000","Island","WA","Passenger","280","230","510","63120","63630","0.8015087223008015087223008015"
"2018-11-30T00:00:00.000","Jefferson","WA","Passenger","180","111","291","24793","25084","1.160102057088183702758730665"
"2018-11-30T00:00:00.000","Jefferson","WA","Truck","0","0","0","9618","9618","0"
"2018-11-30T00:00:00.000","King","WA","Passenger","16160","6653","22813","1377158","1399971","1.629533754627774432470386887"
"2018-11-30T00:00:00.000","King","WA","Truck","6","1","7","182821","182828","0.003828735204673244798389743365"
"2018-11-30T00:00:00.000","Kitsap","WA","Passenger","987","542","1529","180307","181836","0.8408675949756923821465496381"
"2018-11-30T00:00:00.000","Kitsap","WA","Truck","1","0","1","53682","53683","0.001862787102062105321982750591"
"2018-11-30T00:00:00.000","Kittitas","WA","Truck","0","0","0","14164","14164","0"
"2018-11-30T00:00:00.000","Kittitas","WA","Passenger","65","34","99","29291","29390","0.3368492684586594079618917999"
"2018-11-30T00:00:00.000","Klickitat","WA","Truck","0","0","0","8187","8187","0"
"2018-11-30T00:00:00.000","Klickitat","WA","Passenger","27","34","61","15418","15479","0.3940823050584663091931003295"
"2018-11-30T00:00:00.000","Lewis","WA","Passenger","97","77","174","58201","58375","0.2980728051391862955032119914"
"2018-11-30T00:00:00.000","Lewis","WA","Truck","0","0","0","25629","25629","0"
"2018-11-30T00:00:00.000","Lincoln","WA","Truck","0","0","0","4631","4631","0"
"2018-11-30T00:00:00.000","Lincoln","WA","Passenger","4","7","11","7775","7786","0.1412792191112252761366555356"
"2018-11-30T00:00:00.000","Mason","WA","Truck","0","0","0","20191","20191","0"
"2018-11-30T00:00:00.000","Mason","WA","Passenger","121","111","232","46414","46646","0.4973631179522359902242421644"
"2018-11-30T00:00:00.000","Okanogan","WA","Passenger","16","22","38","26135","26173","0.1451877889428036526191112979"
"2018-11-30T00:00:00.000","Okanogan","WA","Truck","0","0","0","16496","16496","0"
"2018-11-30T00:00:00.000","Pacific","WA","Passenger","32","24","56","15804","15860","0.3530895334174022698612862547"
"2018-11-30T00:00:00.000","Pacific","WA","Truck","0","0","0","7612","7612","0"
"2018-11-30T00:00:00.000","Pend Oreille","WA","Passenger","6","5","11","9559","9570","0.1149425287356321839080459770"
"2018-11-30T00:00:00.000","Pend Oreille","WA","Truck","0","0","0","5739","5739","0"
"2018-11-30T00:00:00.000","Pierce","WA","Truck","0","0","0","139111","139111","0"
"2018-11-30T00:00:00.000","Pierce","WA","Passenger","1675","1421","3096","538350","541446","0.5718021741780343746190755865"
"2018-11-30T00:00:00.000","San Juan","WA","Passenger","176","70","246","14213","14459","1.701362473200082993291375614"
"2018-11-30T00:00:00.000","San Juan","WA","Truck","0","0","0","5807","5807","0"
"2018-11-30T00:00:00.000","Skagit","WA","Truck","1","0","1","32351","32352","0.003090999010880316518298714144"
"2018-11-30T00:00:00.000","Skagit","WA","Passenger","279","199","478","91174","91652","0.5215379915331907650678654039"
"2018-11-30T00:00:00.000","Skamania","WA","Passenger","20","14","34","8733","8767","0.3878179536899737652560739135"
"2018-11-30T00:00:00.000","Skamania","WA","Truck","0","0","0","4006","4006","0"
"2018-11-30T00:00:00.000","Snohomish","WA","Passenger","2925","1510","4435","526711","531146","0.8349869903943548478196202174"
"2018-11-30T00:00:00.000","Snohomish","WA","Truck","1","0","1","121977","121978","0.0008198199675351292856088802899"
"2018-11-30T00:00:00.000","Spokane","WA","Passenger","441","384","825","306933","307758","0.2680677675316319965687325756"
"2018-11-30T00:00:00.000","Spokane","WA","Truck","1","0","1","93694","93695","0.001067292811782912642083355569"
"2018-11-30T00:00:00.000","Stevens","WA","Passenger","18","29","47","31788","31835","0.1476362494110256007538872310"
"2018-11-30T00:00:00.000","Stevens","WA","Truck","0","0","0","18729","18729","0"
"2018-11-30T00:00:00.000","Thurston","WA","Truck","0","0","0","54930","54930","0"
"2018-11-30T00:00:00.000","Thurston","WA","Passenger","786","596","1382","195447","196829","0.7021323077392050968099213022"
"2018-11-30T00:00:00.000","Wahkiakum","WA","Passenger","2","2","4","2982","2986","0.1339584728734092431346282652"
"2018-11-30T00:00:00.000","Wahkiakum","WA","Truck","0","0","0","1705","1705","0"
"2018-11-30T00:00:00.000","Walla Walla","WA","Passenger","39","53","92","36112","36204","0.2541155673406253452657164954"
"2018-11-30T00:00:00.000","Walla Walla","WA","Truck","0","0","0","13523","13523","0"
"2018-11-30T00:00:00.000","Whatcom","WA","Truck","2","0","2","42663","42665","0.004687683112621586780733622407"
"2018-11-30T00:00:00.000","Whatcom","WA","Passenger","776","369","1145","149131","150276","0.7619313795948787564215177407"
"2018-11-30T00:00:00.000","Whitman","WA","Truck","0","0","0","8537","8537","0"
"2018-11-30T00:00:00.000","Whitman","WA","Passenger","21","37","58","22812","22870","0.2536073458679492785308264101"
"2018-11-30T00:00:00.000","Yakima","WA","Truck","0","0","0","58752","58752","0"
"2018-11-30T00:00:00.000","Yakima","WA","Passenger","88","106","194","164689","164883","0.1176591886367909366035309886"
"2018-11-30T00:00:00.000","Ozaukee","WI","Passenger","0","1","1","4","5","20.0"
"2018-11-30T00:00:00.000",,,"Passenger","3","0","3","249","252","1.190476190476190476190476190"
"2018-12-31T00:00:00.000","Juneau","AK","Passenger","0","1","1","42","43","2.325581395348837209302325581"
"2018-12-31T00:00:00.000","Dale","AL","Passenger","0","1","1","60","61","1.639344262295081967213114754"
"2018-12-31T00:00:00.000","Lee","AL","Passenger","1","0","1","36","37","2.702702702702702702702702703"
"2018-12-31T00:00:00.000","Montgomery","AL","Passenger","0","1","1","44","45","2.222222222222222222222222222"
"2018-12-31T00:00:00.000","Cochise","AZ","Passenger","0","1","1","125","126","0.7936507936507936507936507937"
"2018-12-31T00:00:00.000","Maricopa","AZ","Passenger","4","3","7","1440","1447","0.4837595024187975120939875605"
"2018-12-31T00:00:00.000","Pima","AZ","Passenger","0","1","1","387","388","0.2577319587628865979381443299"
"2018-12-31T00:00:00.000","Pinal","AZ","Passenger","2","0","2","178","180","1.111111111111111111111111111"
"2018-12-31T00:00:00.000","Alameda","CA","Passenger","0","2","2","314","316","0.6329113924050632911392405063"
"2018-12-31T00:00:00.000","Contra Costa","CA","Passenger","0","2","2","432","434","0.4608294930875576036866359447"
"2018-12-31T00:00:00.000","Fresno","CA","Passenger","1","0","1","188","189","0.5291005291005291005291005291"
"2018-12-31T00:00:00.000","Los Angeles","CA","Passenger","8","5","13","1090","1103","1.178603807796917497733454216"
"2018-12-31T00:00:00.000","Orange","CA","Passenger","5","2","7","535","542","1.291512915129151291512915129"
"2018-12-31T00:00:00.000","Riverside","CA","Passenger","1","2","3","656","659","0.4552352048558421851289833080"
"2018-12-31T00:00:00.000","San Diego","CA","Passenger","7","3","10","2601","2611","0.3829950210647261585599387208"
"2018-12-31T00:00:00.000","San Francisco","CA","Passenger","2","1","3","109","112","2.678571428571428571428571429"
"2018-12-31T00:00:00.000","San Mateo","CA","Passenger","2","1","3","125","128","2.3437500"
"2018-12-31T00:00:00.000","Santa Barbara","CA","Passenger","1","0","1","98","99","1.010101010101010101010101010"
"2018-12-31T00:00:00.000","Santa Clara","CA","Passenger","8","1","9","364","373","2.412868632707774798927613941"
"2018-12-31T00:00:00.000","Santa Cruz","CA","Passenger","1","0","1","41","42","2.380952380952380952380952381"
"2018-12-31T00:00:00.000","Shasta","CA","Passenger","1","0","1","42","43","2.325581395348837209302325581"
"2018-12-31T00:00:00.000","Tuolumne","CA","Passenger","0","1","1","11","12","8.333333333333333333333333333"
"2018-12-31T00:00:00.000","Ventura","CA","Passenger","0","2","2","320","322","0.6211180124223602484472049689"
"2018-12-31T00:00:00.000","Denver","CO","Passenger","1","0","1","124","125","0.800"
"2018-12-31T00:00:00.000","El Paso","CO","Passenger","3","1","4","759","763","0.5242463958060288335517693316"
"2018-12-31T00:00:00.000","Jefferson","CO","Passenger","0","2","2","63","65","3.076923076923076923076923077"
"2018-12-31T00:00:00.000","Larimer","CO","Passenger","1","1","2","58","60","3.333333333333333333333333333"
"2018-12-31T00:00:00.000","New London","CT","Passenger","0","2","2","271","273","0.7326007326007326007326007326"
"2018-12-31T00:00:00.000","District of Columbia","DC","Passenger","1","4","5","196","201","2.487562189054726368159203980"
"2018-12-31T00:00:00.000","Kent","DE","Passenger","0","1","1","77","78","1.282051282051282051282051282"
"2018-12-31T00:00:00.000","New Castle","DE","Passenger","1","0","1","24","25","4.00"
"2018-12-31T00:00:00.000","Brevard","FL","Passenger","0","1","1","87","88","1.136363636363636363636363636"
"2018-12-31T00:00:00.000","Broward","FL","Passenger","1","1","2","124","126","1.587301587301587301587301587"
"2018-12-31T00:00:00.000","Clay","FL","Passenger","0","1","1","83","84","1.190476190476190476190476190"
"2018-12-31T00:00:00.000","Duval","FL","Passenger","1","1","2","375","377","0.5305039787798408488063660477"
"2018-12-31T00:00:00.000","Manatee","FL","Passenger","1","0","1","36","37","2.702702702702702702702702703"
"2018-12-31T00:00:00.000","Miami-Dade","FL","Passenger","0","1","1","114","115","0.8695652173913043478260869565"
"2018-12-31T00:00:00.000","Orange","FL","Passenger","2","0","2","163","165","1.212121212121212121212121212"
"2018-12-31T00:00:00.000","Palm Beach","FL","Passenger","0","1","1","83","84","1.190476190476190476190476190"
"2018-12-31T00:00:00.000","Polk","FL","Passenger","1","0","1","64","65","1.538461538461538461538461538"
"2018-12-31T00:00:00.000","Santa Rosa","FL","Passenger","1","0","1","91","92","1.086956521739130434782608696"
"2018-12-31T00:00:00.000","St. Lucie","FL","Passenger","1","0","1","27","28","3.571428571428571428571428571"
"2018-12-31T00:00:00.000","Sumter","FL","Passenger","0","1","1","10","11","9.090909090909090909090909091"
"2018-12-31T00:00:00.000","Volusia","FL","Passenger","0","1","1","34","35","2.857142857142857142857142857"
"2018-12-31T00:00:00.000","Bryan","GA","Passenger","1","0","1","52","53","1.886792452830188679245283019"
"2018-12-31T00:00:00.000","Camden","GA","Passenger","0","1","1","161","162","0.6172839506172839506172839506"
"2018-12-31T00:00:00.000","Columbia","GA","Passenger","1","1","2","154","156","1.282051282051282051282051282"
"2018-12-31T00:00:00.000","DeKalb","GA","Passenger","1","0","1","75","76","1.315789473684210526315789474"
"2018-12-31T00:00:00.000","Fulton","GA","Passenger","1","2","3","104","107","2.803738317757009345794392523"
"2018-12-31T00:00:00.000","Gwinnett","GA","Passenger","0","1","1","81","82","1.219512195121951219512195122"
"2018-12-31T00:00:00.000","Houston","GA","Passenger","1","0","1","54","55","1.818181818181818181818181818"
"2018-12-31T00:00:00.000","Liberty","GA","Passenger","1","0","1","148","149","0.6711409395973154362416107383"
"2018-12-31T00:00:00.000","Lumpkin","GA","Passenger","1","0","1","7","8","12.500"
"2018-12-31T00:00:00.000","Honolulu","HI","Passenger","2","2","4","509","513","0.7797270955165692007797270955"
"2018-12-31T00:00:00.000","Maui","HI","Passenger","1","0","1","49","50","2.00"
"2018-12-31T00:00:00.000","Ada","ID","Passenger","0","2","2","302","304","0.6578947368421052631578947368"
"2018-12-31T00:00:00.000","Kootenai","ID","Passenger","1","1","2","204","206","0.9708737864077669902912621359"
"2018-12-31T00:00:00.000","Madison","ID","Passenger","1","0","1","35","36","2.777777777777777777777777778"
"2018-12-31T00:00:00.000","Twin Falls","ID","Passenger","0","1","1","21","22","4.545454545454545454545454545"
"2018-12-31T00:00:00.000","Cook","IL","Passenger","1","0","1","236","237","0.4219409282700421940928270042"
"2018-12-31T00:00:00.000","DuPage","IL","Passenger","1","0","1","56","57","1.754385964912280701754385965"
"2018-12-31T00:00:00.000","Monroe","IL","Passenger","1","0","1","3","4","25.00"
"2018-12-31T00:00:00.000","Sangamon","IL","Passenger","1","0","1","10","11","9.090909090909090909090909091"
"2018-12-31T00:00:00.000","St. Clair","IL","Passenger","0","1","1","163","164","0.6097560975609756097560975610"
"2018-12-31T00:00:00.000","DeKalb","IN","Passenger","1","0","1","1","2","50.0"
"2018-12-31T00:00:00.000","Marion","IN","Passenger","1","0","1","121","122","0.8196721311475409836065573770"
"2018-12-31T00:00:00.000","Hardin","KY","Passenger","0","1","1","107","108","0.9259259259259259259259259259"
"2018-12-31T00:00:00.000","Oldham","KY","Passenger","0","1","1","5","6","16.66666666666666666666666667"
"2018-12-31T00:00:00.000","Caddo","LA","Passenger","0","1","1","22","23","4.347826086956521739130434783"
"2018-12-31T00:00:00.000","Franklin","MA","Passenger","0","1","1","1","2","50.0"
"2018-12-31T00:00:00.000","Middlesex","MA","Passenger","1","1","2","126","128","1.562500"
"2018-12-31T00:00:00.000","Nantucket","MA","Passenger","1","0","1","3","4","25.00"
"2018-12-31T00:00:00.000","Norfolk","MA","Passenger","1","0","1","28","29","3.448275862068965517241379310"
"2018-12-31T00:00:00.000","Suffolk","MA","Passenger","0","1","1","45","46","2.173913043478260869565217391"
"2018-12-31T00:00:00.000","Anne Arundel","MD","Passenger","0","2","2","458","460","0.4347826086956521739130434783"
"2018-12-31T00:00:00.000","Charles","MD","Passenger","0","1","1","76","77","1.298701298701298701298701299"
"2018-12-31T00:00:00.000","Frederick","MD","Passenger","0","1","1","83","84","1.190476190476190476190476190"
"2018-12-31T00:00:00.000","Howard","MD","Passenger","0","1","1","86","87","1.149425287356321839080459770"
"2018-12-31T00:00:00.000","Montgomery","MD","Passenger","1","1","2","282","284","0.7042253521126760563380281690"
"2018-12-31T00:00:00.000","St. Mary's","MD","Passenger","1","0","1","210","211","0.4739336492890995260663507109"
"2018-12-31T00:00:00.000","Kent","MI","Passenger","0","1","1","22","23","4.347826086956521739130434783"
"2018-12-31T00:00:00.000","Washtenaw","MI","Passenger","1","0","1","32","33","3.030303030303030303030303030"
"2018-12-31T00:00:00.000","Dakota","MN","Passenger","0","1","1","31","32","3.12500"
"2018-12-31T00:00:00.000","Hennepin","MN","Passenger","2","0","2","101","103","1.941747572815533980582524272"
"2018-12-31T00:00:00.000","Kanabec","MN","Passenger","1","0","1","0","1","100"
"2018-12-31T00:00:00.000","Ramsey","MN","Passenger","1","0","1","40","41","2.439024390243902439024390244"
"2018-12-31T00:00:00.000","Flathead","MT","Passenger","1","0","1","54","55","1.818181818181818181818181818"
"2018-12-31T00:00:00.000","Gallatin","MT","Passenger","0","1","1","57","58","1.724137931034482758620689655"
"2018-12-31T00:00:00.000","Glacier","MT","Passenger","0","1","1","3","4","25.00"
"2018-12-31T00:00:00.000","Cumberland","NC","Passenger","0","1","1","544","545","0.1834862385321100917431192661"
"2018-12-31T00:00:00.000","Guilford","NC","Passenger","1","0","1","23","24","4.166666666666666666666666667"
"2018-12-31T00:00:00.000","Mecklenburg","NC","Passenger","1","0","1","77","78","1.282051282051282051282051282"
"2018-12-31T00:00:00.000","Moore","NC","Passenger","0","1","1","194","195","0.5128205128205128205128205128"
"2018-12-31T00:00:00.000","Douglas","NE","Passenger","0","1","1","68","69","1.449275362318840579710144928"
"2018-12-31T00:00:00.000","Carroll","NH","Passenger","0","1","1","1","2","50.0"
"2018-12-31T00:00:00.000","Bergen","NJ","Passenger","1","0","1","27","28","3.571428571428571428571428571"
"2018-12-31T00:00:00.000","Camden","NJ","Passenger","0","1","1","27","28","3.571428571428571428571428571"
"2018-12-31T00:00:00.000","Santa Fe","NM","Passenger","0","1","1","39","40","2.500"
"2018-12-31T00:00:00.000","Valencia","NM","Passenger","1","0","1","9","10","10.0"
"2018-12-31T00:00:00.000","Carson City","NV","Passenger","1","0","1","14","15","6.666666666666666666666666667"
"2018-12-31T00:00:00.000","Clark","NV","Passenger","2","2","4","709","713","0.5610098176718092566619915849"
"2018-12-31T00:00:00.000","Washoe","NV","Passenger","2","0","2","99","101","1.980198019801980198019801980"
"2018-12-31T00:00:00.000","Jefferson","NY","Passenger","0","1","1","234","235","0.4255319148936170212765957447"
"2018-12-31T00:00:00.000","Nassau","NY","Passenger","2","0","2","33","35","5.714285714285714285714285714"
"2018-12-31T00:00:00.000","Saratoga","NY","Passenger","1","0","1","62","63","1.587301587301587301587301587"
"2018-12-31T00:00:00.000","Garfield","OK","Passenger","1","0","1","14","15","6.666666666666666666666666667"
"2018-12-31T00:00:00.000","Jackson","OK","Passenger","1","0","1","47","48","2.083333333333333333333333333"
"2018-12-31T00:00:00.000","Oklahoma","OK","Passenger","0","1","1","112","113","0.8849557522123893805309734513"
"2018-12-31T00:00:00.000","Rogers","OK","Passenger","1","0","1","5","6","16.66666666666666666666666667"
"2018-12-31T00:00:00.000","Tulsa","OK","Passenger","1","1","2","46","48","4.166666666666666666666666667"
"2018-12-31T00:00:00.000","Clackamas","OR","Passenger","1","1","2","209","211","0.9478672985781990521327014218"
"2018-12-31T00:00:00.000","Deschutes","OR","Passenger","2","0","2","160","162","1.234567901234567901234567901"
"2018-12-31T00:00:00.000","Douglas","OR","Passenger","1","0","1","48","49","2.040816326530612244897959184"
"2018-12-31T00:00:00.000","Klamath","OR","Passenger","1","0","1","30","31","3.225806451612903225806451613"
"2018-12-31T00:00:00.000","Lane","OR","Passenger","0","1","1","158","159","0.6289308176100628930817610063"
"2018-12-31T00:00:00.000","Marion","OR","Passenger","1","0","1","114","115","0.8695652173913043478260869565"
"2018-12-31T00:00:00.000","Multnomah","OR","Passenger","3","4","7","738","745","0.9395973154362416107382550336"
"2018-12-31T00:00:00.000","Washington","OR","Passenger","0","1","1","441","442","0.2262443438914027149321266968"
"2018-12-31T00:00:00.000","Allegheny","PA","Passenger","1","0","1","76","77","1.298701298701298701298701299"
"2018-12-31T00:00:00.000","Bucks","PA","Passenger","1","0","1","17","18","5.555555555555555555555555556"
"2018-12-31T00:00:00.000","Montgomery","PA","Passenger","2","0","2","29","31","6.451612903225806451612903226"
"2018-12-31T00:00:00.000","San Juan","PR","Passenger","0","1","1","5","6","16.66666666666666666666666667"
"2018-12-31T00:00:00.000","Newport","RI","Passenger","1","0","1","99","100","1.00"
"2018-12-31T00:00:00.000","Beaufort","SC","Passenger","1","0","1","33","34","2.941176470588235294117647059"
"2018-12-31T00:00:00.000","Richland","SC","Passenger","0","1","1","163","164","0.6097560975609756097560975610"
"2018-12-31T00:00:00.000","Shelby","TN","Passenger","0","1","1","100","101","0.9900990099009900990099009901"
"2018-12-31T00:00:00.000","Bexar","TX","Passenger","3","4","7","699","706","0.9915014164305949008498583569"
"2018-12-31T00:00:00.000","Dallas","TX","Passenger","0","1","1","195","196","0.5102040816326530612244897959"
"2018-12-31T00:00:00.000","El Paso","TX","Passenger","1","0","1","497","498","0.2008032128514056224899598394"
"2018-12-31T00:00:00.000","Guadalupe","TX","Passenger","1","0","1","70","71","1.408450704225352112676056338"
"2018-12-31T00:00:00.000","Montgomery","TX","Passenger","2","0","2","55","57","3.508771929824561403508771930"
"2018-12-31T00:00:00.000","Nueces","TX","Passenger","1","1","2","93","95","2.105263157894736842105263158"
"2018-12-31T00:00:00.000","Tarrant","TX","Passenger","1","0","1","192","193","0.5181347150259067357512953368"
"2018-12-31T00:00:00.000","Travis","TX","Passenger","1","1","2","187","189","1.058201058201058201058201058"
"2018-12-31T00:00:00.000","Albemarle","VA","Passenger","1","0","1","26","27","3.703703703703703703703703704"
"2018-12-31T00:00:00.000","Alexandria","VA","Passenger","1","0","1","160","161","0.6211180124223602484472049689"
"2018-12-31T00:00:00.000","Arlington","VA","Passenger","1","1","2","163","165","1.212121212121212121212121212"
"2018-12-31T00:00:00.000","Fairfax","VA","Passenger","3","3","6","809","815","0.7361963190184049079754601227"
"2018-12-31T00:00:00.000","Goochland","VA","Passenger","0","1","1","226","227","0.4405286343612334801762114537"
"2018-12-31T00:00:00.000","Manassas","VA","Passenger","0","1","1","9","10","10.0"
"2018-12-31T00:00:00.000","Norfolk","VA","Passenger","2","2","4","345","349","1.146131805157593123209169054"
"2018-12-31T00:00:00.000","Portsmouth","VA","Passenger","0","1","1","70","71","1.408450704225352112676056338"
"2018-12-31T00:00:00.000","Prince William","VA","Passenger","0","4","4","250","254","1.574803149606299212598425197"
"2018-12-31T00:00:00.000","Rockbridge","VA","Passenger","1","0","1","1","2","50.0"
"2018-12-31T00:00:00.000","Virginia Beach","VA","Passenger","2","1","3","686","689","0.4354136429608127721335268505"
"2018-12-31T00:00:00.000","Adams","WA","Truck","0","0","0","5150","5150","0"
"2018-12-31T00:00:00.000","Adams","WA","Passenger","5","6","11","12746","12757","0.08622716939719369757780042330"
"2018-12-31T00:00:00.000","Asotin","WA","Passenger","13","10","23","12727","12750","0.1803921568627450980392156863"
"2018-12-31T00:00:00.000","Asotin","WA","Truck","0","0","0","6639","6639","0"
"2018-12-31T00:00:00.000","Benton","WA","Passenger","239","243","482","132943","133425","0.3612516394978452314034101555"
"2018-12-31T00:00:00.000","Benton","WA","Truck","0","0","0","41568","41568","0"
"2018-12-31T00:00:00.000","Chelan","WA","Passenger","141","60","201","54148","54349","0.3698320116285488233454157390"
"2018-12-31T00:00:00.000","Chelan","WA","Truck","0","0","0","22059","22059","0"
"2018-12-31T00:00:00.000","Clallam","WA","Passenger","158","129","287","50359","50646","0.5666785136042333056904790112"
"2018-12-31T00:00:00.000","Clallam","WA","Truck","0","0","0","21643","21643","0"
"2018-12-31T00:00:00.000","Clark","WA","Passenger","1337","875","2212","311323","313535","0.7055033728291897236353198208"
"2018-12-31T00:00:00.000","Clark","WA","Truck","0","0","0","79848","79848","0"
"2018-12-31T00:00:00.000","Columbia","WA","Passenger","2","2","4","2421","2425","0.1649484536082474226804123711"
"2018-12-31T00:00:00.000","Columbia","WA","Truck","0","0","0","1518","1518","0"
"2018-12-31T00:00:00.000","Cowlitz","WA","Passenger","83","106","189","72421","72610","0.2602947252444566864068310150"
"2018-12-31T00:00:00.000","Cowlitz","WA","Truck","0","0","0","28747","28747","0"
"2018-12-31T00:00:00.000","Douglas","WA","Truck","0","0","0","12163","12163","0"
"2018-12-31T00:00:00.000","Douglas","WA","Passenger","51","34","85","28014","28099","0.3025018683938930211039538774"
"2018-12-31T00:00:00.000","Ferry","WA","Passenger","3","2","5","4384","4389","0.1139211665527455001139211666"
"2018-12-31T00:00:00.000","Ferry","WA","Truck","0","0","0","3587","3587","0"
"2018-12-31T00:00:00.000","Franklin","WA","Passenger","53","67","120","59123","59243","0.2025555761862160930405279949"
"2018-12-31T00:00:00.000","Franklin","WA","Truck","0","0","0","19056","19056","0"
"2018-12-31T00:00:00.000","Garfield","WA","Truck","0","0","0","966","966","0"
"2018-12-31T00:00:00.000","Garfield","WA","Passenger","1","1","2","1329","1331","0.1502629601803155522163786627"
"2018-12-31T00:00:00.000","Grant","WA","Truck","0","0","0","26261","26261","0"
"2018-12-31T00:00:00.000","Grant","WA","Passenger","35","56","91","64212","64303","0.1415175030713963578682176570"
"2018-12-31T00:00:00.000","Grays Harbor","WA","Passenger","73","78","151","47454","47605","0.3171935721037706123306375381"
"2018-12-31T00:00:00.000","Grays Harbor","WA","Truck","0","0","0","20354","20354","0"
"2018-12-31T00:00:00.000","Island","WA","Passenger","290","233","523","63190","63713","0.8208685825498720826205013106"
"2018-12-31T00:00:00.000","Island","WA","Truck","0","0","0","21183","21183","0"
"2018-12-31T00:00:00.000","Jefferson","WA","Passenger","179","114","293","24836","25129","1.165983525010943531378089060"
"2018-12-31T00:00:00.000","Jefferson","WA","Truck","0","0","0","9609","9609","0"
"2018-12-31T00:00:00.000","King","WA","Truck","6","1","7","182716","182723","0.003830935350229582482774472836"
"2018-12-31T00:00:00.000","King","WA","Passenger","16660","6788","23448","1378133","1401581","1.672967884125141536593318545"
"2018-12-31T00:00:00.000","Kitsap","WA","Truck","1","0","1","53668","53669","0.001863273025396411336153086512"
"2018-12-31T00:00:00.000","Kitsap","WA","Passenger","1018","564","1582","179797","181379","0.8722068155629924081619151059"
"2018-12-31T00:00:00.000","Kittitas","WA","Passenger","70","37","107","29344","29451","0.3633153373399884554004957387"
"2018-12-31T00:00:00.000","Kittitas","WA","Truck","0","0","0","14198","14198","0"
"2018-12-31T00:00:00.000","Klickitat","WA","Passenger","32","33","65","15429","15494","0.4195172324770879049954821221"
"2018-12-31T00:00:00.000","Klickitat","WA","Truck","0","0","0","8213","8213","0"
"2018-12-31T00:00:00.000","Lewis","WA","Passenger","101","83","184","58314","58498","0.3145406680570275906868610893"
"2018-12-31T00:00:00.000","Lewis","WA","Truck","0","0","0","25637","25637","0"
"2018-12-31T00:00:00.000","Lincoln","WA","Passenger","4","6","10","7784","7794","0.1283038234539389273800359251"
"2018-12-31T00:00:00.000","Lincoln","WA","Truck","0","0","0","4639","4639","0"
"2018-12-31T00:00:00.000","Mason","WA","Passenger","126","112","238","46449","46687","0.5097778824940561612440293872"
"2018-12-31T00:00:00.000","Mason","WA","Truck","0","0","0","20192","20192","0"
"2018-12-31T00:00:00.000","Okanogan","WA","Passenger","17","22","39","26072","26111","0.1493623377120753705334916319"
"2018-12-31T00:00:00.000","Okanogan","WA","Truck","0","0","0","16491","16491","0"
"2018-12-31T00:00:00.000","Pacific","WA","Passenger","33","26","59","15827","15886","0.3713961979101095304041294221"
"2018-12-31T00:00:00.000","Pacific","WA","Truck","0","0","0","7615","7615","0"
"2018-12-31T00:00:00.000","Pend Oreille","WA","Passenger","6","5","11","9535","9546","0.1152315105803477896501152315"
"2018-12-31T00:00:00.000","Pend Oreille","WA","Truck","0","0","0","5735","5735","0"
"2018-12-31T00:00:00.000","Pierce","WA","Passenger","1715","1459","3174","538809","541983","0.5856272244701402073496770194"
"2018-12-31T00:00:00.000","Pierce","WA","Truck","0","0","0","139170","139170","0"
"2018-12-31T00:00:00.000","San Juan","WA","Passenger","183","71","254","14224","14478","1.754385964912280701754385965"
"2018-12-31T00:00:00.000","San Juan","WA","Truck","0","0","0","5820","5820","0"
"2018-12-31T00:00:00.000","Skagit","WA","Passenger","289","201","490","91185","91675","0.5344968639214616853013362422"
"2018-12-31T00:00:00.000","Skagit","WA","Truck","1","0","1","32332","32333","0.003092815389849379890514335199"
"2018-12-31T00:00:00.000","Skamania","WA","Passenger","18","13","31","8733","8764","0.3537197626654495664080328617"
"2018-12-31T00:00:00.000","Skamania","WA","Truck","0","0","0","4009","4009","0"
"2018-12-31T00:00:00.000","Snohomish","WA","Passenger","3054","1533","4587","527162","531749","0.8626250354960705144720535441"
"2018-12-31T00:00:00.000","Snohomish","WA","Truck","1","0","1","121992","121993","0.0008197191642143401670587656669"
"2018-12-31T00:00:00.000","Spokane","WA","Truck","1","0","1","93791","93792","0.001066189013988399863527806209"
"2018-12-31T00:00:00.000","Spokane","WA","Passenger","472","398","870","307221","308091","0.2823841008013866033087626708"
"2018-12-31T00:00:00.000","Stevens","WA","Passenger","18","29","47","31785","31832","0.1476501633576275446091982910"
"2018-12-31T00:00:00.000","Stevens","WA","Truck","0","0","0","18762","18762","0"
"2018-12-31T00:00:00.000","Thurston","WA","Truck","0","0","0","54884","54884","0"
"2018-12-31T00:00:00.000","Thurston","WA","Passenger","821","602","1423","195596","197019","0.7222653652693395053268974058"
"2018-12-31T00:00:00.000","Wahkiakum","WA","Passenger","2","2","4","2977","2981","0.1341831600134183160013418316"
"2018-12-31T00:00:00.000","Wahkiakum","WA","Truck","0","0","0","1723","1723","0"
"2018-12-31T00:00:00.000","Walla Walla","WA","Passenger","42","53","95","36115","36210","0.2623584645125655896161281414"
"2018-12-31T00:00:00.000","Walla Walla","WA","Truck","0","0","0","13530","13530","0"
"2018-12-31T00:00:00.000","Whatcom","WA","Truck","2","0","2","42673","42675","0.004686584651435266549502050381"
"2018-12-31T00:00:00.000","Whatcom","WA","Passenger","805","385","1190","149443","150633","0.7899995352943910032994098239"
"2018-12-31T00:00:00.000","Whitman","WA","Truck","0","0","0","8548","8548","0"
"2018-12-31T00:00:00.000","Whitman","WA","Passenger","25","40","65","22828","22893","0.2839295854628052243043725156"
"2018-12-31T00:00:00.000","Yakima","WA","Truck","0","0","0","58848","58848","0"
"2018-12-31T00:00:00.000","Yakima","WA","Passenger","92","108","200","164771","164971","0.1212334289056864539828212231"
"2018-12-31T00:00:00.000","Ozaukee","WI","Passenger","0","1","1","3","4","25.00"
"2018-12-31T00:00:00.000",,,"Passenger","3","0","3","245","248","1.209677419354838709677419355"
"2019-01-31T00:00:00.000","Juneau","AK","Passenger","0","1","1","38","39","2.564102564102564102564102564"
"2019-01-31T00:00:00.000","Dale","AL","Passenger","0","1","1","60","61","1.639344262295081967213114754"
"2019-01-31T00:00:00.000","Lee","AL","Passenger","1","0","1","35","36","2.777777777777777777777777778"
"2019-01-31T00:00:00.000","Montgomery","AL","Passenger","0","1","1","43","44","2.272727272727272727272727273"
"2019-01-31T00:00:00.000","Cochise","AZ","Passenger","0","1","1","124","125","0.800"
"2019-01-31T00:00:00.000","Maricopa","AZ","Passenger","6","3","9","1444","1453","0.6194081211286992429456297316"
"2019-01-31T00:00:00.000","Pima","AZ","Passenger","0","1","1","391","392","0.2551020408163265306122448980"
"2019-01-31T00:00:00.000","Pinal","AZ","Passenger","2","0","2","181","183","1.092896174863387978142076503"
"2019-01-31T00:00:00.000","Alameda","CA","Passenger","0","2","2","307","309","0.6472491909385113268608414239"
"2019-01-31T00:00:00.000","Contra Costa","CA","Passenger","1","2","3","430","433","0.6928406466512702078521939954"
"2019-01-31T00:00:00.000","Fresno","CA","Passenger","1","0","1","185","186","0.5376344086021505376344086022"
"2019-01-31T00:00:00.000","Kern","CA","Passenger","0","1","1","235","236","0.4237288135593220338983050847"
"2019-01-31T00:00:00.000","Los Angeles","CA","Passenger","8","5","13","1080","1093","1.189387008234217749313815188"
"2019-01-31T00:00:00.000","Orange","CA","Passenger","4","2","6","534","540","1.111111111111111111111111111"
"2019-01-31T00:00:00.000","Riverside","CA","Passenger","1","2","3","647","650","0.4615384615384615384615384615"
"2019-01-31T00:00:00.000","San Diego","CA","Passenger","8","3","11","2616","2627","0.4187285877426722497145032356"
"2019-01-31T00:00:00.000","San Francisco","CA","Passenger","2","1","3","108","111","2.702702702702702702702702703"
"2019-01-31T00:00:00.000","San Mateo","CA","Passenger","2","1","3","123","126","2.380952380952380952380952381"
"2019-01-31T00:00:00.000","Santa Barbara","CA","Passenger","1","0","1","95","96","1.041666666666666666666666667"
"2019-01-31T00:00:00.000","Santa Clara","CA","Passenger","8","1","9","362","371","2.425876010781671159029649596"
"2019-01-31T00:00:00.000","Santa Cruz","CA","Passenger","1","0","1","41","42","2.380952380952380952380952381"
"2019-01-31T00:00:00.000","Shasta","CA","Passenger","1","0","1","43","44","2.272727272727272727272727273"
"2019-01-31T00:00:00.000","Tuolumne","CA","Passenger","0","1","1","10","11","9.090909090909090909090909091"
"2019-01-31T00:00:00.000","Ventura","CA","Passenger","0","2","2","315","317","0.6309148264984227129337539432"
"2019-01-31T00:00:00.000","Denver","CO","Passenger","1","0","1","126","127","0.7874015748031496062992125984"
"2019-01-31T00:00:00.000","El Paso","CO","Passenger","3","1","4","757","761","0.5256241787122207621550591327"
"2019-01-31T00:00:00.000","Jefferson","CO","Passenger","0","2","2","63","65","3.076923076923076923076923077"
"2019-01-31T00:00:00.000","Larimer","CO","Passenger","1","1","2","56","58","3.448275862068965517241379310"
"2019-01-31T00:00:00.000","New London","CT","Passenger","0","2","2","267","269","0.7434944237918215613382899628"
"2019-01-31T00:00:00.000","District of Columbia","DC","Passenger","1","4","5","200","205","2.439024390243902439024390244"
"2019-01-31T00:00:00.000","Kent","DE","Passenger","0","1","1","75","76","1.315789473684210526315789474"
"2019-01-31T00:00:00.000","New Castle","DE","Passenger","1","0","1","23","24","4.166666666666666666666666667"
"2019-01-31T00:00:00.000","Brevard","FL","Passenger","0","1","1","83","84","1.190476190476190476190476190"
"2019-01-31T00:00:00.000","Broward","FL","Passenger","1","1","2","124","126","1.587301587301587301587301587"
"2019-01-31T00:00:00.000","Clay","FL","Passenger","0","1","1","82","83","1.204819277108433734939759036"
"2019-01-31T00:00:00.000","Duval","FL","Passenger","1","1","2","376","378","0.5291005291005291005291005291"
"2019-01-31T00:00:00.000","Manatee","FL","Passenger","1","0","1","35","36","2.777777777777777777777777778"
"2019-01-31T00:00:00.000","Miami-Dade","FL","Passenger","0","1","1","114","115","0.8695652173913043478260869565"
"2019-01-31T00:00:00.000","Palm Beach","FL","Passenger","0","1","1","80","81","1.234567901234567901234567901"
"2019-01-31T00:00:00.000","Polk","FL","Passenger","1","0","1","67","68","1.470588235294117647058823529"
"2019-01-31T00:00:00.000","Santa Rosa","FL","Passenger","1","0","1","93","94","1.063829787234042553191489362"
"2019-01-31T00:00:00.000","St. Lucie","FL","Passenger","1","0","1","27","28","3.571428571428571428571428571"
"2019-01-31T00:00:00.000","Sumter","FL","Passenger","0","1","1","10","11","9.090909090909090909090909091"
"2019-01-31T00:00:00.000","Volusia","FL","Passenger","0","1","1","34","35","2.857142857142857142857142857"
"2019-01-31T00:00:00.000","Bryan","GA","Passenger","1","0","1","53","54","1.851851851851851851851851852"
"2019-01-31T00:00:00.000","Camden","GA","Passenger","0","1","1","161","162","0.6172839506172839506172839506"
"2019-01-31T00:00:00.000","Columbia","GA","Passenger","1","1","2","150","152","1.315789473684210526315789474"
"2019-01-31T00:00:00.000","DeKalb","GA","Passenger","1","0","1","75","76","1.315789473684210526315789474"
"2019-01-31T00:00:00.000","Fulton","GA","Passenger","1","2","3","103","106","2.830188679245283018867924528"
"2019-01-31T00:00:00.000","Gwinnett","GA","Passenger","0","1","1","78","79","1.265822784810126582278481013"
"2019-01-31T00:00:00.000","Houston","GA","Passenger","1","0","1","54","55","1.818181818181818181818181818"
"2019-01-31T00:00:00.000","Liberty","GA","Passenger","1","0","1","148","149","0.6711409395973154362416107383"
"2019-01-31T00:00:00.000","Lumpkin","GA","Passenger","1","0","1","6","7","14.28571428571428571428571429"
"2019-01-31T00:00:00.000","Honolulu","HI","Passenger","2","2","4","506","510","0.7843137254901960784313725490"
"2019-01-31T00:00:00.000","Maui","HI","Passenger","1","0","1","48","49","2.040816326530612244897959184"
"2019-01-31T00:00:00.000","Ada","ID","Passenger","0","2","2","300","302","0.6622516556291390728476821192"
"2019-01-31T00:00:00.000","Kootenai","ID","Passenger","1","1","2","200","202","0.9900990099009900990099009901"
"2019-01-31T00:00:00.000","Madison","ID","Passenger","1","0","1","35","36","2.777777777777777777777777778"
"2019-01-31T00:00:00.000","Twin Falls","ID","Passenger","0","1","1","18","19","5.263157894736842105263157895"
"2019-01-31T00:00:00.000","Cook","IL","Passenger","1","0","1","234","235","0.4255319148936170212765957447"
"2019-01-31T00:00:00.000","DuPage","IL","Passenger","1","0","1","57","58","1.724137931034482758620689655"
"2019-01-31T00:00:00.000","Monroe","IL","Passenger","1","0","1","3","4","25.00"
"2019-01-31T00:00:00.000","Sangamon","IL","Passenger","1","0","1","9","10","10.0"
"2019-01-31T00:00:00.000","St. Clair","IL","Passenger","0","1","1","165","166","0.6024096385542168674698795181"
"2019-01-31T00:00:00.000","DeKalb","IN","Passenger","1","0","1","1","2","50.0"
"2019-01-31T00:00:00.000","Marion","IN","Passenger","1","0","1","119","120","0.8333333333333333333333333333"
"2019-01-31T00:00:00.000","Hardin","KY","Passenger","0","1","1","104","105","0.9523809523809523809523809524"
"2019-01-31T00:00:00.000","Oldham","KY","Passenger","0","1","1","5","6","16.66666666666666666666666667"
"2019-01-31T00:00:00.000","Caddo","LA","Passenger","0","1","1","22","23","4.347826086956521739130434783"
"2019-01-31T00:00:00.000","Franklin","MA","Passenger","0","1","1","1","2","50.0"
"2019-01-31T00:00:00.000","Middlesex","MA","Passenger","1","1","2","119","121","1.652892561983471074380165289"
"2019-01-31T00:00:00.000","Nantucket","MA","Passenger","1","0","1","3","4","25.00"
"2019-01-31T00:00:00.000","Norfolk","MA","Passenger","1","0","1","28","29","3.448275862068965517241379310"
"2019-01-31T00:00:00.000","Suffolk","MA","Passenger","0","1","1","43","44","2.272727272727272727272727273"
"2019-01-31T00:00:00.000","Anne Arundel","MD","Passenger","0","2","2","455","457","0.4376367614879649890590809628"
"2019-01-31T00:00:00.000","Calvert","MD","Passenger","0","1","1","88","89","1.123595505617977528089887640"
"2019-01-31T00:00:00.000","Charles","MD","Passenger","0","1","1","75","76","1.315789473684210526315789474"
"2019-01-31T00:00:00.000","Frederick","MD","Passenger","0","1","1","85","86","1.162790697674418604651162791"
"2019-01-31T00:00:00.000","Howard","MD","Passenger","0","1","1","84","85","1.176470588235294117647058824"
"2019-01-31T00:00:00.000","Montgomery","MD","Passenger","1","1","2","282","284","0.7042253521126760563380281690"
"2019-01-31T00:00:00.000","St. Mary's","MD","Passenger","1","0","1","208","209","0.4784688995215311004784688995"
"2019-01-31T00:00:00.000","Penobscot","ME","Passenger","0","1","1","14","15","6.666666666666666666666666667"
"2019-01-31T00:00:00.000","Kent","MI","Passenger","0","1","1","22","23","4.347826086956521739130434783"
"2019-01-31T00:00:00.000","Washtenaw","MI","Passenger","1","0","1","31","32","3.12500"
"2019-01-31T00:00:00.000","Dakota","MN","Passenger","0","1","1","30","31","3.225806451612903225806451613"
"2019-01-31T00:00:00.000","Hennepin","MN","Passenger","2","0","2","102","104","1.923076923076923076923076923"
"2019-01-31T00:00:00.000","Kanabec","MN","Passenger","1","0","1","0","1","100"
"2019-01-31T00:00:00.000","Ramsey","MN","Passenger","1","0","1","39","40","2.500"
"2019-01-31T00:00:00.000","Flathead","MT","Passenger","1","0","1","56","57","1.754385964912280701754385965"
"2019-01-31T00:00:00.000","Gallatin","MT","Passenger","0","1","1","55","56","1.785714285714285714285714286"
"2019-01-31T00:00:00.000","Glacier","MT","Passenger","0","1","1","3","4","25.00"
"2019-01-31T00:00:00.000","Cumberland","NC","Passenger","0","2","2","542","544","0.3676470588235294117647058824"
"2019-01-31T00:00:00.000","Guilford","NC","Passenger","1","0","1","23","24","4.166666666666666666666666667"
"2019-01-31T00:00:00.000","Mecklenburg","NC","Passenger","1","0","1","78","79","1.265822784810126582278481013"
"2019-01-31T00:00:00.000","Moore","NC","Passenger","0","1","1","190","191","0.5235602094240837696335078534"
"2019-01-31T00:00:00.000","Douglas","NE","Passenger","0","1","1","68","69","1.449275362318840579710144928"
"2019-01-31T00:00:00.000","Carroll","NH","Passenger","0","1","1","1","2","50.0"
"2019-01-31T00:00:00.000","Bergen","NJ","Passenger","1","0","1","27","28","3.571428571428571428571428571"
"2019-01-31T00:00:00.000","Camden","NJ","Passenger","0","1","1","26","27","3.703703703703703703703703704"
"2019-01-31T00:00:00.000","Santa Fe","NM","Passenger","0","1","1","39","40","2.500"
"2019-01-31T00:00:00.000","Valencia","NM","Passenger","1","0","1","8","9","11.11111111111111111111111111"
"2019-01-31T00:00:00.000","Carson City","NV","Passenger","1","0","1","13","14","7.142857142857142857142857143"
"2019-01-31T00:00:00.000","Clark","NV","Passenger","2","2","4","709","713","0.5610098176718092566619915849"
"2019-01-31T00:00:00.000","Washoe","NV","Passenger","2","0","2","96","98","2.040816326530612244897959184"
"2019-01-31T00:00:00.000","Jefferson","NY","Passenger","0","1","1","235","236","0.4237288135593220338983050847"
"2019-01-31T00:00:00.000","Nassau","NY","Passenger","2","0","2","34","36","5.555555555555555555555555556"
"2019-01-31T00:00:00.000","Saratoga","NY","Passenger","1","0","1","61","62","1.612903225806451612903225806"
"2019-01-31T00:00:00.000","Garfield","OK","Passenger","1","0","1","14","15","6.666666666666666666666666667"
"2019-01-31T00:00:00.000","Jackson","OK","Passenger","1","0","1","47","48","2.083333333333333333333333333"
"2019-01-31T00:00:00.000","Oklahoma","OK","Passenger","0","1","1","112","113","0.8849557522123893805309734513"
"2019-01-31T00:00:00.000","Rogers","OK","Passenger","1","0","1","5","6","16.66666666666666666666666667"
"2019-01-31T00:00:00.000","Tulsa","OK","Passenger","1","1","2","47","49","4.081632653061224489795918367"
"2019-01-31T00:00:00.000","Clackamas","OR","Passenger","1","1","2","206","208","0.9615384615384615384615384615"
"2019-01-31T00:00:00.000","Deschutes","OR","Passenger","2","0","2","158","160","1.2500"
"2019-01-31T00:00:00.000","Douglas","OR","Passenger","1","0","1","48","49","2.040816326530612244897959184"
"2019-01-31T00:00:00.000","Klamath","OR","Passenger","1","0","1","29","30","3.333333333333333333333333333"
"2019-01-31T00:00:00.000","Marion","OR","Passenger","1","0","1","114","115","0.8695652173913043478260869565"
"2019-01-31T00:00:00.000","Multnomah","OR","Passenger","3","4","7","740","747","0.9370816599732262382864792503"
"2019-01-31T00:00:00.000","Washington","OR","Passenger","0","1","1","441","442","0.2262443438914027149321266968"
"2019-01-31T00:00:00.000","Allegheny","PA","Passenger","1","0","1","80","81","1.234567901234567901234567901"
"2019-01-31T00:00:00.000","Bucks","PA","Passenger","1","0","1","17","18","5.555555555555555555555555556"
"2019-01-31T00:00:00.000","Montgomery","PA","Passenger","2","0","2","29","31","6.451612903225806451612903226"
"2019-01-31T00:00:00.000","San Juan","PR","Passenger","0","1","1","5","6","16.66666666666666666666666667"
"2019-01-31T00:00:00.000","Newport","RI","Passenger","1","0","1","97","98","1.020408163265306122448979592"
"2019-01-31T00:00:00.000","Beaufort","SC","Passenger","1","0","1","35","36","2.777777777777777777777777778"
"2019-01-31T00:00:00.000","Richland","SC","Passenger","0","1","1","165","166","0.6024096385542168674698795181"
"2019-01-31T00:00:00.000","Spartanburg","SC","Passenger","0","1","1","27","28","3.571428571428571428571428571"
"2019-01-31T00:00:00.000","Shelby","TN","Passenger","0","1","1","98","99","1.010101010101010101010101010"
"2019-01-31T00:00:00.000","Bexar","TX","Passenger","4","4","8","693","701","1.141226818830242510699001427"
"2019-01-31T00:00:00.000","El Paso","TX","Passenger","2","0","2","501","503","0.3976143141153081510934393638"
"2019-01-31T00:00:00.000","Guadalupe","TX","Passenger","1","0","1","69","70","1.428571428571428571428571429"
"2019-01-31T00:00:00.000","Harris","TX","Passenger","0","1","1","247","248","0.4032258064516129032258064516"
"2019-01-31T00:00:00.000","Montgomery","TX","Passenger","2","0","2","54","56","3.571428571428571428571428571"
"2019-01-31T00:00:00.000","Nueces","TX","Passenger","1","1","2","90","92","2.173913043478260869565217391"
"2019-01-31T00:00:00.000","Tarrant","TX","Passenger","1","0","1","191","192","0.5208333333333333333333333333"
"2019-01-31T00:00:00.000","Travis","TX","Passenger","2","1","3","188","191","1.570680628272251308900523560"
"2019-01-31T00:00:00.000","Albemarle","VA","Passenger","1","0","1","25","26","3.846153846153846153846153846"
"2019-01-31T00:00:00.000","Alexandria","VA","Passenger","3","0","3","160","163","1.840490797546012269938650307"
"2019-01-31T00:00:00.000","Arlington","VA","Passenger","1","2","3","160","163","1.840490797546012269938650307"
"2019-01-31T00:00:00.000","Fairfax","VA","Passenger","3","3","6","802","808","0.7425742574257425742574257426"
"2019-01-31T00:00:00.000","Goochland","VA","Passenger","0","1","1","227","228","0.4385964912280701754385964912"
"2019-01-31T00:00:00.000","Manassas","VA","Passenger","0","1","1","9","10","10.0"
"2019-01-31T00:00:00.000","Norfolk","VA","Passenger","2","2","4","345","349","1.146131805157593123209169054"
"2019-01-31T00:00:00.000","Portsmouth","VA","Passenger","0","1","1","69","70","1.428571428571428571428571429"
"2019-01-31T00:00:00.000","Prince William","VA","Passenger","0","4","4","252","256","1.562500"
"2019-01-31T00:00:00.000","Rockbridge","VA","Passenger","1","0","1","1","2","50.0"
"2019-01-31T00:00:00.000","Virginia Beach","VA","Passenger","2","1","3","689","692","0.4335260115606936416184971098"
"2019-01-31T00:00:00.000","Adams","WA","Truck","0","0","0","5143","5143","0"
"2019-01-31T00:00:00.000","Adams","WA","Passenger","5","6","11","12745","12756","0.08623392913138915020382565067"
"2019-01-31T00:00:00.000","Asotin","WA","Passenger","13","10","23","12732","12755","0.1803214425715405723245785966"
"2019-01-31T00:00:00.000","Asotin","WA","Truck","0","0","0","6649","6649","0"
"2019-01-31T00:00:00.000","Benton","WA","Truck","0","0","0","41624","41624","0"
"2019-01-31T00:00:00.000","Benton","WA","Passenger","244","251","495","133239","133734","0.3701377361030104535869711517"
"2019-01-31T00:00:00.000","Chelan","WA","Truck","0","0","0","22113","22113","0"
"2019-01-31T00:00:00.000","Chelan","WA","Passenger","141","63","204","54215","54419","0.3748690714640107315459674011"
"2019-01-31T00:00:00.000","Clallam","WA","Passenger","161","133","294","50407","50701","0.5798702195222973905840121497"
"2019-01-31T00:00:00.000","Clallam","WA","Truck","0","0","0","21632","21632","0"
"2019-01-31T00:00:00.000","Clark","WA","Truck","0","0","0","79974","79974","0"
"2019-01-31T00:00:00.000","Clark","WA","Passenger","1406","903","2309","312017","314326","0.7345876574002786915495377411"
"2019-01-31T00:00:00.000","Columbia","WA","Passenger","2","2","4","2423","2427","0.1648125257519571487433044911"
"2019-01-31T00:00:00.000","Columbia","WA","Truck","0","0","0","1530","1530","0"
"2019-01-31T00:00:00.000","Cowlitz","WA","Passenger","90","109","199","72543","72742","0.2735696021555634983915757059"
"2019-01-31T00:00:00.000","Cowlitz","WA","Truck","0","0","0","28735","28735","0"
"2019-01-31T00:00:00.000","Douglas","WA","Truck","0","0","0","12174","12174","0"
"2019-01-31T00:00:00.000","Douglas","WA","Passenger","52","35","87","28016","28103","0.3095754901611927552218624346"
"2019-01-31T00:00:00.000","Ferry","WA","Truck","0","0","0","3591","3591","0"
"2019-01-31T00:00:00.000","Ferry","WA","Passenger","3","2","5","4389","4394","0.1137915339098771051433773327"
"2019-01-31T00:00:00.000","Franklin","WA","Passenger","57","69","126","59324","59450","0.2119428090832632464255677040"
"2019-01-31T00:00:00.000","Franklin","WA","Truck","0","0","0","19129","19129","0"
"2019-01-31T00:00:00.000","Garfield","WA","Truck","0","0","0","963","963","0"
"2019-01-31T00:00:00.000","Garfield","WA","Passenger","1","1","2","1332","1334","0.1499250374812593703148425787"
"2019-01-31T00:00:00.000","Grant","WA","Truck","0","0","0","26329","26329","0"
"2019-01-31T00:00:00.000","Grant","WA","Passenger","36","57","93","64379","64472","0.1442486660876039210820201017"
"2019-01-31T00:00:00.000","Grays Harbor","WA","Passenger","78","82","160","47442","47602","0.3361203310785261123482206630"
"2019-01-31T00:00:00.000","Grays Harbor","WA","Truck","0","0","0","20319","20319","0"
"2019-01-31T00:00:00.000","Island","WA","Passenger","301","238","539","63265","63804","0.8447746222807347501724029841"
"2019-01-31T00:00:00.000","Island","WA","Truck","0","0","0","21214","21214","0"
"2019-01-31T00:00:00.000","Jefferson","WA","Passenger","186","120","306","24851","25157","1.216361251341574909567913503"
"2019-01-31T00:00:00.000","Jefferson","WA","Truck","0","0","0","9621","9621","0"
"2019-01-31T00:00:00.000","King","WA","Truck","6","1","7","182458","182465","0.003836352177129860521195845779"
"2019-01-31T00:00:00.000","King","WA","Passenger","17549","6942","24491","1380989","1405480","1.742536357685630531917921280"
"2019-01-31T00:00:00.000","Kitsap","WA","Truck","1","0","1","53765","53766","0.001859911468214113008220808690"
"2019-01-31T00:00:00.000","Kitsap","WA","Passenger","1054","577","1631","179907","181538","0.8984344875453073185779285880"
"2019-01-31T00:00:00.000","Kittitas","WA","Passenger","73","36","109","29468","29577","0.3685296007032491462961084627"
"2019-01-31T00:00:00.000","Kittitas","WA","Truck","0","0","0","14237","14237","0"
"2019-01-31T00:00:00.000","Klickitat","WA","Passenger","33","33","66","15484","15550","0.4244372990353697749196141479"
"2019-01-31T00:00:00.000","Klickitat","WA","Truck","0","0","0","8231","8231","0"
"2019-01-31T00:00:00.000","Lewis","WA","Truck","0","0","0","25666","25666","0"
"2019-01-31T00:00:00.000","Lewis","WA","Passenger","103","88","191","58356","58547","0.3262336242676823748441423130"
"2019-01-31T00:00:00.000","Lincoln","WA","Passenger","4","6","10","7760","7770","0.1287001287001287001287001287"
"2019-01-31T00:00:00.000","Lincoln","WA","Truck","0","0","0","4666","4666","0"
"2019-01-31T00:00:00.000","Mason","WA","Passenger","128","117","245","46649","46894","0.5224548982812300081033820958"
"2019-01-31T00:00:00.000","Mason","WA","Truck","0","0","0","20223","20223","0"
"2019-01-31T00:00:00.000","Okanogan","WA","Passenger","19","21","40","26055","26095","0.1532860701283770837325158076"
"2019-01-31T00:00:00.000","Okanogan","WA","Truck","0","0","0","16480","16480","0"
"2019-01-31T00:00:00.000","Pacific","WA","Truck","0","0","0","7616","7616","0"
"2019-01-31T00:00:00.000","Pacific","WA","Passenger","34","27","61","15875","15936","0.3827811244979919678714859438"
"2019-01-31T00:00:00.000","Pend Oreille","WA","Truck","0","0","0","5740","5740","0"
"2019-01-31T00:00:00.000","Pend Oreille","WA","Passenger","6","5","11","9539","9550","0.1151832460732984293193717277"
"2019-01-31T00:00:00.000","Pierce","WA","Passenger","1793","1513","3306","539703","543009","0.6088296879057253194698430413"
"2019-01-31T00:00:00.000","Pierce","WA","Truck","0","0","0","139175","139175","0"
"2019-01-31T00:00:00.000","San Juan","WA","Passenger","190","70","260","14255","14515","1.791250430589045814674474681"
"2019-01-31T00:00:00.000","San Juan","WA","Truck","0","0","0","5804","5804","0"
"2019-01-31T00:00:00.000","Skagit","WA","Passenger","300","200","500","91352","91852","0.5443539607194181944867830858"
"2019-01-31T00:00:00.000","Skagit","WA","Truck","1","0","1","32331","32332","0.003092911047878263021155511567"
"2019-01-31T00:00:00.000","Skamania","WA","Passenger","20","15","35","8744","8779","0.3986786649960132133500398679"
"2019-01-31T00:00:00.000","Skamania","WA","Truck","0","0","0","4009","4009","0"
"2019-01-31T00:00:00.000","Snohomish","WA","Truck","1","0","1","122032","122033","0.0008194504765104520908278908164"
"2019-01-31T00:00:00.000","Snohomish","WA","Passenger","3213","1584","4797","528224","533021","0.8999645417347534149686410104"
"2019-01-31T00:00:00.000","Spokane","WA","Truck","1","0","1","93975","93976","0.001064101472716438239550523538"
"2019-01-31T00:00:00.000","Spokane","WA","Passenger","505","406","911","307653","308564","0.2952385890771444497737908505"
"2019-01-31T00:00:00.000","Stevens","WA","Truck","0","0","0","18769","18769","0"
"2019-01-31T00:00:00.000","Stevens","WA","Passenger","20","30","50","31814","31864","0.1569168968114486567913632940"
"2019-01-31T00:00:00.000","Thurston","WA","Passenger","853","621","1474","196042","197516","0.7462686567164179104477611940"
"2019-01-31T00:00:00.000","Thurston","WA","Truck","0","0","0","54937","54937","0"
"2019-01-31T00:00:00.000","Wahkiakum","WA","Truck","0","0","0","1712","1712","0"
"2019-01-31T00:00:00.000","Wahkiakum","WA","Passenger","2","2","4","3004","3008","0.1329787234042553191489361702"
"2019-01-31T00:00:00.000","Walla Walla","WA","Truck","0","0","0","13542","13542","0"
"2019-01-31T00:00:00.000","Walla Walla","WA","Passenger","43","55","98","36157","36255","0.2703075437870638532616190870"
"2019-01-31T00:00:00.000","Whatcom","WA","Passenger","828","390","1218","149703","150921","0.8070447452640785576559922078"
"2019-01-31T00:00:00.000","Whatcom","WA","Truck","2","0","2","42749","42751","0.004678253140277420411218451030"
"2019-01-31T00:00:00.000","Whitman","WA","Truck","0","0","0","8517","8517","0"
"2019-01-31T00:00:00.000","Whitman","WA","Passenger","25","42","67","22863","22930","0.2921936327954644570431748801"
"2019-01-31T00:00:00.000","Yakima","WA","Passenger","94","109","203","164938","165141","0.1229252578099926729279827541"
"2019-01-31T00:00:00.000","Yakima","WA","Truck","0","0","0","58929","58929","0"
"2019-01-31T00:00:00.000","Ozaukee","WI","Passenger","0","1","1","3","4","25.00"
"2019-01-31T00:00:00.000",,,"Passenger","3","0","3","248","251","1.195219123505976095617529880"
"2019-02-28T00:00:00.000","Juneau","AK","Passenger","0","1","1","37","38","2.631578947368421052631578947"
"2019-02-28T00:00:00.000","Dale","AL","Passenger","0","1","1","61","62","1.612903225806451612903225806"
"2019-02-28T00:00:00.000","Lee","AL","Passenger","1","0","1","34","35","2.857142857142857142857142857"
"2019-02-28T00:00:00.000","Montgomery","AL","Passenger","0","1","1","42","43","2.325581395348837209302325581"
"2019-02-28T00:00:00.000","Cochise","AZ","Passenger","0","1","1","123","124","0.8064516129032258064516129032"
"2019-02-28T00:00:00.000","Maricopa","AZ","Passenger","7","3","10","1434","1444","0.6925207756232686980609418283"
"2019-02-28T00:00:00.000","Pima","AZ","Passenger","0","1","1","390","391","0.2557544757033248081841432225"
"2019-02-28T00:00:00.000","Pinal","AZ","Passenger","2","0","2","180","182","1.098901098901098901098901099"
"2019-02-28T00:00:00.000","Alameda","CA","Passenger","1","2","3","310","313","0.9584664536741214057507987220"
"2019-02-28T00:00:00.000","Contra Costa","CA","Passenger","1","2","3","418","421","0.7125890736342042755344418052"
"2019-02-28T00:00:00.000","Fresno","CA","Passenger","1","0","1","184","185","0.5405405405405405405405405405"
"2019-02-28T00:00:00.000","Kern","CA","Passenger","0","1","1","237","238","0.4201680672268907563025210084"
"2019-02-28T00:00:00.000","Los Angeles","CA","Passenger","7","5","12","1069","1081","1.110083256244218316373728030"
"2019-02-28T00:00:00.000","Orange","CA","Passenger","4","2","6","529","535","1.121495327102803738317757009"
"2019-02-28T00:00:00.000","Riverside","CA","Passenger","1","2","3","636","639","0.4694835680751173708920187793"
"2019-02-28T00:00:00.000","San Diego","CA","Passenger","8","3","11","2658","2669","0.4121393780442113150992881229"
"2019-02-28T00:00:00.000","San Francisco","CA","Passenger","2","1","3","108","111","2.702702702702702702702702703"
"2019-02-28T00:00:00.000","San Mateo","CA","Passenger","2","1","3","122","125","2.400"
"2019-02-28T00:00:00.000","Santa Barbara","CA","Passenger","2","0","2","94","96","2.083333333333333333333333333"
"2019-02-28T00:00:00.000","Santa Clara","CA","Passenger","8","1","9","359","368","2.445652173913043478260869565"
"2019-02-28T00:00:00.000","Santa Cruz","CA","Passenger","1","0","1","40","41","2.439024390243902439024390244"
"2019-02-28T00:00:00.000","Shasta","CA","Passenger","1","0","1","45","46","2.173913043478260869565217391"
"2019-02-28T00:00:00.000","Tuolumne","CA","Passenger","0","1","1","10","11","9.090909090909090909090909091"
"2019-02-28T00:00:00.000","Ventura","CA","Passenger","0","2","2","311","313","0.6389776357827476038338658147"
"2019-02-28T00:00:00.000","Denver","CO","Passenger","1","0","1","125","126","0.7936507936507936507936507937"
"2019-02-28T00:00:00.000","El Paso","CO","Passenger","3","2","5","753","758","0.6596306068601583113456464380"
"2019-02-28T00:00:00.000","Jefferson","CO","Passenger","0","2","2","62","64","3.12500"
"2019-02-28T00:00:00.000","Larimer","CO","Passenger","1","1","2","55","57","3.508771929824561403508771930"
"2019-02-28T00:00:00.000","New London","CT","Passenger","0","2","2","265","267","0.7490636704119850187265917603"
"2019-02-28T00:00:00.000","District of Columbia","DC","Passenger","1","2","3","203","206","1.456310679611650485436893204"
"2019-02-28T00:00:00.000","Kent","DE","Passenger","0","1","1","74","75","1.333333333333333333333333333"
"2019-02-28T00:00:00.000","New Castle","DE","Passenger","1","0","1","23","24","4.166666666666666666666666667"
"2019-02-28T00:00:00.000","Brevard","FL","Passenger","0","1","1","82","83","1.204819277108433734939759036"
"2019-02-28T00:00:00.000","Broward","FL","Passenger","1","1","2","122","124","1.612903225806451612903225806"
"2019-02-28T00:00:00.000","Clay","FL","Passenger","0","1","1","80","81","1.234567901234567901234567901"
"2019-02-28T00:00:00.000","Duval","FL","Passenger","1","1","2","376","378","0.5291005291005291005291005291"
"2019-02-28T00:00:00.000","Manatee","FL","Passenger","1","0","1","34","35","2.857142857142857142857142857"
"2019-02-28T00:00:00.000","Miami-Dade","FL","Passenger","0","1","1","112","113","0.8849557522123893805309734513"
"2019-02-28T00:00:00.000","Palm Beach","FL","Passenger","0","1","1","81","82","1.219512195121951219512195122"
"2019-02-28T00:00:00.000","Polk","FL","Passenger","1","0","1","66","67","1.492537313432835820895522388"
"2019-02-28T00:00:00.000","Santa Rosa","FL","Passenger","1","0","1","93","94","1.063829787234042553191489362"
"2019-02-28T00:00:00.000","St. Lucie","FL","Passenger","1","0","1","27","28","3.571428571428571428571428571"
"2019-02-28T00:00:00.000","Sumter","FL","Passenger","0","1","1","10","11","9.090909090909090909090909091"
"2019-02-28T00:00:00.000","Volusia","FL","Passenger","0","1","1","34","35","2.857142857142857142857142857"
"2019-02-28T00:00:00.000","Bryan","GA","Passenger","1","0","1","53","54","1.851851851851851851851851852"
"2019-02-28T00:00:00.000","Camden","GA","Passenger","0","1","1","161","162","0.6172839506172839506172839506"
"2019-02-28T00:00:00.000","Columbia","GA","Passenger","1","1","2","149","151","1.324503311258278145695364238"
"2019-02-28T00:00:00.000","DeKalb","GA","Passenger","1","0","1","75","76","1.315789473684210526315789474"
"2019-02-28T00:00:00.000","Fulton","GA","Passenger","1","2","3","105","108","2.777777777777777777777777778"
"2019-02-28T00:00:00.000","Gwinnett","GA","Passenger","0","1","1","78","79","1.265822784810126582278481013"
"2019-02-28T00:00:00.000","Houston","GA","Passenger","1","0","1","56","57","1.754385964912280701754385965"
"2019-02-28T00:00:00.000","Liberty","GA","Passenger","1","0","1","142","143","0.6993006993006993006993006993"
"2019-02-28T00:00:00.000","Lumpkin","GA","Passenger","1","0","1","6","7","14.28571428571428571428571429"
"2019-02-28T00:00:00.000","Honolulu","HI","Passenger","2","2","4","494","498","0.8032128514056224899598393574"
"2019-02-28T00:00:00.000","Maui","HI","Passenger","1","0","1","47","48","2.083333333333333333333333333"
"2019-02-28T00:00:00.000","Ada","ID","Passenger","0","2","2","296","298","0.6711409395973154362416107383"
"2019-02-28T00:00:00.000","Kootenai","ID","Passenger","1","1","2","196","198","1.010101010101010101010101010"
"2019-02-28T00:00:00.000","Twin Falls","ID","Passenger","0","1","1","18","19","5.263157894736842105263157895"
"2019-02-28T00:00:00.000","Cook","IL","Passenger","1","0","1","229","230","0.4347826086956521739130434783"
"2019-02-28T00:00:00.000","DuPage","IL","Passenger","1","0","1","57","58","1.724137931034482758620689655"
"2019-02-28T00:00:00.000","Monroe","IL","Passenger","1","0","1","3","4","25.00"
"2019-02-28T00:00:00.000","Sangamon","IL","Passenger","2","0","2","8","10","20.0"
"2019-02-28T00:00:00.000","St. Clair","IL","Passenger","0","1","1","164","165","0.6060606060606060606060606061"
"2019-02-28T00:00:00.000","DeKalb","IN","Passenger","1","0","1","1","2","50.0"
"2019-02-28T00:00:00.000","Marion","IN","Passenger","1","0","1","114","115","0.8695652173913043478260869565"
"2019-02-28T00:00:00.000","Hardin","KY","Passenger","0","1","1","104","105","0.9523809523809523809523809524"
"2019-02-28T00:00:00.000","Oldham","KY","Passenger","0","1","1","5","6","16.66666666666666666666666667"
"2019-02-28T00:00:00.000","Caddo","LA","Passenger","0","1","1","23","24","4.166666666666666666666666667"
"2019-02-28T00:00:00.000","Franklin","MA","Passenger","0","1","1","1","2","50.0"
"2019-02-28T00:00:00.000","Middlesex","MA","Passenger","1","1","2","117","119","1.680672268907563025210084034"
"2019-02-28T00:00:00.000","Nantucket","MA","Passenger","1","0","1","3","4","25.00"
"2019-02-28T00:00:00.000","Norfolk","MA","Passenger","1","0","1","27","28","3.571428571428571428571428571"
"2019-02-28T00:00:00.000","Suffolk","MA","Passenger","0","1","1","44","45","2.222222222222222222222222222"
"2019-02-28T00:00:00.000","Anne Arundel","MD","Passenger","0","2","2","451","453","0.4415011037527593818984547461"
"2019-02-28T00:00:00.000","Calvert","MD","Passenger","0","1","1","87","88","1.136363636363636363636363636"
"2019-02-28T00:00:00.000","Charles","MD","Passenger","0","1","1","76","77","1.298701298701298701298701299"
"2019-02-28T00:00:00.000","Frederick","MD","Passenger","1","1","2","85","87","2.298850574712643678160919540"
"2019-02-28T00:00:00.000","Howard","MD","Passenger","0","1","1","83","84","1.190476190476190476190476190"
"2019-02-28T00:00:00.000","Montgomery","MD","Passenger","1","1","2","283","285","0.7017543859649122807017543860"
"2019-02-28T00:00:00.000","St. Mary's","MD","Passenger","1","0","1","206","207","0.4830917874396135265700483092"
"2019-02-28T00:00:00.000","Penobscot","ME","Passenger","0","1","1","14","15","6.666666666666666666666666667"
"2019-02-28T00:00:00.000","Kent","MI","Passenger","0","1","1","21","22","4.545454545454545454545454545"
"2019-02-28T00:00:00.000","Washtenaw","MI","Passenger","1","0","1","30","31","3.225806451612903225806451613"
"2019-02-28T00:00:00.000","Dakota","MN","Passenger","0","1","1","30","31","3.225806451612903225806451613"
"2019-02-28T00:00:00.000","Hennepin","MN","Passenger","2","0","2","102","104","1.923076923076923076923076923"
"2019-02-28T00:00:00.000","Kanabec","MN","Passenger","1","0","1","0","1","100"
"2019-02-28T00:00:00.000","Ramsey","MN","Passenger","1","0","1","40","41","2.439024390243902439024390244"
"2019-02-28T00:00:00.000","Cascade","MT","Passenger","0","1","1","55","56","1.785714285714285714285714286"
"2019-02-28T00:00:00.000","Flathead","MT","Passenger","1","0","1","55","56","1.785714285714285714285714286"
"2019-02-28T00:00:00.000","Gallatin","MT","Passenger","0","1","1","55","56","1.785714285714285714285714286"
"2019-02-28T00:00:00.000","Glacier","MT","Passenger","0","1","1","4","5","20.0"
"2019-02-28T00:00:00.000","Cumberland","NC","Passenger","0","2","2","532","534","0.3745318352059925093632958801"
"2019-02-28T00:00:00.000","Guilford","NC","Passenger","1","0","1","25","26","3.846153846153846153846153846"
"2019-02-28T00:00:00.000","Mecklenburg","NC","Passenger","1","0","1","78","79","1.265822784810126582278481013"
"2019-02-28T00:00:00.000","Moore","NC","Passenger","0","1","1","186","187","0.5347593582887700534759358289"
"2019-02-28T00:00:00.000","Douglas","NE","Passenger","0","1","1","67","68","1.470588235294117647058823529"
"2019-02-28T00:00:00.000","Carroll","NH","Passenger","0","1","1","1","2","50.0"
"2019-02-28T00:00:00.000","Bergen","NJ","Passenger","1","0","1","25","26","3.846153846153846153846153846"
"2019-02-28T00:00:00.000","Camden","NJ","Passenger","0","1","1","26","27","3.703703703703703703703703704"
"2019-02-28T00:00:00.000","Chaves","NM","Passenger","1","0","1","6","7","14.28571428571428571428571429"
"2019-02-28T00:00:00.000","Santa Fe","NM","Passenger","0","1","1","39","40","2.500"
"2019-02-28T00:00:00.000","Valencia","NM","Passenger","1","0","1","8","9","11.11111111111111111111111111"
"2019-02-28T00:00:00.000","Carson City","NV","Passenger","1","0","1","13","14","7.142857142857142857142857143"
"2019-02-28T00:00:00.000","Clark","NV","Passenger","3","2","5","700","705","0.7092198581560283687943262411"
"2019-02-28T00:00:00.000","Washoe","NV","Passenger","2","0","2","94","96","2.083333333333333333333333333"
"2019-02-28T00:00:00.000","Jefferson","NY","Passenger","0","2","2","228","230","0.8695652173913043478260869565"
"2019-02-28T00:00:00.000","Nassau","NY","Passenger","2","0","2","35","37","5.405405405405405405405405405"
"2019-02-28T00:00:00.000","Saratoga","NY","Passenger","1","0","1","62","63","1.587301587301587301587301587"
"2019-02-28T00:00:00.000","Jackson","OK","Passenger","1","0","1","46","47","2.127659574468085106382978723"
"2019-02-28T00:00:00.000","Oklahoma","OK","Passenger","0","1","1","112","113","0.8849557522123893805309734513"
"2019-02-28T00:00:00.000","Rogers","OK","Passenger","1","0","1","4","5","20.0"
"2019-02-28T00:00:00.000","Tulsa","OK","Passenger","1","1","2","47","49","4.081632653061224489795918367"
"2019-02-28T00:00:00.000","Clackamas","OR","Passenger","1","1","2","204","206","0.9708737864077669902912621359"
"2019-02-28T00:00:00.000","Deschutes","OR","Passenger","2","0","2","157","159","1.257861635220125786163522013"
"2019-02-28T00:00:00.000","Douglas","OR","Passenger","1","0","1","49","50","2.00"
"2019-02-28T00:00:00.000","Klamath","OR","Passenger","1","0","1","29","30","3.333333333333333333333333333"
"2019-02-28T00:00:00.000","Marion","OR","Passenger","1","0","1","112","113","0.8849557522123893805309734513"
"2019-02-28T00:00:00.000","Multnomah","OR","Passenger","4","4","8","731","739","1.082543978349120433017591340"
"2019-02-28T00:00:00.000","Washington","OR","Passenger","0","1","1","436","437","0.2288329519450800915331807780"
"2019-02-28T00:00:00.000","Allegheny","PA","Passenger","1","0","1","79","80","1.2500"
"2019-02-28T00:00:00.000","Bucks","PA","Passenger","1","0","1","18","19","5.263157894736842105263157895"
"2019-02-28T00:00:00.000","Montgomery","PA","Passenger","2","0","2","30","32","6.2500"
"2019-02-28T00:00:00.000","San Juan","PR","Passenger","0","1","1","3","4","25.00"
"2019-02-28T00:00:00.000","Newport","RI","Passenger","1","0","1","97","98","1.020408163265306122448979592"
"2019-02-28T00:00:00.000","Beaufort","SC","Passenger","1","0","1","35","36","2.777777777777777777777777778"
"2019-02-28T00:00:00.000","Richland","SC","Passenger","0","1","1","165","166","0.6024096385542168674698795181"
"2019-02-28T00:00:00.000","Spartanburg","SC","Passenger","0","1","1","27","28","3.571428571428571428571428571"
"2019-02-28T00:00:00.000","Shelby","TN","Passenger","0","1","1","98","99","1.010101010101010101010101010"
"2019-02-28T00:00:00.000","Bexar","TX","Passenger","4","4","8","678","686","1.166180758017492711370262391"
"2019-02-28T00:00:00.000","El Paso","TX","Passenger","2","0","2","498","500","0.400"
"2019-02-28T00:00:00.000","Guadalupe","TX","Passenger","1","0","1","69","70","1.428571428571428571428571429"
"2019-02-28T00:00:00.000","Harris","TX","Passenger","0","1","1","245","246","0.4065040650406504065040650407"
"2019-02-28T00:00:00.000","Hidalgo","TX","Passenger","0","1","1","85","86","1.162790697674418604651162791"
"2019-02-28T00:00:00.000","Montgomery","TX","Passenger","2","0","2","55","57","3.508771929824561403508771930"
"2019-02-28T00:00:00.000","Nueces","TX","Passenger","1","1","2","90","92","2.173913043478260869565217391"
"2019-02-28T00:00:00.000","Tarrant","TX","Passenger","1","0","1","194","195","0.5128205128205128205128205128"
"2019-02-28T00:00:00.000","Travis","TX","Passenger","2","1","3","188","191","1.570680628272251308900523560"
"2019-02-28T00:00:00.000","Albemarle","VA","Passenger","1","0","1","25","26","3.846153846153846153846153846"
"2019-02-28T00:00:00.000","Alexandria","VA","Passenger","3","0","3","157","160","1.87500"
"2019-02-28T00:00:00.000","Arlington","VA","Passenger","1","2","3","160","163","1.840490797546012269938650307"
"2019-02-28T00:00:00.000","Fairfax","VA","Passenger","3","3","6","799","805","0.7453416149068322981366459627"
"2019-02-28T00:00:00.000","Goochland","VA","Passenger","1","1","2","226","228","0.8771929824561403508771929825"
"2019-02-28T00:00:00.000","Manassas","VA","Passenger","0","1","1","9","10","10.0"
"2019-02-28T00:00:00.000","Norfolk","VA","Passenger","2","2","4","348","352","1.136363636363636363636363636"
"2019-02-28T00:00:00.000","Portsmouth","VA","Passenger","0","1","1","69","70","1.428571428571428571428571429"
"2019-02-28T00:00:00.000","Prince William","VA","Passenger","0","4","4","251","255","1.568627450980392156862745098"
"2019-02-28T00:00:00.000","Rockbridge","VA","Passenger","1","0","1","2","3","33.33333333333333333333333333"
"2019-02-28T00:00:00.000","Virginia Beach","VA","Passenger","2","1","3","689","692","0.4335260115606936416184971098"
"2019-02-28T00:00:00.000","Adams","WA","Passenger","4","6","10","12673","12683","0.07884569896712134353071039975"
"2019-02-28T00:00:00.000","Adams","WA","Truck","0","0","0","5109","5109","0"
"2019-02-28T00:00:00.000","Asotin","WA","Truck","0","0","0","6648","6648","0"
"2019-02-28T00:00:00.000","Asotin","WA","Passenger","13","10","23","12685","12708","0.1809883537928863707900535096"
"2019-02-28T00:00:00.000","Benton","WA","Passenger","244","254","498","133008","133506","0.3730169430587389330816592513"
"2019-02-28T00:00:00.000","Benton","WA","Truck","0","0","0","41553","41553","0"
"2019-02-28T00:00:00.000","Chelan","WA","Truck","0","0","0","22103","22103","0"
"2019-02-28T00:00:00.000","Chelan","WA","Passenger","146","66","212","54169","54381","0.3898420404185285301851749692"
"2019-02-28T00:00:00.000","Clallam","WA","Truck","0","0","0","21577","21577","0"
"2019-02-28T00:00:00.000","Clallam","WA","Passenger","163","132","295","50349","50644","0.5824974330621593870942263644"
"2019-02-28T00:00:00.000","Clark","WA","Passenger","1426","902","2328","311769","314097","0.7411723130115855929856063573"
"2019-02-28T00:00:00.000","Clark","WA","Truck","0","0","0","79986","79986","0"
"2019-02-28T00:00:00.000","Columbia","WA","Truck","0","0","0","1526","1526","0"
"2019-02-28T00:00:00.000","Columbia","WA","Passenger","2","2","4","2429","2433","0.1644060830250719276613234690"
"2019-02-28T00:00:00.000","Cowlitz","WA","Passenger","93","113","206","72427","72633","0.2836176393650269161400465353"
"2019-02-28T00:00:00.000","Cowlitz","WA","Truck","0","0","0","28734","28734","0"
"2019-02-28T00:00:00.000","Douglas","WA","Passenger","53","35","88","27945","28033","0.3139157421610245068312346163"
"2019-02-28T00:00:00.000","Douglas","WA","Truck","0","0","0","12168","12168","0"
"2019-02-28T00:00:00.000","Ferry","WA","Truck","0","0","0","3593","3593","0"
"2019-02-28T00:00:00.000","Ferry","WA","Passenger","3","2","5","4378","4383","0.1140771161305042208532968287"
"2019-02-28T00:00:00.000","Franklin","WA","Truck","0","0","0","19117","19117","0"
"2019-02-28T00:00:00.000","Franklin","WA","Passenger","58","71","129","59302","59431","0.2170584375157745957496929212"
"2019-02-28T00:00:00.000","Garfield","WA","Passenger","1","1","2","1325","1327","0.1507159005275056518462697815"
"2019-02-28T00:00:00.000","Garfield","WA","Truck","0","0","0","961","961","0"
"2019-02-28T00:00:00.000","Grant","WA","Passenger","36","59","95","64294","64389","0.1475407290065073226793396388"
"2019-02-28T00:00:00.000","Grant","WA","Truck","0","0","0","26321","26321","0"
"2019-02-28T00:00:00.000","Grays Harbor","WA","Truck","0","0","0","20320","20320","0"
"2019-02-28T00:00:00.000","Grays Harbor","WA","Passenger","77","84","161","47448","47609","0.3381713541557268583671154614"
"2019-02-28T00:00:00.000","Island","WA","Passenger","307","241","548","63192","63740","0.8597427047379981173517414496"
"2019-02-28T00:00:00.000","Island","WA","Truck","0","0","0","21174","21174","0"
"2019-02-28T00:00:00.000","Jefferson","WA","Truck","0","0","0","9625","9625","0"
"2019-02-28T00:00:00.000","Jefferson","WA","Passenger","189","121","310","24865","25175","1.231380337636544190665342602"
"2019-02-28T00:00:00.000","King","WA","Passenger","17911","7026","24937","1379787","1404724","1.775224172150543451952127251"
"2019-02-28T00:00:00.000","King","WA","Truck","6","1","7","182084","182091","0.003844231730288701802944681505"
"2019-02-28T00:00:00.000","Kitsap","WA","Passenger","1062","592","1654","179755","181409","0.9117518976456515387880424896"
"2019-02-28T00:00:00.000","Kitsap","WA","Truck","1","0","1","53736","53737","0.001860915198094422837151311015"
"2019-02-28T00:00:00.000","Kittitas","WA","Truck","0","0","0","14259","14259","0"
"2019-02-28T00:00:00.000","Kittitas","WA","Passenger","77","37","114","29451","29565","0.3855910705225773718924403856"
"2019-02-28T00:00:00.000","Klickitat","WA","Passenger","34","33","67","15449","15516","0.4318123227635988656870327404"
"2019-02-28T00:00:00.000","Klickitat","WA","Truck","0","0","0","8223","8223","0"
"2019-02-28T00:00:00.000","Lewis","WA","Truck","0","0","0","25704","25704","0"
"2019-02-28T00:00:00.000","Lewis","WA","Passenger","104","89","193","58300","58493","0.3299540115911305626314259826"
"2019-02-28T00:00:00.000","Lincoln","WA","Passenger","5","6","11","7740","7751","0.1419171719778093149271061798"
"2019-02-28T00:00:00.000","Lincoln","WA","Truck","0","0","0","4666","4666","0"
"2019-02-28T00:00:00.000","Mason","WA","Passenger","130","121","251","46667","46918","0.5349759154269150432669764270"
"2019-02-28T00:00:00.000","Mason","WA","Truck","0","0","0","20228","20228","0"
"2019-02-28T00:00:00.000","Okanogan","WA","Truck","0","0","0","16471","16471","0"
"2019-02-28T00:00:00.000","Okanogan","WA","Passenger","20","21","41","25966","26007","0.1576498634982889222132502788"
"2019-02-28T00:00:00.000","Pacific","WA","Truck","0","0","0","7637","7637","0"
"2019-02-28T00:00:00.000","Pacific","WA","Passenger","34","28","62","15856","15918","0.3894961678602839552707626586"
"2019-02-28T00:00:00.000","Pend Oreille","WA","Truck","0","0","0","5735","5735","0"
"2019-02-28T00:00:00.000","Pend Oreille","WA","Passenger","6","5","11","9484","9495","0.1158504476040021063717746182"
"2019-02-28T00:00:00.000","Pierce","WA","Passenger","1824","1522","3346","538850","542196","0.6171200082626946712996776074"
"2019-02-28T00:00:00.000","Pierce","WA","Truck","0","0","0","138981","138981","0"
"2019-02-28T00:00:00.000","San Juan","WA","Truck","0","0","0","5801","5801","0"
"2019-02-28T00:00:00.000","San Juan","WA","Passenger","193","71","264","14275","14539","1.815805763807689662287640140"
"2019-02-28T00:00:00.000","Skagit","WA","Passenger","308","200","508","91198","91706","0.5539441257932959675484701110"
"2019-02-28T00:00:00.000","Skagit","WA","Truck","1","0","1","32303","32304","0.003095591877166914314016840020"
"2019-02-28T00:00:00.000","Skamania","WA","Truck","0","0","0","3991","3991","0"
"2019-02-28T00:00:00.000","Skamania","WA","Passenger","22","15","37","8718","8755","0.4226156482010279840091376356"
"2019-02-28T00:00:00.000","Snohomish","WA","Truck","1","0","1","121905","121906","0.0008203041687857857693632799042"
"2019-02-28T00:00:00.000","Snohomish","WA","Passenger","3288","1593","4881","527594","532475","0.9166627541199117329452086952"
"2019-02-28T00:00:00.000","Spokane","WA","Truck","1","0","1","93918","93919","0.001064747282232562101385236214"
"2019-02-28T00:00:00.000","Spokane","WA","Passenger","515","413","928","307275","308203","0.3011002488619513762033464957"
"2019-02-28T00:00:00.000","Stevens","WA","Passenger","20","30","50","31734","31784","0.1573118550213944122829096401"
"2019-02-28T00:00:00.000","Stevens","WA","Truck","0","0","0","18758","18758","0"
"2019-02-28T00:00:00.000","Thurston","WA","Passenger","863","625","1488","195889","197377","0.7538872310350243442751688393"
"2019-02-28T00:00:00.000","Thurston","WA","Truck","0","0","0","54924","54924","0"
"2019-02-28T00:00:00.000","Wahkiakum","WA","Truck","0","0","0","1721","1721","0"
"2019-02-28T00:00:00.000","Wahkiakum","WA","Passenger","2","2","4","3019","3023","0.1323188885213364207740654978"
"2019-02-28T00:00:00.000","Walla Walla","WA","Truck","0","0","0","13550","13550","0"
"2019-02-28T00:00:00.000","Walla Walla","WA","Passenger","44","55","99","36084","36183","0.2736091534698615371859713125"
"2019-02-28T00:00:00.000","Whatcom","WA","Truck","2","0","2","42719","42721","0.004681538353502961073008590623"
"2019-02-28T00:00:00.000","Whatcom","WA","Passenger","834","395","1229","149639","150868","0.8146194023914945515284884800"
"2019-02-28T00:00:00.000","Whitman","WA","Passenger","26","43","69","22772","22841","0.3020883498971148373538811786"
"2019-02-28T00:00:00.000","Whitman","WA","Truck","0","0","0","8496","8496","0"
"2019-02-28T00:00:00.000","Yakima","WA","Passenger","96","110","206","164474","164680","0.1250910857420451785280544085"
"2019-02-28T00:00:00.000","Yakima","WA","Truck","0","0","0","58798","58798","0"
"2019-02-28T00:00:00.000","Ozaukee","WI","Passenger","0","1","1","3","4","25.00"
"2019-02-28T00:00:00.000",,,"Passenger","2","0","2","247","249","0.8032128514056224899598393574"
"2019-03-31T00:00:00.000","Juneau","AK","Passenger","0","1","1","32","33","3.030303030303030303030303030"
"2019-03-31T00:00:00.000","Dale","AL","Passenger","0","1","1","59","60","1.666666666666666666666666667"
"2019-03-31T00:00:00.000","Lee","AL","Passenger","1","0","1","35","36","2.777777777777777777777777778"
"2019-03-31T00:00:00.000","Montgomery","AL","Passenger","0","1","1","42","43","2.325581395348837209302325581"
"2019-03-31T00:00:00.000","Cochise","AZ","Passenger","0","1","1","120","121","0.8264462809917355371900826446"
"2019-03-31T00:00:00.000","Maricopa","AZ","Passenger","7","3","10","1426","1436","0.6963788300835654596100278552"
"2019-03-31T00:00:00.000","Pima","AZ","Passenger","0","1","1","390","391","0.2557544757033248081841432225"
"2019-03-31T00:00:00.000","Pinal","AZ","Passenger","2","0","2","174","176","1.136363636363636363636363636"
"2019-03-31T00:00:00.000","Alameda","CA","Passenger","3","2","5","311","316","1.582278481012658227848101266"
"2019-03-31T00:00:00.000","Contra Costa","CA","Passenger","1","2","3","420","423","0.7092198581560283687943262411"
"2019-03-31T00:00:00.000","Fresno","CA","Passenger","1","0","1","186","187","0.5347593582887700534759358289"
"2019-03-31T00:00:00.000","Kern","CA","Passenger","0","1","1","230","231","0.4329004329004329004329004329"
"2019-03-31T00:00:00.000","Los Angeles","CA","Passenger","8","5","13","1069","1082","1.201478743068391866913123845"
"2019-03-31T00:00:00.000","Orange","CA","Passenger","4","1","5","529","534","0.9363295880149812734082397004"
"2019-03-31T00:00:00.000","Riverside","CA","Passenger","1","2","3","639","642","0.4672897196261682242990654206"
"2019-03-31T00:00:00.000","San Diego","CA","Passenger","9","3","12","2678","2690","0.4460966542750929368029739777"
"2019-03-31T00:00:00.000","San Francisco","CA","Passenger","2","1","3","105","108","2.777777777777777777777777778"
"2019-03-31T00:00:00.000","San Mateo","CA","Passenger","2","1","3","123","126","2.380952380952380952380952381"
"2019-03-31T00:00:00.000","Santa Barbara","CA","Passenger","2","0","2","93","95","2.105263157894736842105263158"
"2019-03-31T00:00:00.000","Santa Clara","CA","Passenger","7","1","8","352","360","2.222222222222222222222222222"
"2019-03-31T00:00:00.000","Santa Cruz","CA","Passenger","1","0","1","40","41","2.439024390243902439024390244"
"2019-03-31T00:00:00.000","Shasta","CA","Passenger","1","0","1","41","42","2.380952380952380952380952381"
"2019-03-31T00:00:00.000","Tuolumne","CA","Passenger","0","1","1","10","11","9.090909090909090909090909091"
"2019-03-31T00:00:00.000","Ventura","CA","Passenger","0","2","2","308","310","0.6451612903225806451612903226"
"2019-03-31T00:00:00.000","Denver","CO","Passenger","1","0","1","128","129","0.7751937984496124031007751938"
"2019-03-31T00:00:00.000","El Paso","CO","Passenger","3","2","5","746","751","0.6657789613848202396804260985"
"2019-03-31T00:00:00.000","Jefferson","CO","Passenger","0","2","2","60","62","3.225806451612903225806451613"
"2019-03-31T00:00:00.000","Larimer","CO","Passenger","1","1","2","55","57","3.508771929824561403508771930"
"2019-03-31T00:00:00.000","New London","CT","Passenger","0","2","2","269","271","0.7380073800738007380073800738"
"2019-03-31T00:00:00.000","District of Columbia","DC","Passenger","1","2","3","200","203","1.477832512315270935960591133"
"2019-03-31T00:00:00.000","Kent","DE","Passenger","0","1","1","75","76","1.315789473684210526315789474"
"2019-03-31T00:00:00.000","New Castle","DE","Passenger","1","0","1","24","25","4.00"
"2019-03-31T00:00:00.000","Brevard","FL","Passenger","0","1","1","80","81","1.234567901234567901234567901"
"2019-03-31T00:00:00.000","Broward","FL","Passenger","1","1","2","122","124","1.612903225806451612903225806"
"2019-03-31T00:00:00.000","Clay","FL","Passenger","0","1","1","80","81","1.234567901234567901234567901"
"2019-03-31T00:00:00.000","Duval","FL","Passenger","1","1","2","376","378","0.5291005291005291005291005291"
"2019-03-31T00:00:00.000","Manatee","FL","Passenger","1","0","1","31","32","3.12500"
"2019-03-31T00:00:00.000","Palm Beach","FL","Passenger","0","1","1","82","83","1.204819277108433734939759036"
"2019-03-31T00:00:00.000","Polk","FL","Passenger","1","0","1","66","67","1.492537313432835820895522388"
"2019-03-31T00:00:00.000","Santa Rosa","FL","Passenger","1","0","1","91","92","1.086956521739130434782608696"
"2019-03-31T00:00:00.000","St. Lucie","FL","Passenger","1","0","1","27","28","3.571428571428571428571428571"
"2019-03-31T00:00:00.000","Sumter","FL","Passenger","0","1","1","10","11","9.090909090909090909090909091"
"2019-03-31T00:00:00.000","Volusia","FL","Passenger","0","1","1","33","34","2.941176470588235294117647059"
"2019-03-31T00:00:00.000","Bryan","GA","Passenger","1","0","1","52","53","1.886792452830188679245283019"
"2019-03-31T00:00:00.000","Camden","GA","Passenger","0","1","1","163","164","0.6097560975609756097560975610"
"2019-03-31T00:00:00.000","Columbia","GA","Passenger","1","1","2","147","149","1.342281879194630872483221477"
"2019-03-31T00:00:00.000","DeKalb","GA","Passenger","1","0","1","77","78","1.282051282051282051282051282"
"2019-03-31T00:00:00.000","Fulton","GA","Passenger","1","2","3","108","111","2.702702702702702702702702703"
"2019-03-31T00:00:00.000","Gwinnett","GA","Passenger","0","1","1","77","78","1.282051282051282051282051282"
"2019-03-31T00:00:00.000","Houston","GA","Passenger","1","0","1","57","58","1.724137931034482758620689655"
"2019-03-31T00:00:00.000","Liberty","GA","Passenger","1","0","1","139","140","0.7142857142857142857142857143"
"2019-03-31T00:00:00.000","Lumpkin","GA","Passenger","1","0","1","6","7","14.28571428571428571428571429"
"2019-03-31T00:00:00.000","Honolulu","HI","Passenger","2","2","4","491","495","0.8080808080808080808080808081"
"2019-03-31T00:00:00.000","Maui","HI","Passenger","1","0","1","46","47","2.127659574468085106382978723"
"2019-03-31T00:00:00.000","Ada","ID","Passenger","0","2","2","297","299","0.6688963210702341137123745819"
"2019-03-31T00:00:00.000","Kootenai","ID","Passenger","1","1","2","198","200","1.00"
"2019-03-31T00:00:00.000","Twin Falls","ID","Passenger","0","1","1","19","20","5.00"
"2019-03-31T00:00:00.000","Cook","IL","Passenger","1","0","1","233","234","0.4273504273504273504273504274"
"2019-03-31T00:00:00.000","DuPage","IL","Passenger","1","0","1","57","58","1.724137931034482758620689655"
"2019-03-31T00:00:00.000","Monroe","IL","Passenger","1","0","1","3","4","25.00"
"2019-03-31T00:00:00.000","Sangamon","IL","Passenger","2","0","2","8","10","20.0"
"2019-03-31T00:00:00.000","St. Clair","IL","Passenger","0","1","1","161","162","0.6172839506172839506172839506"
"2019-03-31T00:00:00.000","DeKalb","IN","Passenger","1","0","1","1","2","50.0"
"2019-03-31T00:00:00.000","Vigo","IN","Passenger","1","0","1","5","6","16.66666666666666666666666667"
"2019-03-31T00:00:00.000","Hardin","KY","Passenger","0","1","1","101","102","0.9803921568627450980392156863"
"2019-03-31T00:00:00.000","Oldham","KY","Passenger","0","1","1","5","6","16.66666666666666666666666667"
"2019-03-31T00:00:00.000","Caddo","LA","Passenger","0","1","1","24","25","4.00"
"2019-03-31T00:00:00.000","Berkshire","MA","Passenger","0","1","1","5","6","16.66666666666666666666666667"
"2019-03-31T00:00:00.000","Franklin","MA","Passenger","0","1","1","1","2","50.0"
"2019-03-31T00:00:00.000","Middlesex","MA","Passenger","1","1","2","115","117","1.709401709401709401709401709"
"2019-03-31T00:00:00.000","Nantucket","MA","Passenger","1","0","1","3","4","25.00"
"2019-03-31T00:00:00.000","Norfolk","MA","Passenger","1","0","1","28","29","3.448275862068965517241379310"
"2019-03-31T00:00:00.000","Suffolk","MA","Passenger","0","1","1","43","44","2.272727272727272727272727273"
"2019-03-31T00:00:00.000","Anne Arundel","MD","Passenger","0","2","2","453","455","0.4395604395604395604395604396"
"2019-03-31T00:00:00.000","Calvert","MD","Passenger","0","1","1","87","88","1.136363636363636363636363636"
"2019-03-31T00:00:00.000","Charles","MD","Passenger","0","1","1","77","78","1.282051282051282051282051282"
"2019-03-31T00:00:00.000","Frederick","MD","Passenger","1","1","2","86","88","2.272727272727272727272727273"
"2019-03-31T00:00:00.000","Howard","MD","Passenger","0","1","1","78","79","1.265822784810126582278481013"
"2019-03-31T00:00:00.000","Montgomery","MD","Passenger","1","2","3","280","283","1.060070671378091872791519435"
"2019-03-31T00:00:00.000","St. Mary's","MD","Passenger","1","0","1","207","208","0.4807692307692307692307692308"
"2019-03-31T00:00:00.000","Penobscot","ME","Passenger","0","1","1","15","16","6.2500"
"2019-03-31T00:00:00.000","Kent","MI","Passenger","0","1","1","20","21","4.761904761904761904761904762"
"2019-03-31T00:00:00.000","Washtenaw","MI","Passenger","1","0","1","29","30","3.333333333333333333333333333"
"2019-03-31T00:00:00.000","Wayne","MI","Passenger","0","1","1","65","66","1.515151515151515151515151515"
"2019-03-31T00:00:00.000","Dakota","MN","Passenger","0","1","1","31","32","3.12500"
"2019-03-31T00:00:00.000","Hennepin","MN","Passenger","2","0","2","100","102","1.960784313725490196078431373"
"2019-03-31T00:00:00.000","Kanabec","MN","Passenger","1","0","1","0","1","100"
"2019-03-31T00:00:00.000","Ramsey","MN","Passenger","1","0","1","42","43","2.325581395348837209302325581"
"2019-03-31T00:00:00.000","Cascade","MT","Passenger","0","1","1","55","56","1.785714285714285714285714286"
"2019-03-31T00:00:00.000","Flathead","MT","Passenger","1","0","1","56","57","1.754385964912280701754385965"
"2019-03-31T00:00:00.000","Gallatin","MT","Passenger","0","1","1","55","56","1.785714285714285714285714286"
"2019-03-31T00:00:00.000","Glacier","MT","Passenger","0","1","1","5","6","16.66666666666666666666666667"
"2019-03-31T00:00:00.000","Cumberland","NC","Passenger","0","2","2","528","530","0.3773584905660377358490566038"
"2019-03-31T00:00:00.000","Guilford","NC","Passenger","1","0","1","25","26","3.846153846153846153846153846"
"2019-03-31T00:00:00.000","Mecklenburg","NC","Passenger","1","0","1","79","80","1.2500"
"2019-03-31T00:00:00.000","Moore","NC","Passenger","0","1","1","182","183","0.5464480874316939890710382514"
"2019-03-31T00:00:00.000","Douglas","NE","Passenger","0","1","1","65","66","1.515151515151515151515151515"
"2019-03-31T00:00:00.000","Carroll","NH","Passenger","0","1","1","1","2","50.0"
"2019-03-31T00:00:00.000","Bergen","NJ","Passenger","1","0","1","25","26","3.846153846153846153846153846"
"2019-03-31T00:00:00.000","Camden","NJ","Passenger","0","1","1","25","26","3.846153846153846153846153846"
"2019-03-31T00:00:00.000","Chaves","NM","Passenger","1","0","1","6","7","14.28571428571428571428571429"
"2019-03-31T00:00:00.000","Santa Fe","NM","Passenger","0","1","1","37","38","2.631578947368421052631578947"
"2019-03-31T00:00:00.000","Valencia","NM","Passenger","1","0","1","8","9","11.11111111111111111111111111"
"2019-03-31T00:00:00.000","Carson City","NV","Passenger","1","0","1","13","14","7.142857142857142857142857143"
"2019-03-31T00:00:00.000","Clark","NV","Passenger","3","2","5","697","702","0.7122507122507122507122507123"
"2019-03-31T00:00:00.000","Washoe","NV","Passenger","2","0","2","95","97","2.061855670103092783505154639"
"2019-03-31T00:00:00.000","Jefferson","NY","Passenger","0","2","2","229","231","0.8658008658008658008658008658"
"2019-03-31T00:00:00.000","Nassau","NY","Passenger","2","0","2","37","39","5.128205128205128205128205128"
"2019-03-31T00:00:00.000","Saratoga","NY","Passenger","1","0","1","58","59","1.694915254237288135593220339"
"2019-03-31T00:00:00.000","Jackson","OK","Passenger","1","0","1","45","46","2.173913043478260869565217391"
"2019-03-31T00:00:00.000","Oklahoma","OK","Passenger","0","1","1","111","112","0.8928571428571428571428571429"
"2019-03-31T00:00:00.000","Rogers","OK","Passenger","1","0","1","4","5","20.0"
"2019-03-31T00:00:00.000","Tulsa","OK","Passenger","1","1","2","46","48","4.166666666666666666666666667"
"2019-03-31T00:00:00.000","Clackamas","OR","Passenger","1","1","2","198","200","1.00"
"2019-03-31T00:00:00.000","Deschutes","OR","Passenger","2","0","2","151","153","1.307189542483660130718954248"
"2019-03-31T00:00:00.000","Douglas","OR","Passenger","1","0","1","49","50","2.00"
"2019-03-31T00:00:00.000","Klamath","OR","Passenger","1","0","1","30","31","3.225806451612903225806451613"
"2019-03-31T00:00:00.000","Marion","OR","Passenger","1","0","1","114","115","0.8695652173913043478260869565"
"2019-03-31T00:00:00.000","Multnomah","OR","Passenger","4","4","8","719","727","1.100412654745529573590096286"
"2019-03-31T00:00:00.000","Washington","OR","Passenger","0","1","1","430","431","0.2320185614849187935034802784"
"2019-03-31T00:00:00.000","Allegheny","PA","Passenger","1","0","1","80","81","1.234567901234567901234567901"
"2019-03-31T00:00:00.000","Bucks","PA","Passenger","1","0","1","18","19","5.263157894736842105263157895"
"2019-03-31T00:00:00.000","Montgomery","PA","Passenger","2","0","2","31","33","6.060606060606060606060606061"
"2019-03-31T00:00:00.000","San Juan","PR","Passenger","0","1","1","3","4","25.00"
"2019-03-31T00:00:00.000","Newport","RI","Passenger","1","0","1","97","98","1.020408163265306122448979592"
"2019-03-31T00:00:00.000","Richland","SC","Passenger","0","1","1","166","167","0.5988023952095808383233532934"
"2019-03-31T00:00:00.000","Spartanburg","SC","Passenger","0","1","1","27","28","3.571428571428571428571428571"
"2019-03-31T00:00:00.000","Shelby","TN","Passenger","0","1","1","98","99","1.010101010101010101010101010"
"2019-03-31T00:00:00.000","Bexar","TX","Passenger","4","4","8","664","672","1.190476190476190476190476190"
"2019-03-31T00:00:00.000","El Paso","TX","Passenger","2","0","2","494","496","0.4032258064516129032258064516"
"2019-03-31T00:00:00.000","Guadalupe","TX","Passenger","1","0","1","68","69","1.449275362318840579710144928"
"2019-03-31T00:00:00.000","Harris","TX","Passenger","0","1","1","245","246","0.4065040650406504065040650407"
"2019-03-31T00:00:00.000","Hidalgo","TX","Passenger","0","1","1","86","87","1.149425287356321839080459770"
"2019-03-31T00:00:00.000","Montgomery","TX","Passenger","2","0","2","56","58","3.448275862068965517241379310"
"2019-03-31T00:00:00.000","Nueces","TX","Passenger","1","1","2","92","94","2.127659574468085106382978723"
"2019-03-31T00:00:00.000","Tarrant","TX","Passenger","2","0","2","190","192","1.041666666666666666666666667"
"2019-03-31T00:00:00.000","Travis","TX","Passenger","2","1","3","189","192","1.562500"
"2019-03-31T00:00:00.000","Albemarle","VA","Passenger","1","0","1","24","25","4.00"
"2019-03-31T00:00:00.000","Alexandria","VA","Passenger","3","0","3","154","157","1.910828025477707006369426752"
"2019-03-31T00:00:00.000","Arlington","VA","Passenger","1","2","3","161","164","1.829268292682926829268292683"
"2019-03-31T00:00:00.000","Fairfax","VA","Passenger","3","3","6","796","802","0.7481296758104738154613466334"
"2019-03-31T00:00:00.000","Goochland","VA","Passenger","1","1","2","229","231","0.8658008658008658008658008658"
"2019-03-31T00:00:00.000","Manassas","VA","Passenger","0","1","1","9","10","10.0"
"2019-03-31T00:00:00.000","Norfolk","VA","Passenger","2","2","4","352","356","1.123595505617977528089887640"
"2019-03-31T00:00:00.000","Portsmouth","VA","Passenger","0","1","1","65","66","1.515151515151515151515151515"
"2019-03-31T00:00:00.000","Prince William","VA","Passenger","0","4","4","252","256","1.562500"
"2019-03-31T00:00:00.000","Rockbridge","VA","Passenger","1","0","1","3","4","25.00"
"2019-03-31T00:00:00.000","Virginia Beach","VA","Passenger","1","1","2","688","690","0.2898550724637681159420289855"
"2019-03-31T00:00:00.000","Adams","WA","Passenger","4","6","10","12634","12644","0.07908889591901297057893071813"
"2019-03-31T00:00:00.000","Adams","WA","Truck","0","0","0","5105","5105","0"
"2019-03-31T00:00:00.000","Asotin","WA","Truck","0","0","0","6637","6637","0"
"2019-03-31T00:00:00.000","Asotin","WA","Passenger","13","10","23","12663","12686","0.1813022229229071417310420936"
"2019-03-31T00:00:00.000","Benton","WA","Passenger","248","258","506","133002","133508","0.3790035054079156305240135423"
"2019-03-31T00:00:00.000","Benton","WA","Truck","0","0","0","41539","41539","0"
"2019-03-31T00:00:00.000","Chelan","WA","Passenger","145","67","212","54169","54381","0.3898420404185285301851749692"
"2019-03-31T00:00:00.000","Chelan","WA","Truck","0","0","0","22131","22131","0"
"2019-03-31T00:00:00.000","Clallam","WA","Passenger","164","135","299","50319","50618","0.5906989608439685487376032241"
"2019-03-31T00:00:00.000","Clallam","WA","Truck","0","0","0","21616","21616","0"
"2019-03-31T00:00:00.000","Clark","WA","Passenger","1450","918","2368","311901","314269","0.7534946176683032688556618693"
"2019-03-31T00:00:00.000","Clark","WA","Truck","0","0","0","80002","80002","0"
"2019-03-31T00:00:00.000","Columbia","WA","Truck","0","0","0","1528","1528","0"
"2019-03-31T00:00:00.000","Columbia","WA","Passenger","2","2","4","2426","2430","0.1646090534979423868312757202"
"2019-03-31T00:00:00.000","Cowlitz","WA","Truck","0","0","0","28791","28791","0"
"2019-03-31T00:00:00.000","Cowlitz","WA","Passenger","95","114","209","72531","72740","0.2873247181743194940885345065"
"2019-03-31T00:00:00.000","Douglas","WA","Passenger","54","34","88","27894","27982","0.3144878850689729111571724680"
"2019-03-31T00:00:00.000","Douglas","WA","Truck","0","0","0","12158","12158","0"
"2019-03-31T00:00:00.000","Ferry","WA","Passenger","3","2","5","4363","4368","0.1144688644688644688644688645"
"2019-03-31T00:00:00.000","Ferry","WA","Truck","0","0","0","3594","3594","0"
"2019-03-31T00:00:00.000","Franklin","WA","Truck","0","0","0","19138","19138","0"
"2019-03-31T00:00:00.000","Franklin","WA","Passenger","60","70","130","59374","59504","0.2184727077171282602850228556"
"2019-03-31T00:00:00.000","Garfield","WA","Passenger","1","1","2","1311","1313","0.1523229246001523229246001523"
"2019-03-31T00:00:00.000","Garfield","WA","Truck","0","0","0","954","954","0"
"2019-03-31T00:00:00.000","Grant","WA","Passenger","37","59","96","64226","64322","0.1492490905133546842448928827"
"2019-03-31T00:00:00.000","Grant","WA","Truck","0","0","0","26343","26343","0"
"2019-03-31T00:00:00.000","Grays Harbor","WA","Truck","0","0","0","20379","20379","0"
"2019-03-31T00:00:00.000","Grays Harbor","WA","Passenger","81","85","166","47583","47749","0.3476512597122452826237198685"
"2019-03-31T00:00:00.000","Island","WA","Truck","0","0","0","21190","21190","0"
"2019-03-31T00:00:00.000","Island","WA","Passenger","313","244","557","63146","63703","0.8743701238560193397485204778"
"2019-03-31T00:00:00.000","Jefferson","WA","Truck","0","0","0","9647","9647","0"
"2019-03-31T00:00:00.000","Jefferson","WA","Passenger","188","126","314","24883","25197","1.246180100805651466444417986"
"2019-03-31T00:00:00.000","King","WA","Passenger","18063","7044","25107","1381333","1406440","1.785145473678223031199340178"
"2019-03-31T00:00:00.000","King","WA","Truck","6","1","7","181822","181829","0.003849770938629151565481853830"
"2019-03-31T00:00:00.000","Kitsap","WA","Passenger","1071","591","1662","179897","181559","0.9154049096987756046243920709"
"2019-03-31T00:00:00.000","Kitsap","WA","Truck","1","0","1","53779","53780","0.001859427296392711044998140573"
"2019-03-31T00:00:00.000","Kittitas","WA","Truck","0","0","0","14248","14248","0"
"2019-03-31T00:00:00.000","Kittitas","WA","Passenger","75","38","113","29445","29558","0.3822992083361526490290276744"
"2019-03-31T00:00:00.000","Klickitat","WA","Truck","0","0","0","8209","8209","0"
"2019-03-31T00:00:00.000","Klickitat","WA","Passenger","36","32","68","15423","15491","0.4389645600671357562455619392"
"2019-03-31T00:00:00.000","Lewis","WA","Passenger","103","94","197","58518","58715","0.3355190326151749978710721281"
"2019-03-31T00:00:00.000","Lewis","WA","Truck","0","0","0","25761","25761","0"
"2019-03-31T00:00:00.000","Lincoln","WA","Truck","0","0","0","4682","4682","0"
"2019-03-31T00:00:00.000","Lincoln","WA","Passenger","5","7","12","7738","7750","0.1548387096774193548387096774"
"2019-03-31T00:00:00.000","Mason","WA","Truck","0","0","0","20273","20273","0"
"2019-03-31T00:00:00.000","Mason","WA","Passenger","134","122","256","46705","46961","0.5451331956304167287749409084"
"2019-03-31T00:00:00.000","Okanogan","WA","Truck","0","0","0","16443","16443","0"
"2019-03-31T00:00:00.000","Okanogan","WA","Passenger","21","21","42","25910","25952","0.1618372379778051787916152898"
"2019-03-31T00:00:00.000","Pacific","WA","Truck","0","0","0","7658","7658","0"
"2019-03-31T00:00:00.000","Pacific","WA","Passenger","36","28","64","15841","15905","0.4023891857906318767683118516"
"2019-03-31T00:00:00.000","Pend Oreille","WA","Truck","0","0","0","5719","5719","0"
"2019-03-31T00:00:00.000","Pend Oreille","WA","Passenger","6","5","11","9475","9486","0.1159603626396795277250685220"
"2019-03-31T00:00:00.000","Pierce","WA","Truck","0","0","0","139052","139052","0"
"2019-03-31T00:00:00.000","Pierce","WA","Passenger","1848","1550","3398","539394","542792","0.6260224911199870300225500744"
"2019-03-31T00:00:00.000","San Juan","WA","Truck","0","0","0","5813","5813","0"
"2019-03-31T00:00:00.000","San Juan","WA","Passenger","198","72","270","14290","14560","1.854395604395604395604395604"
"2019-03-31T00:00:00.000","Skagit","WA","Truck","1","0","1","32268","32269","0.003098949456134370448417986303"
"2019-03-31T00:00:00.000","Skagit","WA","Passenger","311","203","514","91313","91827","0.5597482222004421357552789485"
"2019-03-31T00:00:00.000","Skamania","WA","Passenger","23","15","38","8725","8763","0.4336414469930389136140591122"
"2019-03-31T00:00:00.000","Skamania","WA","Truck","0","0","0","4018","4018","0"
"2019-03-31T00:00:00.000","Snohomish","WA","Passenger","3341","1613","4954","527921","532875","0.9296739385409336148252404410"
"2019-03-31T00:00:00.000","Snohomish","WA","Truck","1","0","1","121937","121938","0.0008200888976365037970115960570"
"2019-03-31T00:00:00.000","Spokane","WA","Passenger","524","419","943","307821","308764","0.3054112526071692295733958622"
"2019-03-31T00:00:00.000","Spokane","WA","Truck","1","0","1","94043","94044","0.001063332057334864531495895538"
"2019-03-31T00:00:00.000","Stevens","WA","Passenger","20","30","50","31633","31683","0.1578133383833601616008585046"
"2019-03-31T00:00:00.000","Stevens","WA","Truck","0","0","0","18709","18709","0"
"2019-03-31T00:00:00.000","Thurston","WA","Truck","0","0","0","54971","54971","0"
"2019-03-31T00:00:00.000","Thurston","WA","Passenger","883","633","1516","196185","197701","0.7668145330574959155492384965"
"2019-03-31T00:00:00.000","Wahkiakum","WA","Passenger","2","2","4","3007","3011","0.1328462304882098970441713716"
"2019-03-31T00:00:00.000","Wahkiakum","WA","Truck","0","0","0","1726","1726","0"
"2019-03-31T00:00:00.000","Walla Walla","WA","Passenger","45","57","102","36083","36185","0.2818847588779881166229100456"
"2019-03-31T00:00:00.000","Walla Walla","WA","Truck","0","0","0","13559","13559","0"
"2019-03-31T00:00:00.000","Whatcom","WA","Truck","2","0","2","42736","42738","0.004679676166409284477514156020"
"2019-03-31T00:00:00.000","Whatcom","WA","Passenger","842","402","1244","149748","150992","0.8238847091236621807777895518"
"2019-03-31T00:00:00.000","Whitman","WA","Passenger","28","45","73","22730","22803","0.3201333157917817830987150813"
"2019-03-31T00:00:00.000","Whitman","WA","Truck","0","0","0","8508","8508","0"
"2019-03-31T00:00:00.000","Yakima","WA","Passenger","99","111","210","164214","164424","0.1277185812290176616552328127"
"2019-03-31T00:00:00.000","Yakima","WA","Truck","0","0","0","58749","58749","0"
"2019-03-31T00:00:00.000","Ozaukee","WI","Passenger","0","1","1","3","4","25.00"
"2019-03-31T00:00:00.000",,,"Passenger","2","0","2","245","247","0.8097165991902834008097165992"
"2019-04-30T00:00:00.000","Juneau","AK","Passenger","0","2","2","31","33","6.060606060606060606060606061"
"2019-04-30T00:00:00.000","Dale","AL","Passenger","0","1","1","58","59","1.694915254237288135593220339"
"2019-04-30T00:00:00.000","Lee","AL","Passenger","1","0","1","35","36","2.777777777777777777777777778"
"2019-04-30T00:00:00.000","Montgomery","AL","Passenger","0","1","1","43","44","2.272727272727272727272727273"
"2019-04-30T00:00:00.000","Cochise","AZ","Passenger","0","1","1","122","123","0.8130081300813008130081300813"
"2019-04-30T00:00:00.000","Maricopa","AZ","Passenger","7","3","10","1417","1427","0.7007708479327259985984583041"
"2019-04-30T00:00:00.000","Pima","AZ","Passenger","0","1","1","386","387","0.2583979328165374677002583979"
"2019-04-30T00:00:00.000","Pinal","AZ","Passenger","2","0","2","173","175","1.142857142857142857142857143"
"2019-04-30T00:00:00.000","Alameda","CA","Passenger","3","2","5","304","309","1.618122977346278317152103560"
"2019-04-30T00:00:00.000","Contra Costa","CA","Passenger","2","2","4","418","422","0.9478672985781990521327014218"
"2019-04-30T00:00:00.000","Fresno","CA","Passenger","1","0","1","185","186","0.5376344086021505376344086022"
"2019-04-30T00:00:00.000","Kern","CA","Passenger","0","1","1","231","232","0.4310344827586206896551724138"
"2019-04-30T00:00:00.000","Los Angeles","CA","Passenger","9","5","14","1073","1087","1.287948482060717571297148114"
"2019-04-30T00:00:00.000","Orange","CA","Passenger","5","1","6","525","531","1.129943502824858757062146893"
"2019-04-30T00:00:00.000","Riverside","CA","Passenger","1","2","3","640","643","0.4665629860031104199066874028"
"2019-04-30T00:00:00.000","San Diego","CA","Passenger","9","3","12","2682","2694","0.4454342984409799554565701559"
"2019-04-30T00:00:00.000","San Francisco","CA","Passenger","2","1","3","105","108","2.777777777777777777777777778"
"2019-04-30T00:00:00.000","San Mateo","CA","Passenger","2","1","3","119","122","2.459016393442622950819672131"
"2019-04-30T00:00:00.000","Santa Barbara","CA","Passenger","2","0","2","92","94","2.127659574468085106382978723"
"2019-04-30T00:00:00.000","Santa Clara","CA","Passenger","7","1","8","352","360","2.222222222222222222222222222"
"2019-04-30T00:00:00.000","Santa Cruz","CA","Passenger","1","0","1","38","39","2.564102564102564102564102564"
"2019-04-30T00:00:00.000","Shasta","CA","Passenger","1","0","1","40","41","2.439024390243902439024390244"
"2019-04-30T00:00:00.000","Tuolumne","CA","Passenger","0","1","1","10","11","9.090909090909090909090909091"
"2019-04-30T00:00:00.000","Ventura","CA","Passenger","0","2","2","310","312","0.6410256410256410256410256410"
"2019-04-30T00:00:00.000","Denver","CO","Passenger","1","0","1","126","127","0.7874015748031496062992125984"
"2019-04-30T00:00:00.000","El Paso","CO","Passenger","3","2","5","741","746","0.6702412868632707774798927614"
"2019-04-30T00:00:00.000","Jefferson","CO","Passenger","0","2","2","62","64","3.12500"
"2019-04-30T00:00:00.000","Larimer","CO","Passenger","1","1","2","55","57","3.508771929824561403508771930"
"2019-04-30T00:00:00.000","New London","CT","Passenger","0","2","2","269","271","0.7380073800738007380073800738"
"2019-04-30T00:00:00.000","District of Columbia","DC","Passenger","1","3","4","205","209","1.913875598086124401913875598"
"2019-04-30T00:00:00.000","Kent","DE","Passenger","0","1","1","75","76","1.315789473684210526315789474"
"2019-04-30T00:00:00.000","New Castle","DE","Passenger","1","0","1","24","25","4.00"
"2019-04-30T00:00:00.000","Brevard","FL","Passenger","0","1","1","78","79","1.265822784810126582278481013"
"2019-04-30T00:00:00.000","Broward","FL","Passenger","1","1","2","124","126","1.587301587301587301587301587"
"2019-04-30T00:00:00.000","Clay","FL","Passenger","0","1","1","85","86","1.162790697674418604651162791"
"2019-04-30T00:00:00.000","Duval","FL","Passenger","1","1","2","375","377","0.5305039787798408488063660477"
"2019-04-30T00:00:00.000","Lake","FL","Passenger","1","0","1","15","16","6.2500"
"2019-04-30T00:00:00.000","Manatee","FL","Passenger","1","0","1","31","32","3.12500"
"2019-04-30T00:00:00.000","Palm Beach","FL","Passenger","0","1","1","81","82","1.219512195121951219512195122"
"2019-04-30T00:00:00.000","Polk","FL","Passenger","1","0","1","66","67","1.492537313432835820895522388"
"2019-04-30T00:00:00.000","Santa Rosa","FL","Passenger","1","0","1","90","91","1.098901098901098901098901099"
"2019-04-30T00:00:00.000","St. Lucie","FL","Passenger","1","0","1","27","28","3.571428571428571428571428571"
"2019-04-30T00:00:00.000","Sumter","FL","Passenger","0","1","1","10","11","9.090909090909090909090909091"
"2019-04-30T00:00:00.000","Volusia","FL","Passenger","0","1","1","33","34","2.941176470588235294117647059"
"2019-04-30T00:00:00.000","Bryan","GA","Passenger","1","0","1","52","53","1.886792452830188679245283019"
"2019-04-30T00:00:00.000","Camden","GA","Passenger","0","1","1","163","164","0.6097560975609756097560975610"
"2019-04-30T00:00:00.000","Columbia","GA","Passenger","1","1","2","144","146","1.369863013698630136986301370"
"2019-04-30T00:00:00.000","DeKalb","GA","Passenger","1","0","1","77","78","1.282051282051282051282051282"
"2019-04-30T00:00:00.000","Fulton","GA","Passenger","1","2","3","110","113","2.654867256637168141592920354"
"2019-04-30T00:00:00.000","Houston","GA","Passenger","1","0","1","56","57","1.754385964912280701754385965"
"2019-04-30T00:00:00.000","Liberty","GA","Passenger","1","0","1","137","138","0.7246376811594202898550724638"
"2019-04-30T00:00:00.000","Lumpkin","GA","Passenger","1","0","1","6","7","14.28571428571428571428571429"
"2019-04-30T00:00:00.000","Honolulu","HI","Passenger","2","2","4","493","497","0.8048289738430583501006036217"
"2019-04-30T00:00:00.000","Maui","HI","Passenger","1","0","1","44","45","2.222222222222222222222222222"
"2019-04-30T00:00:00.000","Ada","ID","Passenger","0","2","2","297","299","0.6688963210702341137123745819"
"2019-04-30T00:00:00.000","Kootenai","ID","Passenger","1","1","2","200","202","0.9900990099009900990099009901"
"2019-04-30T00:00:00.000","Twin Falls","ID","Passenger","0","1","1","20","21","4.761904761904761904761904762"
"2019-04-30T00:00:00.000","Cook","IL","Passenger","1","0","1","229","230","0.4347826086956521739130434783"
"2019-04-30T00:00:00.000","DuPage","IL","Passenger","1","0","1","56","57","1.754385964912280701754385965"
"2019-04-30T00:00:00.000","Monroe","IL","Passenger","1","0","1","3","4","25.00"
"2019-04-30T00:00:00.000","Sangamon","IL","Passenger","2","0","2","8","10","20.0"
"2019-04-30T00:00:00.000","St. Clair","IL","Passenger","0","1","1","158","159","0.6289308176100628930817610063"
"2019-04-30T00:00:00.000","DeKalb","IN","Passenger","1","0","1","1","2","50.0"
"2019-04-30T00:00:00.000","Vigo","IN","Passenger","1","0","1","5","6","16.66666666666666666666666667"
"2019-04-30T00:00:00.000","Oldham","KY","Passenger","0","1","1","5","6","16.66666666666666666666666667"
"2019-04-30T00:00:00.000","Caddo","LA","Passenger","0","1","1","24","25","4.00"
"2019-04-30T00:00:00.000","Berkshire","MA","Passenger","0","1","1","5","6","16.66666666666666666666666667"
"2019-04-30T00:00:00.000","Franklin","MA","Passenger","0","1","1","1","2","50.0"
"2019-04-30T00:00:00.000","Middlesex","MA","Passenger","1","1","2","113","115","1.739130434782608695652173913"
"2019-04-30T00:00:00.000","Nantucket","MA","Passenger","1","0","1","2","3","33.33333333333333333333333333"
"2019-04-30T00:00:00.000","Norfolk","MA","Passenger","1","0","1","29","30","3.333333333333333333333333333"
"2019-04-30T00:00:00.000","Suffolk","MA","Passenger","0","1","1","42","43","2.325581395348837209302325581"
"2019-04-30T00:00:00.000","Anne Arundel","MD","Passenger","0","2","2","449","451","0.4434589800443458980044345898"
"2019-04-30T00:00:00.000","Calvert","MD","Passenger","0","2","2","86","88","2.272727272727272727272727273"
"2019-04-30T00:00:00.000","Charles","MD","Passenger","0","1","1","80","81","1.234567901234567901234567901"
"2019-04-30T00:00:00.000","Frederick","MD","Passenger","2","1","3","82","85","3.529411764705882352941176471"
"2019-04-30T00:00:00.000","Howard","MD","Passenger","0","1","1","77","78","1.282051282051282051282051282"
"2019-04-30T00:00:00.000","Montgomery","MD","Passenger","1","2","3","278","281","1.067615658362989323843416370"
"2019-04-30T00:00:00.000","St. Mary's","MD","Passenger","1","0","1","205","206","0.4854368932038834951456310680"
"2019-04-30T00:00:00.000","Penobscot","ME","Passenger","0","1","1","15","16","6.2500"
"2019-04-30T00:00:00.000","Kent","MI","Passenger","0","1","1","21","22","4.545454545454545454545454545"
"2019-04-30T00:00:00.000","Washtenaw","MI","Passenger","1","0","1","29","30","3.333333333333333333333333333"
"2019-04-30T00:00:00.000","Wayne","MI","Passenger","0","1","1","66","67","1.492537313432835820895522388"
"2019-04-30T00:00:00.000","Dakota","MN","Passenger","0","1","1","32","33","3.030303030303030303030303030"
"2019-04-30T00:00:00.000","Hennepin","MN","Passenger","2","0","2","100","102","1.960784313725490196078431373"
"2019-04-30T00:00:00.000","Kanabec","MN","Passenger","1","0","1","0","1","100"
"2019-04-30T00:00:00.000","Ramsey","MN","Passenger","1","0","1","43","44","2.272727272727272727272727273"
"2019-04-30T00:00:00.000","Cascade","MT","Passenger","0","1","1","58","59","1.694915254237288135593220339"
"2019-04-30T00:00:00.000","Flathead","MT","Passenger","1","0","1","56","57","1.754385964912280701754385965"
"2019-04-30T00:00:00.000","Gallatin","MT","Passenger","0","1","1","56","57","1.754385964912280701754385965"
"2019-04-30T00:00:00.000","Glacier","MT","Passenger","0","1","1","5","6","16.66666666666666666666666667"
"2019-04-30T00:00:00.000","Cumberland","NC","Passenger","0","2","2","529","531","0.3766478342749529190207156309"
"2019-04-30T00:00:00.000","Guilford","NC","Passenger","1","0","1","25","26","3.846153846153846153846153846"
"2019-04-30T00:00:00.000","Harnett","NC","Passenger","0","1","1","219","220","0.4545454545454545454545454545"
"2019-04-30T00:00:00.000","Mecklenburg","NC","Passenger","1","0","1","83","84","1.190476190476190476190476190"
"2019-04-30T00:00:00.000","Moore","NC","Passenger","0","1","1","185","186","0.5376344086021505376344086022"
"2019-04-30T00:00:00.000","Douglas","NE","Passenger","0","1","1","64","65","1.538461538461538461538461538"
"2019-04-30T00:00:00.000","Carroll","NH","Passenger","0","1","1","1","2","50.0"
"2019-04-30T00:00:00.000","Bergen","NJ","Passenger","1","0","1","27","28","3.571428571428571428571428571"
"2019-04-30T00:00:00.000","Camden","NJ","Passenger","0","1","1","24","25","4.00"
"2019-04-30T00:00:00.000","Chaves","NM","Passenger","1","0","1","6","7","14.28571428571428571428571429"
"2019-04-30T00:00:00.000","Santa Fe","NM","Passenger","0","1","1","38","39","2.564102564102564102564102564"
"2019-04-30T00:00:00.000","Valencia","NM","Passenger","1","0","1","7","8","12.500"
"2019-04-30T00:00:00.000","Carson City","NV","Passenger","1","0","1","13","14","7.142857142857142857142857143"
"2019-04-30T00:00:00.000","Clark","NV","Passenger","3","2","5","681","686","0.7288629737609329446064139942"
"2019-04-30T00:00:00.000","Washoe","NV","Passenger","2","0","2","97","99","2.020202020202020202020202020"
"2019-04-30T00:00:00.000","Jefferson","NY","Passenger","0","2","2","227","229","0.8733624454148471615720524017"
"2019-04-30T00:00:00.000","Nassau","NY","Passenger","2","0","2","38","40","5.00"
"2019-04-30T00:00:00.000","Saratoga","NY","Passenger","1","0","1","58","59","1.694915254237288135593220339"
"2019-04-30T00:00:00.000","Oklahoma","OK","Passenger","0","1","1","112","113","0.8849557522123893805309734513"
"2019-04-30T00:00:00.000","Rogers","OK","Passenger","1","0","1","5","6","16.66666666666666666666666667"
"2019-04-30T00:00:00.000","Tulsa","OK","Passenger","1","1","2","44","46","4.347826086956521739130434783"
"2019-04-30T00:00:00.000","Clackamas","OR","Passenger","1","1","2","200","202","0.9900990099009900990099009901"
"2019-04-30T00:00:00.000","Deschutes","OR","Passenger","2","0","2","148","150","1.333333333333333333333333333"
"2019-04-30T00:00:00.000","Douglas","OR","Passenger","1","0","1","50","51","1.960784313725490196078431373"
"2019-04-30T00:00:00.000","Klamath","OR","Passenger","1","0","1","30","31","3.225806451612903225806451613"
"2019-04-30T00:00:00.000","Marion","OR","Passenger","1","0","1","113","114","0.8771929824561403508771929825"
"2019-04-30T00:00:00.000","Multnomah","OR","Passenger","4","4","8","719","727","1.100412654745529573590096286"
"2019-04-30T00:00:00.000","Allegheny","PA","Passenger","1","0","1","78","79","1.265822784810126582278481013"
"2019-04-30T00:00:00.000","Bucks","PA","Passenger","1","0","1","18","19","5.263157894736842105263157895"
"2019-04-30T00:00:00.000","Montgomery","PA","Passenger","2","0","2","32","34","5.882352941176470588235294118"
"2019-04-30T00:00:00.000","San Juan","PR","Passenger","0","1","1","3","4","25.00"
"2019-04-30T00:00:00.000","Newport","RI","Passenger","1","0","1","93","94","1.063829787234042553191489362"
"2019-04-30T00:00:00.000","Richland","SC","Passenger","0","1","1","162","163","0.6134969325153374233128834356"
"2019-04-30T00:00:00.000","Spartanburg","SC","Passenger","0","1","1","27","28","3.571428571428571428571428571"
"2019-04-30T00:00:00.000","Shelby","TN","Passenger","0","1","1","95","96","1.041666666666666666666666667"
"2019-04-30T00:00:00.000","Bexar","TX","Passenger","5","4","9","656","665","1.353383458646616541353383459"
"2019-04-30T00:00:00.000","El Paso","TX","Passenger","2","0","2","487","489","0.4089979550102249488752556237"
"2019-04-30T00:00:00.000","Guadalupe","TX","Passenger","1","0","1","67","68","1.470588235294117647058823529"
"2019-04-30T00:00:00.000","Harris","TX","Passenger","0","1","1","241","242","0.4132231404958677685950413223"
"2019-04-30T00:00:00.000","Hidalgo","TX","Passenger","0","1","1","87","88","1.136363636363636363636363636"
"2019-04-30T00:00:00.000","Montgomery","TX","Passenger","2","0","2","54","56","3.571428571428571428571428571"
"2019-04-30T00:00:00.000","Nueces","TX","Passenger","1","1","2","95","97","2.061855670103092783505154639"
"2019-04-30T00:00:00.000","Tarrant","TX","Passenger","2","0","2","189","191","1.047120418848167539267015707"
"2019-04-30T00:00:00.000","Travis","TX","Passenger","2","1","3","183","186","1.612903225806451612903225806"
"2019-04-30T00:00:00.000","Albemarle","VA","Passenger","1","0","1","26","27","3.703703703703703703703703704"
"2019-04-30T00:00:00.000","Alexandria","VA","Passenger","3","0","3","152","155","1.935483870967741935483870968"
"2019-04-30T00:00:00.000","Arlington","VA","Passenger","1","2","3","159","162","1.851851851851851851851851852"
"2019-04-30T00:00:00.000","Fairfax","VA","Passenger","3","3","6","783","789","0.7604562737642585551330798479"
"2019-04-30T00:00:00.000","Goochland","VA","Passenger","1","1","2","232","234","0.8547008547008547008547008547"
"2019-04-30T00:00:00.000","Manassas","VA","Passenger","0","1","1","8","9","11.11111111111111111111111111"
"2019-04-30T00:00:00.000","Norfolk","VA","Passenger","2","2","4","355","359","1.114206128133704735376044568"
"2019-04-30T00:00:00.000","Portsmouth","VA","Passenger","0","1","1","64","65","1.538461538461538461538461538"
"2019-04-30T00:00:00.000","Prince William","VA","Passenger","1","4","5","252","257","1.945525291828793774319066148"
"2019-04-30T00:00:00.000","Rockbridge","VA","Passenger","1","0","1","3","4","25.00"
"2019-04-30T00:00:00.000","Virginia Beach","VA","Passenger","1","1","2","687","689","0.2902757619738751814223512337"
"2019-04-30T00:00:00.000","Adams","WA","Passenger","5","6","11","12659","12670","0.08681925808997632202052091555"
"2019-04-30T00:00:00.000","Adams","WA","Truck","0","0","0","5105","5105","0"
"2019-04-30T00:00:00.000","Asotin","WA","Truck","0","0","0","6634","6634","0"
"2019-04-30T00:00:00.000","Asotin","WA","Passenger","13","9","22","12662","12684","0.1734468621885840428886786503"
"2019-04-30T00:00:00.000","Benton","WA","Passenger","260","270","530","133322","133852","0.3959597167020291067746466246"
"2019-04-30T00:00:00.000","Benton","WA","Truck","0","0","0","41663","41663","0"
"2019-04-30T00:00:00.000","Chelan","WA","Passenger","148","67","215","54307","54522","0.3943362312461024907376838707"
"2019-04-30T00:00:00.000","Chelan","WA","Truck","0","0","0","22177","22177","0"
"2019-04-30T00:00:00.000","Clallam","WA","Passenger","170","138","308","50458","50766","0.6067052751841783871094827247"
"2019-04-30T00:00:00.000","Clallam","WA","Truck","0","0","0","21682","21682","0"
"2019-04-30T00:00:00.000","Clark","WA","Truck","0","0","0","80115","80115","0"
"2019-04-30T00:00:00.000","Clark","WA","Passenger","1507","933","2440","312509","314949","0.7747286068538080768632381751"
"2019-04-30T00:00:00.000","Columbia","WA","Truck","0","0","0","1532","1532","0"
"2019-04-30T00:00:00.000","Columbia","WA","Passenger","2","2","4","2440","2444","0.1636661211129296235679214403"
"2019-04-30T00:00:00.000","Cowlitz","WA","Truck","0","0","0","28861","28861","0"
"2019-04-30T00:00:00.000","Cowlitz","WA","Passenger","100","115","215","72737","72952","0.2947143327119201666849435245"
"2019-04-30T00:00:00.000","Douglas","WA","Truck","0","0","0","12177","12177","0"
"2019-04-30T00:00:00.000","Douglas","WA","Passenger","56","34","90","27977","28067","0.3206612748067125093526205152"
"2019-04-30T00:00:00.000","Ferry","WA","Passenger","4","2","6","4371","4377","0.1370801919122686771761480466"
"2019-04-30T00:00:00.000","Ferry","WA","Truck","0","0","0","3592","3592","0"
"2019-04-30T00:00:00.000","Franklin","WA","Truck","0","0","0","19221","19221","0"
"2019-04-30T00:00:00.000","Franklin","WA","Passenger","61","69","130","59472","59602","0.2181134861246266903795174659"
"2019-04-30T00:00:00.000","Garfield","WA","Passenger","1","1","2","1299","1301","0.1537279016141429669485011530"
"2019-04-30T00:00:00.000","Garfield","WA","Truck","0","0","0","958","958","0"
"2019-04-30T00:00:00.000","Grant","WA","Passenger","38","64","102","64398","64500","0.1581395348837209302325581395"
"2019-04-30T00:00:00.000","Grant","WA","Truck","0","0","0","26435","26435","0"
"2019-04-30T00:00:00.000","Grays Harbor","WA","Truck","0","0","0","20397","20397","0"
"2019-04-30T00:00:00.000","Grays Harbor","WA","Passenger","82","89","171","47658","47829","0.3575236781032428024838487110"
"2019-04-30T00:00:00.000","Island","WA","Truck","0","0","0","21253","21253","0"
"2019-04-30T00:00:00.000","Island","WA","Passenger","324","251","575","63277","63852","0.9005199523899016475599824594"
"2019-04-30T00:00:00.000","Jefferson","WA","Passenger","196","127","323","24904","25227","1.280374202243627859039917549"
"2019-04-30T00:00:00.000","Jefferson","WA","Truck","0","0","0","9654","9654","0"
"2019-04-30T00:00:00.000","King","WA","Truck","5","1","6","181877","181883","0.003298823969254960606543767147"
"2019-04-30T00:00:00.000","King","WA","Passenger","18667","7139","25806","1384061","1409867","1.830385419333880429856149552"
"2019-04-30T00:00:00.000","Kitsap","WA","Passenger","1081","597","1678","180182","181860","0.9226877818101836577587154954"
"2019-04-30T00:00:00.000","Kitsap","WA","Truck","1","0","1","53904","53905","0.001855115480938688433354976347"
"2019-04-30T00:00:00.000","Kittitas","WA","Truck","0","0","0","14295","14295","0"
"2019-04-30T00:00:00.000","Kittitas","WA","Passenger","75","36","111","29493","29604","0.3749493311714633157681394406"
"2019-04-30T00:00:00.000","Klickitat","WA","Truck","0","0","0","8224","8224","0"
"2019-04-30T00:00:00.000","Klickitat","WA","Passenger","37","34","71","15506","15577","0.4558002182705270591256339475"
"2019-04-30T00:00:00.000","Lewis","WA","Passenger","103","95","198","58814","59012","0.3355249779705822544567206670"
"2019-04-30T00:00:00.000","Lewis","WA","Truck","0","0","0","25830","25830","0"
"2019-04-30T00:00:00.000","Lincoln","WA","Truck","0","0","0","4699","4699","0"
"2019-04-30T00:00:00.000","Lincoln","WA","Passenger","5","7","12","7761","7773","0.1543805480509455808568120417"
"2019-04-30T00:00:00.000","Mason","WA","Truck","0","0","0","20324","20324","0"
"2019-04-30T00:00:00.000","Mason","WA","Passenger","137","124","261","46855","47116","0.5539519483827150012734527549"
"2019-04-30T00:00:00.000","Okanogan","WA","Truck","0","0","0","16481","16481","0"
"2019-04-30T00:00:00.000","Okanogan","WA","Passenger","21","22","43","26024","26067","0.1649595273717727394790347950"
"2019-04-30T00:00:00.000","Pacific","WA","Passenger","34","31","65","15914","15979","0.4067839038738344076600538206"
"2019-04-30T00:00:00.000","Pacific","WA","Truck","0","0","0","7662","7662","0"
"2019-04-30T00:00:00.000","Pend Oreille","WA","Passenger","5","5","10","9505","9515","0.1050972149238045191802417236"
"2019-04-30T00:00:00.000","Pend Oreille","WA","Truck","0","0","0","5751","5751","0"
"2019-04-30T00:00:00.000","Pierce","WA","Truck","0","0","0","139402","139402","0"
"2019-04-30T00:00:00.000","Pierce","WA","Passenger","1912","1577","3489","540886","544375","0.6409184845005740528128587830"
"2019-04-30T00:00:00.000","San Juan","WA","Truck","0","0","0","5836","5836","0"
"2019-04-30T00:00:00.000","San Juan","WA","Passenger","205","71","276","14331","14607","1.889505031834052166769357158"
"2019-04-30T00:00:00.000","Skagit","WA","Truck","1","0","1","32339","32340","0.003092145949288806431663574521"
"2019-04-30T00:00:00.000","Skagit","WA","Passenger","322","211","533","91525","92058","0.5789828151817332551217710574"
"2019-04-30T00:00:00.000","Skamania","WA","Passenger","23","16","39","8714","8753","0.4455615217639666400091397235"
"2019-04-30T00:00:00.000","Skamania","WA","Truck","0","0","0","4041","4041","0"
"2019-04-30T00:00:00.000","Snohomish","WA","Passenger","3439","1637","5076","529092","534168","0.9502628386575010109179134654"
"2019-04-30T00:00:00.000","Snohomish","WA","Truck","1","0","1","122040","122041","0.0008193967601052105439975090338"
"2019-04-30T00:00:00.000","Spokane","WA","Passenger","547","433","980","309628","310608","0.3155102251068871374851903364"
"2019-04-30T00:00:00.000","Spokane","WA","Truck","1","0","1","94410","94411","0.001059198610331423245172702333"
"2019-04-30T00:00:00.000","Stevens","WA","Passenger","22","30","52","31638","31690","0.1640896181760807825812559167"
"2019-04-30T00:00:00.000","Stevens","WA","Truck","0","0","0","18683","18683","0"
"2019-04-30T00:00:00.000","Thurston","WA","Truck","0","0","0","55050","55050","0"
"2019-04-30T00:00:00.000","Thurston","WA","Passenger","903","650","1553","196774","198327","0.7830502150488839139401090119"
"2019-04-30T00:00:00.000","Wahkiakum","WA","Passenger","2","2","4","3013","3017","0.1325820351342393105734173020"
"2019-04-30T00:00:00.000","Wahkiakum","WA","Truck","0","0","0","1734","1734","0"
"2019-04-30T00:00:00.000","Walla Walla","WA","Passenger","47","58","105","36153","36258","0.2895912626179050140658613272"
"2019-04-30T00:00:00.000","Walla Walla","WA","Truck","0","0","0","13610","13610","0"
"2019-04-30T00:00:00.000","Whatcom","WA","Truck","2","0","2","42786","42788","0.004674207721791156398990371132"
"2019-04-30T00:00:00.000","Whatcom","WA","Passenger","875","410","1285","150082","151367","0.8489300838359748161752561655"
"2019-04-30T00:00:00.000","Whitman","WA","Passenger","30","49","79","22727","22806","0.3464000701569762343243006226"
"2019-04-30T00:00:00.000","Whitman","WA","Truck","0","0","0","8523","8523","0"
"2019-04-30T00:00:00.000","Yakima","WA","Truck","0","0","0","58951","58951","0"
"2019-04-30T00:00:00.000","Yakima","WA","Passenger","103","112","215","164625","164840","0.1304295074011162339238049017"
"2019-04-30T00:00:00.000","Ozaukee","WI","Passenger","0","1","1","3","4","25.00"
"2019-04-30T00:00:00.000",,,"Passenger","2","0","2","245","247","0.8097165991902834008097165992"
"2019-05-31T00:00:00.000","Juneau","AK","Passenger","0","2","2","30","32","6.2500"
"2019-05-31T00:00:00.000","Dale","AL","Passenger","0","1","1","61","62","1.612903225806451612903225806"
"2019-05-31T00:00:00.000","Lee","AL","Passenger","1","0","1","34","35","2.857142857142857142857142857"
"2019-05-31T00:00:00.000","Montgomery","AL","Passenger","0","1","1","41","42","2.380952380952380952380952381"
"2019-05-31T00:00:00.000","Cochise","AZ","Passenger","0","1","1","119","120","0.8333333333333333333333333333"
"2019-05-31T00:00:00.000","Maricopa","AZ","Passenger","7","3","10","1415","1425","0.7017543859649122807017543860"
"2019-05-31T00:00:00.000","Pima","AZ","Passenger","0","1","1","383","384","0.2604166666666666666666666667"
"2019-05-31T00:00:00.000","Pinal","AZ","Passenger","2","0","2","172","174","1.149425287356321839080459770"
"2019-05-31T00:00:00.000","Alameda","CA","Passenger","3","2","5","300","305","1.639344262295081967213114754"
"2019-05-31T00:00:00.000","Contra Costa","CA","Passenger","2","2","4","412","416","0.9615384615384615384615384615"
"2019-05-31T00:00:00.000","Fresno","CA","Passenger","1","0","1","186","187","0.5347593582887700534759358289"
"2019-05-31T00:00:00.000","Kern","CA","Passenger","0","1","1","230","231","0.4329004329004329004329004329"
"2019-05-31T00:00:00.000","Los Angeles","CA","Passenger","9","5","14","1073","1087","1.287948482060717571297148114"
"2019-05-31T00:00:00.000","Orange","CA","Passenger","5","1","6","521","527","1.138519924098671726755218216"
"2019-05-31T00:00:00.000","Riverside","CA","Passenger","1","2","3","634","637","0.4709576138147566718995290424"
"2019-05-31T00:00:00.000","San Diego","CA","Passenger","10","3","13","2701","2714","0.4789977892409727339719970523"
"2019-05-31T00:00:00.000","San Francisco","CA","Passenger","2","1","3","101","104","2.884615384615384615384615385"
"2019-05-31T00:00:00.000","San Mateo","CA","Passenger","2","1","3","121","124","2.419354838709677419354838710"
"2019-05-31T00:00:00.000","Santa Barbara","CA","Passenger","2","0","2","91","93","2.150537634408602150537634409"
"2019-05-31T00:00:00.000","Santa Clara","CA","Passenger","6","1","7","355","362","1.933701657458563535911602210"
"2019-05-31T00:00:00.000","Santa Cruz","CA","Passenger","1","0","1","39","40","2.500"
"2019-05-31T00:00:00.000","Shasta","CA","Passenger","1","0","1","42","43","2.325581395348837209302325581"
"2019-05-31T00:00:00.000","Solano","CA","Passenger","1","0","1","219","220","0.4545454545454545454545454545"
"2019-05-31T00:00:00.000","Tuolumne","CA","Passenger","0","1","1","10","11","9.090909090909090909090909091"
"2019-05-31T00:00:00.000","Ventura","CA","Passenger","0","2","2","315","317","0.6309148264984227129337539432"
"2019-05-31T00:00:00.000","Denver","CO","Passenger","1","0","1","128","129","0.7751937984496124031007751938"
"2019-05-31T00:00:00.000","El Paso","CO","Passenger","2","1","3","726","729","0.4115226337448559670781893004"
"2019-05-31T00:00:00.000","Jefferson","CO","Passenger","0","2","2","60","62","3.225806451612903225806451613"
"2019-05-31T00:00:00.000","Larimer","CO","Passenger","1","1","2","55","57","3.508771929824561403508771930"
"2019-05-31T00:00:00.000","New London","CT","Passenger","0","2","2","267","269","0.7434944237918215613382899628"
"2019-05-31T00:00:00.000","District of Columbia","DC","Passenger","1","3","4","205","209","1.913875598086124401913875598"
"2019-05-31T00:00:00.000","Kent","DE","Passenger","0","1","1","76","77","1.298701298701298701298701299"
"2019-05-31T00:00:00.000","New Castle","DE","Passenger","1","0","1","23","24","4.166666666666666666666666667"
"2019-05-31T00:00:00.000","Brevard","FL","Passenger","0","1","1","78","79","1.265822784810126582278481013"
"2019-05-31T00:00:00.000","Broward","FL","Passenger","1","1","2","122","124","1.612903225806451612903225806"
"2019-05-31T00:00:00.000","Clay","FL","Passenger","0","1","1","85","86","1.162790697674418604651162791"
"2019-05-31T00:00:00.000","Duval","FL","Passenger","1","1","2","366","368","0.5434782608695652173913043478"
"2019-05-31T00:00:00.000","Lake","FL","Passenger","1","0","1","15","16","6.2500"
"2019-05-31T00:00:00.000","Manatee","FL","Passenger","1","0","1","30","31","3.225806451612903225806451613"
"2019-05-31T00:00:00.000","Palm Beach","FL","Passenger","0","1","1","78","79","1.265822784810126582278481013"
"2019-05-31T00:00:00.000","Pinellas","FL","Passenger","1","0","1","99","100","1.00"
"2019-05-31T00:00:00.000","Polk","FL","Passenger","1","0","1","67","68","1.470588235294117647058823529"
"2019-05-31T00:00:00.000","Santa Rosa","FL","Passenger","1","0","1","92","93","1.075268817204301075268817204"
"2019-05-31T00:00:00.000","St. Lucie","FL","Passenger","1","0","1","26","27","3.703703703703703703703703704"
"2019-05-31T00:00:00.000","Sumter","FL","Passenger","0","1","1","10","11","9.090909090909090909090909091"
"2019-05-31T00:00:00.000","Volusia","FL","Passenger","0","1","1","35","36","2.777777777777777777777777778"
"2019-05-31T00:00:00.000","Bryan","GA","Passenger","1","0","1","51","52","1.923076923076923076923076923"
"2019-05-31T00:00:00.000","Camden","GA","Passenger","0","1","1","162","163","0.6134969325153374233128834356"
"2019-05-31T00:00:00.000","Columbia","GA","Passenger","1","1","2","145","147","1.360544217687074829931972789"
"2019-05-31T00:00:00.000","DeKalb","GA","Passenger","1","0","1","75","76","1.315789473684210526315789474"
"2019-05-31T00:00:00.000","Fulton","GA","Passenger","1","2","3","105","108","2.777777777777777777777777778"
"2019-05-31T00:00:00.000","Houston","GA","Passenger","1","0","1","56","57","1.754385964912280701754385965"
"2019-05-31T00:00:00.000","Liberty","GA","Passenger","1","0","1","132","133","0.7518796992481203007518796992"
"2019-05-31T00:00:00.000","Lumpkin","GA","Passenger","1","0","1","4","5","20.0"
"2019-05-31T00:00:00.000","Honolulu","HI","Passenger","2","2","4","488","492","0.8130081300813008130081300813"
"2019-05-31T00:00:00.000","Maui","HI","Passenger","1","0","1","43","44","2.272727272727272727272727273"
"2019-05-31T00:00:00.000","Ada","ID","Passenger","0","2","2","297","299","0.6688963210702341137123745819"
"2019-05-31T00:00:00.000","Kootenai","ID","Passenger","1","1","2","201","203","0.9852216748768472906403940887"
"2019-05-31T00:00:00.000","Twin Falls","ID","Passenger","0","1","1","20","21","4.761904761904761904761904762"
"2019-05-31T00:00:00.000","Cook","IL","Passenger","1","0","1","229","230","0.4347826086956521739130434783"
"2019-05-31T00:00:00.000","DuPage","IL","Passenger","1","0","1","57","58","1.724137931034482758620689655"
"2019-05-31T00:00:00.000","Monroe","IL","Passenger","1","0","1","4","5","20.0"
"2019-05-31T00:00:00.000","Sangamon","IL","Passenger","1","0","1","8","9","11.11111111111111111111111111"
"2019-05-31T00:00:00.000","St. Clair","IL","Passenger","0","1","1","158","159","0.6289308176100628930817610063"
"2019-05-31T00:00:00.000","DeKalb","IN","Passenger","1","0","1","1","2","50.0"
"2019-05-31T00:00:00.000","Vigo","IN","Passenger","1","0","1","5","6","16.66666666666666666666666667"
"2019-05-31T00:00:00.000","Oldham","KY","Passenger","0","1","1","5","6","16.66666666666666666666666667"
"2019-05-31T00:00:00.000","Caddo","LA","Passenger","0","1","1","25","26","3.846153846153846153846153846"
"2019-05-31T00:00:00.000","Berkshire","MA","Passenger","0","1","1","5","6","16.66666666666666666666666667"
"2019-05-31T00:00:00.000","Franklin","MA","Passenger","0","1","1","1","2","50.0"
"2019-05-31T00:00:00.000","Middlesex","MA","Passenger","1","1","2","114","116","1.724137931034482758620689655"
"2019-05-31T00:00:00.000","Nantucket","MA","Passenger","1","0","1","1","2","50.0"
"2019-05-31T00:00:00.000","Norfolk","MA","Passenger","1","0","1","28","29","3.448275862068965517241379310"
"2019-05-31T00:00:00.000","Suffolk","MA","Passenger","0","1","1","42","43","2.325581395348837209302325581"
"2019-05-31T00:00:00.000","Anne Arundel","MD","Passenger","1","2","3","449","452","0.6637168141592920353982300885"
"2019-05-31T00:00:00.000","Calvert","MD","Passenger","0","2","2","88","90","2.222222222222222222222222222"
"2019-05-31T00:00:00.000","Charles","MD","Passenger","0","1","1","82","83","1.204819277108433734939759036"
"2019-05-31T00:00:00.000","Frederick","MD","Passenger","2","1","3","84","87","3.448275862068965517241379310"
"2019-05-31T00:00:00.000","Howard","MD","Passenger","0","1","1","76","77","1.298701298701298701298701299"
"2019-05-31T00:00:00.000","Montgomery","MD","Passenger","1","2","3","282","285","1.052631578947368421052631579"
"2019-05-31T00:00:00.000","St. Mary's","MD","Passenger","1","0","1","206","207","0.4830917874396135265700483092"
"2019-05-31T00:00:00.000","Penobscot","ME","Passenger","0","1","1","15","16","6.2500"
"2019-05-31T00:00:00.000","Kent","MI","Passenger","0","1","1","21","22","4.545454545454545454545454545"
"2019-05-31T00:00:00.000","Saginaw","MI","Passenger","1","0","1","11","12","8.333333333333333333333333333"
"2019-05-31T00:00:00.000","Washtenaw","MI","Passenger","1","0","1","30","31","3.225806451612903225806451613"
"2019-05-31T00:00:00.000","Wayne","MI","Passenger","0","1","1","65","66","1.515151515151515151515151515"
"2019-05-31T00:00:00.000","Dakota","MN","Passenger","0","1","1","33","34","2.941176470588235294117647059"
"2019-05-31T00:00:00.000","Hennepin","MN","Passenger","2","0","2","100","102","1.960784313725490196078431373"
"2019-05-31T00:00:00.000","Kanabec","MN","Passenger","1","0","1","0","1","100"
"2019-05-31T00:00:00.000","Ramsey","MN","Passenger","1","0","1","42","43","2.325581395348837209302325581"
"2019-05-31T00:00:00.000","Cascade","MT","Passenger","0","1","1","59","60","1.666666666666666666666666667"
"2019-05-31T00:00:00.000","Flathead","MT","Passenger","1","0","1","57","58","1.724137931034482758620689655"
"2019-05-31T00:00:00.000","Gallatin","MT","Passenger","0","1","1","55","56","1.785714285714285714285714286"
"2019-05-31T00:00:00.000","Glacier","MT","Passenger","0","1","1","5","6","16.66666666666666666666666667"
"2019-05-31T00:00:00.000","Cumberland","NC","Passenger","0","2","2","522","524","0.3816793893129770992366412214"
"2019-05-31T00:00:00.000","Guilford","NC","Passenger","1","0","1","27","28","3.571428571428571428571428571"
"2019-05-31T00:00:00.000","Harnett","NC","Passenger","0","1","1","219","220","0.4545454545454545454545454545"
"2019-05-31T00:00:00.000","Mecklenburg","NC","Passenger","1","0","1","82","83","1.204819277108433734939759036"
"2019-05-31T00:00:00.000","Moore","NC","Passenger","0","1","1","190","191","0.5235602094240837696335078534"
"2019-05-31T00:00:00.000","Douglas","NE","Passenger","0","1","1","64","65","1.538461538461538461538461538"
"2019-05-31T00:00:00.000","Carroll","NH","Passenger","0","1","1","2","3","33.33333333333333333333333333"
"2019-05-31T00:00:00.000","Bergen","NJ","Passenger","1","0","1","28","29","3.448275862068965517241379310"
"2019-05-31T00:00:00.000","Camden","NJ","Passenger","0","1","1","22","23","4.347826086956521739130434783"
"2019-05-31T00:00:00.000","Chaves","NM","Passenger","1","0","1","6","7","14.28571428571428571428571429"
"2019-05-31T00:00:00.000","Santa Fe","NM","Passenger","0","1","1","37","38","2.631578947368421052631578947"
"2019-05-31T00:00:00.000","Valencia","NM","Passenger","1","0","1","6","7","14.28571428571428571428571429"
"2019-05-31T00:00:00.000","Carson City","NV","Passenger","1","0","1","13","14","7.142857142857142857142857143"
"2019-05-31T00:00:00.000","Clark","NV","Passenger","4","2","6","683","689","0.8708272859216255442670537010"
"2019-05-31T00:00:00.000","Washoe","NV","Passenger","2","0","2","97","99","2.020202020202020202020202020"
"2019-05-31T00:00:00.000","Jefferson","NY","Passenger","0","2","2","224","226","0.8849557522123893805309734513"
"2019-05-31T00:00:00.000","Nassau","NY","Passenger","2","0","2","36","38","5.263157894736842105263157895"
"2019-05-31T00:00:00.000","Saratoga","NY","Passenger","1","0","1","55","56","1.785714285714285714285714286"
"2019-05-31T00:00:00.000","Westchester","NY","Passenger","0","1","1","28","29","3.448275862068965517241379310"
"2019-05-31T00:00:00.000","Oklahoma","OK","Passenger","0","2","2","114","116","1.724137931034482758620689655"
"2019-05-31T00:00:00.000","Rogers","OK","Passenger","1","0","1","5","6","16.66666666666666666666666667"
"2019-05-31T00:00:00.000","Tulsa","OK","Passenger","1","1","2","42","44","4.545454545454545454545454545"
"2019-05-31T00:00:00.000","Clackamas","OR","Passenger","1","1","2","206","208","0.9615384615384615384615384615"
"2019-05-31T00:00:00.000","Deschutes","OR","Passenger","2","0","2","149","151","1.324503311258278145695364238"
"2019-05-31T00:00:00.000","Douglas","OR","Passenger","1","0","1","50","51","1.960784313725490196078431373"
"2019-05-31T00:00:00.000","Klamath","OR","Passenger","1","0","1","30","31","3.225806451612903225806451613"
"2019-05-31T00:00:00.000","Marion","OR","Passenger","1","0","1","111","112","0.8928571428571428571428571429"
"2019-05-31T00:00:00.000","Multnomah","OR","Passenger","5","4","9","716","725","1.241379310344827586206896552"
"2019-05-31T00:00:00.000","Allegheny","PA","Passenger","1","0","1","77","78","1.282051282051282051282051282"
"2019-05-31T00:00:00.000","Bucks","PA","Passenger","1","0","1","19","20","5.00"
"2019-05-31T00:00:00.000","Montgomery","PA","Passenger","2","0","2","31","33","6.060606060606060606060606061"
"2019-05-31T00:00:00.000","San Juan","PR","Passenger","0","1","1","3","4","25.00"
"2019-05-31T00:00:00.000","Newport","RI","Passenger","1","0","1","93","94","1.063829787234042553191489362"
"2019-05-31T00:00:00.000","Richland","SC","Passenger","0","1","1","160","161","0.6211180124223602484472049689"
"2019-05-31T00:00:00.000","Spartanburg","SC","Passenger","0","1","1","29","30","3.333333333333333333333333333"
"2019-05-31T00:00:00.000","Shelby","TN","Passenger","0","1","1","94","95","1.052631578947368421052631579"
"2019-05-31T00:00:00.000","Bell","TX","Passenger","0","1","1","447","448","0.2232142857142857142857142857"
"2019-05-31T00:00:00.000","Bexar","TX","Passenger","5","5","10","648","658","1.519756838905775075987841945"
"2019-05-31T00:00:00.000","Dallas","TX","Passenger","1","0","1","195","196","0.5102040816326530612244897959"
"2019-05-31T00:00:00.000","El Paso","TX","Passenger","2","0","2","481","483","0.4140786749482401656314699793"
"2019-05-31T00:00:00.000","Guadalupe","TX","Passenger","1","0","1","67","68","1.470588235294117647058823529"
"2019-05-31T00:00:00.000","Harris","TX","Passenger","0","1","1","238","239","0.4184100418410041841004184100"
"2019-05-31T00:00:00.000","Hidalgo","TX","Passenger","0","1","1","85","86","1.162790697674418604651162791"
"2019-05-31T00:00:00.000","Montgomery","TX","Passenger","2","0","2","53","55","3.636363636363636363636363636"
"2019-05-31T00:00:00.000","Nueces","TX","Passenger","1","1","2","97","99","2.020202020202020202020202020"
"2019-05-31T00:00:00.000","Tarrant","TX","Passenger","2","0","2","189","191","1.047120418848167539267015707"
"2019-05-31T00:00:00.000","Travis","TX","Passenger","2","1","3","187","190","1.578947368421052631578947368"
"2019-05-31T00:00:00.000","Albemarle","VA","Passenger","1","0","1","25","26","3.846153846153846153846153846"
"2019-05-31T00:00:00.000","Alexandria","VA","Passenger","3","0","3","145","148","2.027027027027027027027027027"
"2019-05-31T00:00:00.000","Arlington","VA","Passenger","1","2","3","158","161","1.863354037267080745341614907"
"2019-05-31T00:00:00.000","Fairfax","VA","Passenger","3","3","6","780","786","0.7633587786259541984732824427"
"2019-05-31T00:00:00.000","Goochland","VA","Passenger","1","1","2","237","239","0.8368200836820083682008368201"
"2019-05-31T00:00:00.000","Loudoun","VA","Passenger","1","0","1","92","93","1.075268817204301075268817204"
"2019-05-31T00:00:00.000","Manassas","VA","Passenger","0","1","1","8","9","11.11111111111111111111111111"
"2019-05-31T00:00:00.000","Norfolk","VA","Passenger","2","2","4","349","353","1.133144475920679886685552408"
"2019-05-31T00:00:00.000","Portsmouth","VA","Passenger","0","1","1","63","64","1.562500"
"2019-05-31T00:00:00.000","Prince William","VA","Passenger","1","4","5","246","251","1.992031872509960159362549801"
"2019-05-31T00:00:00.000","Virginia Beach","VA","Passenger","1","1","2","697","699","0.2861230329041487839771101574"
"2019-05-31T00:00:00.000","Adams","WA","Passenger","5","6","11","12715","12726","0.08643721515008643721515008644"
"2019-05-31T00:00:00.000","Adams","WA","Truck","0","0","0","5127","5127","0"
"2019-05-31T00:00:00.000","Asotin","WA","Passenger","13","9","22","12678","12700","0.1732283464566929133858267717"
"2019-05-31T00:00:00.000","Asotin","WA","Truck","0","0","0","6657","6657","0"
"2019-05-31T00:00:00.000","Benton","WA","Passenger","265","280","545","133646","134191","0.4061375204000268274325401853"
"2019-05-31T00:00:00.000","Benton","WA","Truck","0","0","0","41856","41856","0"
"2019-05-31T00:00:00.000","Chelan","WA","Passenger","154","68","222","54347","54569","0.4068243874727409334970404442"
"2019-05-31T00:00:00.000","Chelan","WA","Truck","0","0","0","22246","22246","0"
"2019-05-31T00:00:00.000","Clallam","WA","Passenger","177","143","320","50562","50882","0.6289060964584725443182264848"
"2019-05-31T00:00:00.000","Clallam","WA","Truck","0","0","0","21747","21747","0"
"2019-05-31T00:00:00.000","Clark","WA","Truck","0","0","0","80197","80197","0"
"2019-05-31T00:00:00.000","Clark","WA","Passenger","1569","949","2518","313183","315701","0.7975901248333074649747704315"
"2019-05-31T00:00:00.000","Columbia","WA","Passenger","2","2","4","2442","2446","0.1635322976287816843826655765"
"2019-05-31T00:00:00.000","Columbia","WA","Truck","0","0","0","1533","1533","0"
"2019-05-31T00:00:00.000","Cowlitz","WA","Passenger","106","122","228","72899","73127","0.3117863443051130225498106035"
"2019-05-31T00:00:00.000","Cowlitz","WA","Truck","0","0","0","28852","28852","0"
"2019-05-31T00:00:00.000","Douglas","WA","Truck","0","0","0","12182","12182","0"
"2019-05-31T00:00:00.000","Douglas","WA","Passenger","57","36","93","28012","28105","0.3309019747375911759473403309"
"2019-05-31T00:00:00.000","Ferry","WA","Truck","0","0","0","3589","3589","0"
"2019-05-31T00:00:00.000","Ferry","WA","Passenger","5","2","7","4382","4389","0.1594896331738437001594896332"
"2019-05-31T00:00:00.000","Franklin","WA","Passenger","61","72","133","59792","59925","0.2219440967876512307050479766"
"2019-05-31T00:00:00.000","Franklin","WA","Truck","0","0","0","19255","19255","0"
"2019-05-31T00:00:00.000","Garfield","WA","Truck","0","0","0","954","954","0"
"2019-05-31T00:00:00.000","Garfield","WA","Passenger","1","1","2","1294","1296","0.1543209876543209876543209877"
"2019-05-31T00:00:00.000","Grant","WA","Truck","0","0","0","26538","26538","0"
"2019-05-31T00:00:00.000","Grant","WA","Passenger","42","64","106","64575","64681","0.1638812015893384456022634158"
"2019-05-31T00:00:00.000","Grays Harbor","WA","Passenger","85","88","173","47835","48008","0.3603566072321279786702216297"
"2019-05-31T00:00:00.000","Grays Harbor","WA","Truck","0","0","0","20461","20461","0"
"2019-05-31T00:00:00.000","Island","WA","Truck","0","0","0","21250","21250","0"
"2019-05-31T00:00:00.000","Island","WA","Passenger","328","246","574","63365","63939","0.8977306495253288290401789205"
"2019-05-31T00:00:00.000","Jefferson","WA","Passenger","200","128","328","25004","25332","1.294804989736301910626875099"
"2019-05-31T00:00:00.000","Jefferson","WA","Truck","0","0","0","9671","9671","0"
"2019-05-31T00:00:00.000","King","WA","Truck","5","1","6","181997","182003","0.003296648956335884573331208826"
"2019-05-31T00:00:00.000","King","WA","Passenger","19006","7219","26225","1387286","1413511","1.855309226458089112854445420"
"2019-05-31T00:00:00.000","Kitsap","WA","Passenger","1107","610","1717","180686","182403","0.9413222370246103408386923461"
"2019-05-31T00:00:00.000","Kitsap","WA","Truck","1","0","1","54049","54050","0.001850138760407030527289546716"
"2019-05-31T00:00:00.000","Kittitas","WA","Passenger","75","36","111","29560","29671","0.3741026591621448552458629638"
"2019-05-31T00:00:00.000","Kittitas","WA","Truck","0","0","0","14377","14377","0"
"2019-05-31T00:00:00.000","Klickitat","WA","Passenger","39","34","73","15549","15622","0.4672897196261682242990654206"
"2019-05-31T00:00:00.000","Klickitat","WA","Truck","0","0","0","8239","8239","0"
"2019-05-31T00:00:00.000","Lewis","WA","Passenger","105","97","202","59024","59226","0.3410664235302063283017593624"
"2019-05-31T00:00:00.000","Lewis","WA","Truck","0","0","0","25917","25917","0"
"2019-05-31T00:00:00.000","Lincoln","WA","Truck","0","0","0","4694","4694","0"
"2019-05-31T00:00:00.000","Lincoln","WA","Passenger","5","9","14","7777","7791","0.1796945193171608265947888589"
"2019-05-31T00:00:00.000","Mason","WA","Truck","0","0","0","20362","20362","0"
"2019-05-31T00:00:00.000","Mason","WA","Passenger","141","125","266","47005","47271","0.5627128683548052717310824819"
"2019-05-31T00:00:00.000","Okanogan","WA","Passenger","22","23","45","26076","26121","0.1722751808889399333869300563"
"2019-05-31T00:00:00.000","Okanogan","WA","Truck","0","0","0","16511","16511","0"
"2019-05-31T00:00:00.000","Pacific","WA","Passenger","34","31","65","15944","16009","0.4060216128427759385345743020"
"2019-05-31T00:00:00.000","Pacific","WA","Truck","0","0","0","7663","7663","0"
"2019-05-31T00:00:00.000","Pend Oreille","WA","Truck","0","0","0","5740","5740","0"
"2019-05-31T00:00:00.000","Pend Oreille","WA","Passenger","5","5","10","9536","9546","0.1047559187094070815001047559"
"2019-05-31T00:00:00.000","Pierce","WA","Truck","0","0","0","139698","139698","0"
"2019-05-31T00:00:00.000","Pierce","WA","Passenger","1966","1617","3583","542021","545604","0.6567033966026642033416177301"
"2019-05-31T00:00:00.000","San Juan","WA","Passenger","208","73","281","14356","14637","1.919792307166769146683063469"
"2019-05-31T00:00:00.000","San Juan","WA","Truck","0","0","0","5853","5853","0"
"2019-05-31T00:00:00.000","Skagit","WA","Truck","1","0","1","32431","32432","0.003083374444992599901332017760"
"2019-05-31T00:00:00.000","Skagit","WA","Passenger","322","217","539","91683","92222","0.5844592396608184598035175988"
"2019-05-31T00:00:00.000","Skamania","WA","Passenger","25","17","42","8720","8762","0.4793426158411321616069390550"
"2019-05-31T00:00:00.000","Skamania","WA","Truck","0","0","0","4054","4054","0"
"2019-05-31T00:00:00.000","Snohomish","WA","Passenger","3518","1672","5190","530276","535466","0.9692492147027075481916685653"
"2019-05-31T00:00:00.000","Snohomish","WA","Truck","1","0","1","122105","122106","0.0008189605752379080471066122877"
"2019-05-31T00:00:00.000","Spokane","WA","Passenger","564","448","1012","310980","311992","0.3243672914690120259493833175"
"2019-05-31T00:00:00.000","Spokane","WA","Truck","1","0","1","94637","94638","0.001056658002071049684059257381"
"2019-05-31T00:00:00.000","Stevens","WA","Truck","0","0","0","18676","18676","0"
"2019-05-31T00:00:00.000","Stevens","WA","Passenger","23","32","55","31678","31733","0.1733211483313900356096177481"
"2019-05-31T00:00:00.000","Thurston","WA","Truck","0","0","0","55109","55109","0"
"2019-05-31T00:00:00.000","Thurston","WA","Passenger","929","670","1599","197146","198745","0.8045485421016880927822083574"
"2019-05-31T00:00:00.000","Wahkiakum","WA","Passenger","2","3","5","3017","3022","0.1654533421575115817339510258"
"2019-05-31T00:00:00.000","Wahkiakum","WA","Truck","0","0","0","1744","1744","0"
"2019-05-31T00:00:00.000","Walla Walla","WA","Passenger","47","58","105","36178","36283","0.2893917261527437091750957749"
"2019-05-31T00:00:00.000","Walla Walla","WA","Truck","0","0","0","13620","13620","0"
"2019-05-31T00:00:00.000","Whatcom","WA","Truck","2","0","2","42837","42839","0.004668643058894932187959569551"
"2019-05-31T00:00:00.000","Whatcom","WA","Passenger","889","429","1318","150438","151756","0.8684994333008250085663828778"
"2019-05-31T00:00:00.000","Whitman","WA","Passenger","32","49","81","22726","22807","0.3551541193493225764019818477"
"2019-05-31T00:00:00.000","Whitman","WA","Truck","0","0","0","8555","8555","0"
"2019-05-31T00:00:00.000","Yakima","WA","Truck","0","0","0","59087","59087","0"
"2019-05-31T00:00:00.000","Yakima","WA","Passenger","105","113","218","165021","165239","0.1319301133509643607138750537"
"2019-05-31T00:00:00.000","Ozaukee","WI","Passenger","0","1","1","3","4","25.00"
"2019-05-31T00:00:00.000",,,"Passenger","2","0","2","240","242","0.8264462809917355371900826446"
"2019-06-30T00:00:00.000","Juneau","AK","Passenger","0","2","2","29","31","6.451612903225806451612903226"
"2019-06-30T00:00:00.000","Dale","AL","Passenger","0","1","1","62","63","1.587301587301587301587301587"
"2019-06-30T00:00:00.000","Montgomery","AL","Passenger","0","1","1","41","42","2.380952380952380952380952381"
"2019-06-30T00:00:00.000","Cochise","AZ","Passenger","0","1","1","120","121","0.8264462809917355371900826446"
"2019-06-30T00:00:00.000","Maricopa","AZ","Passenger","7","4","11","1402","1413","0.7784854918612880396319886766"
"2019-06-30T00:00:00.000","Pima","AZ","Passenger","0","1","1","379","380","0.2631578947368421052631578947"
"2019-06-30T00:00:00.000","Pinal","AZ","Passenger","2","0","2","173","175","1.142857142857142857142857143"
"2019-06-30T00:00:00.000","Alameda","CA","Passenger","4","2","6","298","304","1.973684210526315789473684211"
"2019-06-30T00:00:00.000","Contra Costa","CA","Passenger","2","2","4","416","420","0.9523809523809523809523809524"
"2019-06-30T00:00:00.000","Fresno","CA","Passenger","1","0","1","188","189","0.5291005291005291005291005291"
"2019-06-30T00:00:00.000","Kern","CA","Passenger","0","1","1","228","229","0.4366812227074235807860262009"
"2019-06-30T00:00:00.000","Los Angeles","CA","Passenger","9","5","14","1072","1086","1.289134438305709023941068140"
"2019-06-30T00:00:00.000","Orange","CA","Passenger","5","1","6","522","528","1.136363636363636363636363636"
"2019-06-30T00:00:00.000","Riverside","CA","Passenger","1","2","3","629","632","0.4746835443037974683544303797"
"2019-06-30T00:00:00.000","San Diego","CA","Passenger","10","3","13","2718","2731","0.4760161113145367997070670084"
"2019-06-30T00:00:00.000","San Francisco","CA","Passenger","2","1","3","99","102","2.941176470588235294117647059"
"2019-06-30T00:00:00.000","San Mateo","CA","Passenger","2","1","3","113","116","2.586206896551724137931034483"
"2019-06-30T00:00:00.000","Santa Barbara","CA","Passenger","2","0","2","93","95","2.105263157894736842105263158"
"2019-06-30T00:00:00.000","Santa Clara","CA","Passenger","4","2","6","350","356","1.685393258426966292134831461"
"2019-06-30T00:00:00.000","Santa Cruz","CA","Passenger","1","0","1","40","41","2.439024390243902439024390244"
"2019-06-30T00:00:00.000","Shasta","CA","Passenger","1","0","1","42","43","2.325581395348837209302325581"
"2019-06-30T00:00:00.000","Solano","CA","Passenger","1","0","1","216","217","0.4608294930875576036866359447"
"2019-06-30T00:00:00.000","Tuolumne","CA","Passenger","0","1","1","10","11","9.090909090909090909090909091"
"2019-06-30T00:00:00.000","Ventura","CA","Passenger","0","2","2","316","318","0.6289308176100628930817610063"
"2019-06-30T00:00:00.000","Denver","CO","Passenger","1","0","1","129","130","0.7692307692307692307692307692"
"2019-06-30T00:00:00.000","El Paso","CO","Passenger","2","1","3","716","719","0.4172461752433936022253129346"
"2019-06-30T00:00:00.000","Jefferson","CO","Passenger","0","2","2","60","62","3.225806451612903225806451613"
"2019-06-30T00:00:00.000","Larimer","CO","Passenger","1","1","2","55","57","3.508771929824561403508771930"
"2019-06-30T00:00:00.000","New London","CT","Passenger","0","2","2","259","261","0.7662835249042145593869731801"
"2019-06-30T00:00:00.000","District of Columbia","DC","Passenger","1","3","4","203","207","1.932367149758454106280193237"
"2019-06-30T00:00:00.000","Kent","DE","Passenger","0","1","1","75","76","1.315789473684210526315789474"
"2019-06-30T00:00:00.000","New Castle","DE","Passenger","1","0","1","23","24","4.166666666666666666666666667"
"2019-06-30T00:00:00.000","Brevard","FL","Passenger","0","1","1","78","79","1.265822784810126582278481013"
"2019-06-30T00:00:00.000","Broward","FL","Passenger","1","1","2","122","124","1.612903225806451612903225806"
"2019-06-30T00:00:00.000","Clay","FL","Passenger","0","1","1","85","86","1.162790697674418604651162791"
"2019-06-30T00:00:00.000","Duval","FL","Passenger","1","1","2","368","370","0.5405405405405405405405405405"
"2019-06-30T00:00:00.000","Lake","FL","Passenger","1","0","1","15","16","6.2500"
"2019-06-30T00:00:00.000","Manatee","FL","Passenger","1","0","1","31","32","3.12500"
"2019-06-30T00:00:00.000","Palm Beach","FL","Passenger","0","1","1","74","75","1.333333333333333333333333333"
"2019-06-30T00:00:00.000","Pinellas","FL","Passenger","1","0","1","101","102","0.9803921568627450980392156863"
"2019-06-30T00:00:00.000","Polk","FL","Passenger","1","0","1","69","70","1.428571428571428571428571429"
"2019-06-30T00:00:00.000","Santa Rosa","FL","Passenger","1","0","1","92","93","1.075268817204301075268817204"
"2019-06-30T00:00:00.000","Sarasota","FL","Passenger","1","0","1","25","26","3.846153846153846153846153846"
"2019-06-30T00:00:00.000","Sumter","FL","Passenger","0","1","1","10","11","9.090909090909090909090909091"
"2019-06-30T00:00:00.000","Volusia","FL","Passenger","0","1","1","35","36","2.777777777777777777777777778"
"2019-06-30T00:00:00.000","Bryan","GA","Passenger","1","0","1","52","53","1.886792452830188679245283019"
"2019-06-30T00:00:00.000","Camden","GA","Passenger","0","1","1","161","162","0.6172839506172839506172839506"
"2019-06-30T00:00:00.000","Columbia","GA","Passenger","1","1","2","143","145","1.379310344827586206896551724"
"2019-06-30T00:00:00.000","DeKalb","GA","Passenger","1","0","1","75","76","1.315789473684210526315789474"
"2019-06-30T00:00:00.000","Fulton","GA","Passenger","1","2","3","103","106","2.830188679245283018867924528"
"2019-06-30T00:00:00.000","Houston","GA","Passenger","1","0","1","56","57","1.754385964912280701754385965"
"2019-06-30T00:00:00.000","Liberty","GA","Passenger","1","0","1","126","127","0.7874015748031496062992125984"
"2019-06-30T00:00:00.000","Honolulu","HI","Passenger","3","2","5","490","495","1.010101010101010101010101010"
"2019-06-30T00:00:00.000","Maui","HI","Passenger","1","0","1","42","43","2.325581395348837209302325581"
"2019-06-30T00:00:00.000","Ada","ID","Passenger","0","2","2","295","297","0.6734006734006734006734006734"
"2019-06-30T00:00:00.000","Kootenai","ID","Passenger","1","1","2","205","207","0.9661835748792270531400966184"
"2019-06-30T00:00:00.000","Twin Falls","ID","Passenger","0","1","1","21","22","4.545454545454545454545454545"
"2019-06-30T00:00:00.000","Cook","IL","Passenger","1","0","1","227","228","0.4385964912280701754385964912"
"2019-06-30T00:00:00.000","DuPage","IL","Passenger","2","0","2","56","58","3.448275862068965517241379310"
"2019-06-30T00:00:00.000","Monroe","IL","Passenger","1","0","1","4","5","20.0"
"2019-06-30T00:00:00.000","Sangamon","IL","Passenger","1","0","1","7","8","12.500"
"2019-06-30T00:00:00.000","St. Clair","IL","Passenger","0","1","1","162","163","0.6134969325153374233128834356"
"2019-06-30T00:00:00.000","DeKalb","IN","Passenger","1","0","1","1","2","50.0"
"2019-06-30T00:00:00.000","Vigo","IN","Passenger","1","0","1","5","6","16.66666666666666666666666667"
"2019-06-30T00:00:00.000","Sedgwick","KS","Passenger","1","0","1","100","101","0.9900990099009900990099009901"
"2019-06-30T00:00:00.000","Oldham","KY","Passenger","0","1","1","5","6","16.66666666666666666666666667"
"2019-06-30T00:00:00.000","Caddo","LA","Passenger","0","1","1","23","24","4.166666666666666666666666667"
"2019-06-30T00:00:00.000","Berkshire","MA","Passenger","0","1","1","5","6","16.66666666666666666666666667"
"2019-06-30T00:00:00.000","Franklin","MA","Passenger","0","1","1","1","2","50.0"
"2019-06-30T00:00:00.000","Middlesex","MA","Passenger","1","1","2","114","116","1.724137931034482758620689655"
"2019-06-30T00:00:00.000","Nantucket","MA","Passenger","1","0","1","1","2","50.0"
"2019-06-30T00:00:00.000","Norfolk","MA","Passenger","1","0","1","30","31","3.225806451612903225806451613"
"2019-06-30T00:00:00.000","Suffolk","MA","Passenger","0","1","1","42","43","2.325581395348837209302325581"
"2019-06-30T00:00:00.000","Anne Arundel","MD","Passenger","1","2","3","443","446","0.6726457399103139013452914798"
"2019-06-30T00:00:00.000","Calvert","MD","Passenger","0","2","2","87","89","2.247191011235955056179775281"
"2019-06-30T00:00:00.000","Charles","MD","Passenger","0","1","1","85","86","1.162790697674418604651162791"
"2019-06-30T00:00:00.000","Frederick","MD","Passenger","2","1","3","82","85","3.529411764705882352941176471"
"2019-06-30T00:00:00.000","Howard","MD","Passenger","0","1","1","75","76","1.315789473684210526315789474"
"2019-06-30T00:00:00.000","Montgomery","MD","Passenger","1","2","3","284","287","1.045296167247386759581881533"
"2019-06-30T00:00:00.000","St. Mary's","MD","Passenger","1","0","1","207","208","0.4807692307692307692307692308"
"2019-06-30T00:00:00.000","Penobscot","ME","Passenger","0","1","1","14","15","6.666666666666666666666666667"
"2019-06-30T00:00:00.000","Kent","MI","Passenger","0","1","1","21","22","4.545454545454545454545454545"
"2019-06-30T00:00:00.000","Saginaw","MI","Passenger","1","0","1","12","13","7.692307692307692307692307692"
"2019-06-30T00:00:00.000","Washtenaw","MI","Passenger","1","0","1","33","34","2.941176470588235294117647059"
"2019-06-30T00:00:00.000","Wayne","MI","Passenger","0","1","1","64","65","1.538461538461538461538461538"
"2019-06-30T00:00:00.000","Hennepin","MN","Passenger","2","1","3","99","102","2.941176470588235294117647059"
"2019-06-30T00:00:00.000","Kanabec","MN","Passenger","1","0","1","0","1","100"
"2019-06-30T00:00:00.000","Ramsey","MN","Passenger","1","0","1","41","42","2.380952380952380952380952381"
"2019-06-30T00:00:00.000","Cascade","MT","Passenger","0","1","1","61","62","1.612903225806451612903225806"
"2019-06-30T00:00:00.000","Flathead","MT","Passenger","1","0","1","58","59","1.694915254237288135593220339"
"2019-06-30T00:00:00.000","Glacier","MT","Passenger","0","1","1","5","6","16.66666666666666666666666667"
"2019-06-30T00:00:00.000","Cumberland","NC","Passenger","0","2","2","521","523","0.3824091778202676864244741874"
"2019-06-30T00:00:00.000","Guilford","NC","Passenger","1","0","1","28","29","3.448275862068965517241379310"
"2019-06-30T00:00:00.000","Harnett","NC","Passenger","0","1","1","219","220","0.4545454545454545454545454545"
"2019-06-30T00:00:00.000","Mecklenburg","NC","Passenger","1","0","1","85","86","1.162790697674418604651162791"
"2019-06-30T00:00:00.000","Moore","NC","Passenger","0","1","1","189","190","0.5263157894736842105263157895"
"2019-06-30T00:00:00.000","Douglas","NE","Passenger","0","1","1","63","64","1.562500"
"2019-06-30T00:00:00.000","Carroll","NH","Passenger","0","1","1","2","3","33.33333333333333333333333333"
"2019-06-30T00:00:00.000","Bergen","NJ","Passenger","1","0","1","28","29","3.448275862068965517241379310"
"2019-06-30T00:00:00.000","Camden","NJ","Passenger","0","1","1","23","24","4.166666666666666666666666667"
"2019-06-30T00:00:00.000","Chaves","NM","Passenger","1","0","1","7","8","12.500"
"2019-06-30T00:00:00.000","Santa Fe","NM","Passenger","0","1","1","36","37","2.702702702702702702702702703"
"2019-06-30T00:00:00.000","Valencia","NM","Passenger","1","0","1","6","7","14.28571428571428571428571429"
"2019-06-30T00:00:00.000","Carson City","NV","Passenger","1","0","1","11","12","8.333333333333333333333333333"
"2019-06-30T00:00:00.000","Clark","NV","Passenger","4","2","6","685","691","0.8683068017366136034732272069"
"2019-06-30T00:00:00.000","Washoe","NV","Passenger","2","0","2","99","101","1.980198019801980198019801980"
"2019-06-30T00:00:00.000","Jefferson","NY","Passenger","0","2","2","222","224","0.8928571428571428571428571429"
"2019-06-30T00:00:00.000","Nassau","NY","Passenger","2","0","2","36","38","5.263157894736842105263157895"
"2019-06-30T00:00:00.000","Saratoga","NY","Passenger","1","0","1","53","54","1.851851851851851851851851852"
"2019-06-30T00:00:00.000","Westchester","NY","Passenger","0","1","1","28","29","3.448275862068965517241379310"
"2019-06-30T00:00:00.000","Shelby","OH","Passenger","0","1","1","1","2","50.0"
"2019-06-30T00:00:00.000","Oklahoma","OK","Passenger","0","2","2","118","120","1.666666666666666666666666667"
"2019-06-30T00:00:00.000","Rogers","OK","Passenger","1","0","1","5","6","16.66666666666666666666666667"
"2019-06-30T00:00:00.000","Tulsa","OK","Passenger","1","1","2","43","45","4.444444444444444444444444444"
"2019-06-30T00:00:00.000","Clackamas","OR","Passenger","1","1","2","206","208","0.9615384615384615384615384615"
"2019-06-30T00:00:00.000","Deschutes","OR","Passenger","2","0","2","147","149","1.342281879194630872483221477"
"2019-06-30T00:00:00.000","Douglas","OR","Passenger","1","0","1","50","51","1.960784313725490196078431373"
"2019-06-30T00:00:00.000","Klamath","OR","Passenger","1","0","1","30","31","3.225806451612903225806451613"
"2019-06-30T00:00:00.000","Marion","OR","Passenger","1","0","1","114","115","0.8695652173913043478260869565"
"2019-06-30T00:00:00.000","Multnomah","OR","Passenger","5","4","9","704","713","1.262272089761570827489481066"
"2019-06-30T00:00:00.000","Allegheny","PA","Passenger","1","0","1","72","73","1.369863013698630136986301370"
"2019-06-30T00:00:00.000","Bucks","PA","Passenger","1","0","1","20","21","4.761904761904761904761904762"
"2019-06-30T00:00:00.000","Montgomery","PA","Passenger","2","0","2","31","33","6.060606060606060606060606061"
"2019-06-30T00:00:00.000","RÃ­o Grande","PR","Passenger","1","0","1","1","2","50.0"
"2019-06-30T00:00:00.000","Newport","RI","Passenger","1","0","1","90","91","1.098901098901098901098901099"
"2019-06-30T00:00:00.000","Richland","SC","Passenger","0","1","1","160","161","0.6211180124223602484472049689"
"2019-06-30T00:00:00.000","Spartanburg","SC","Passenger","0","1","1","30","31","3.225806451612903225806451613"
"2019-06-30T00:00:00.000","Putnam","TN","Passenger","0","1","1","2","3","33.33333333333333333333333333"
"2019-06-30T00:00:00.000","Shelby","TN","Passenger","0","1","1","93","94","1.063829787234042553191489362"
"2019-06-30T00:00:00.000","Bell","TX","Passenger","0","1","1","446","447","0.2237136465324384787472035794"
"2019-06-30T00:00:00.000","Bexar","TX","Passenger","5","5","10","640","650","1.538461538461538461538461538"
"2019-06-30T00:00:00.000","Dallas","TX","Passenger","1","0","1","194","195","0.5128205128205128205128205128"
"2019-06-30T00:00:00.000","El Paso","TX","Passenger","2","0","2","482","484","0.4132231404958677685950413223"
"2019-06-30T00:00:00.000","Guadalupe","TX","Passenger","1","0","1","65","66","1.515151515151515151515151515"
"2019-06-30T00:00:00.000","Harris","TX","Passenger","1","1","2","239","241","0.8298755186721991701244813278"
"2019-06-30T00:00:00.000","Hidalgo","TX","Passenger","0","1","1","83","84","1.190476190476190476190476190"
"2019-06-30T00:00:00.000","Montgomery","TX","Passenger","2","0","2","55","57","3.508771929824561403508771930"
"2019-06-30T00:00:00.000","Nueces","TX","Passenger","1","1","2","98","100","2.00"
"2019-06-30T00:00:00.000","Tarrant","TX","Passenger","2","0","2","187","189","1.058201058201058201058201058"
"2019-06-30T00:00:00.000","Travis","TX","Passenger","2","1","3","183","186","1.612903225806451612903225806"
"2019-06-30T00:00:00.000","Albemarle","VA","Passenger","1","0","1","24","25","4.00"
"2019-06-30T00:00:00.000","Alexandria","VA","Passenger","3","0","3","145","148","2.027027027027027027027027027"
"2019-06-30T00:00:00.000","Arlington","VA","Passenger","0","2","2","157","159","1.257861635220125786163522013"
"2019-06-30T00:00:00.000","Fairfax","VA","Passenger","3","3","6","772","778","0.7712082262210796915167095116"
"2019-06-30T00:00:00.000","Goochland","VA","Passenger","1","1","2","236","238","0.8403361344537815126050420168"
"2019-06-30T00:00:00.000","Loudoun","VA","Passenger","1","0","1","92","93","1.075268817204301075268817204"
"2019-06-30T00:00:00.000","Manassas","VA","Passenger","0","1","1","8","9","11.11111111111111111111111111"
"2019-06-30T00:00:00.000","Norfolk","VA","Passenger","2","1","3","350","353","0.8498583569405099150141643059"
"2019-06-30T00:00:00.000","Portsmouth","VA","Passenger","0","1","1","64","65","1.538461538461538461538461538"
"2019-06-30T00:00:00.000","Prince William","VA","Passenger","1","3","4","244","248","1.612903225806451612903225806"
"2019-06-30T00:00:00.000","Virginia Beach","VA","Passenger","1","0","1","698","699","0.1430615164520743919885550787"
"2019-06-30T00:00:00.000","Adams","WA","Truck","0","0","0","5127","5127","0"
"2019-06-30T00:00:00.000","Adams","WA","Passenger","5","6","11","12758","12769","0.08614613517111755031717440677"
"2019-06-30T00:00:00.000","Asotin","WA","Passenger","13","9","22","12643","12665","0.1737070667193051717331227793"
"2019-06-30T00:00:00.000","Asotin","WA","Truck","0","0","0","6672","6672","0"
"2019-06-30T00:00:00.000","Benton","WA","Truck","0","0","0","41919","41919","0"
"2019-06-30T00:00:00.000","Benton","WA","Passenger","271","288","559","133812","134371","0.4160123836244427741104851493"
"2019-06-30T00:00:00.000","Chelan","WA","Truck","0","0","0","22287","22287","0"
"2019-06-30T00:00:00.000","Chelan","WA","Passenger","158","69","227","54364","54591","0.4158194574197211994651132971"
"2019-06-30T00:00:00.000","Clallam","WA","Passenger","184","147","331","50494","50825","0.6512543039842597147073290703"
"2019-06-30T00:00:00.000","Clallam","WA","Truck","1","0","1","21740","21741","0.004599604434018674394002115818"
"2019-06-30T00:00:00.000","Clark","WA","Truck","0","0","0","80342","80342","0"
"2019-06-30T00:00:00.000","Clark","WA","Passenger","1632","965","2597","313780","316377","0.8208561305025333699984512148"
"2019-06-30T00:00:00.000","Columbia","WA","Passenger","2","2","4","2449","2453","0.1630656339176518548715858133"
"2019-06-30T00:00:00.000","Columbia","WA","Truck","0","0","0","1533","1533","0"
"2019-06-30T00:00:00.000","Cowlitz","WA","Passenger","109","122","231","73006","73237","0.3154143397463030981607657332"
"2019-06-30T00:00:00.000","Cowlitz","WA","Truck","0","0","0","28876","28876","0"
"2019-06-30T00:00:00.000","Douglas","WA","Passenger","58","37","95","28039","28134","0.3376697234662685718347906448"
"2019-06-30T00:00:00.000","Douglas","WA","Truck","0","0","0","12184","12184","0"
"2019-06-30T00:00:00.000","Ferry","WA","Truck","0","0","0","3570","3570","0"
"2019-06-30T00:00:00.000","Ferry","WA","Passenger","5","2","7","4389","4396","0.1592356687898089171974522293"
"2019-06-30T00:00:00.000","Franklin","WA","Passenger","59","73","132","59917","60049","0.2198204799413812053489650119"
"2019-06-30T00:00:00.000","Franklin","WA","Truck","0","0","0","19275","19275","0"
"2019-06-30T00:00:00.000","Garfield","WA","Truck","0","0","0","964","964","0"
"2019-06-30T00:00:00.000","Garfield","WA","Passenger","1","1","2","1299","1301","0.1537279016141429669485011530"
"2019-06-30T00:00:00.000","Grant","WA","Passenger","44","66","110","64718","64828","0.1696797680014808416116492873"
"2019-06-30T00:00:00.000","Grant","WA","Truck","0","0","0","26638","26638","0"
"2019-06-30T00:00:00.000","Grays Harbor","WA","Passenger","85","89","174","47921","48095","0.3617839692275704335169976089"
"2019-06-30T00:00:00.000","Grays Harbor","WA","Truck","0","0","0","20459","20459","0"
"2019-06-30T00:00:00.000","Island","WA","Passenger","330","251","581","63407","63988","0.9079827467650184409576795649"
"2019-06-30T00:00:00.000","Island","WA","Truck","0","0","0","21269","21269","0"
"2019-06-30T00:00:00.000","Jefferson","WA","Passenger","206","129","335","24998","25333","1.322385820866064027158252082"
"2019-06-30T00:00:00.000","Jefferson","WA","Truck","0","0","0","9670","9670","0"
"2019-06-30T00:00:00.000","King","WA","Truck","5","1","6","182132","182138","0.003294205492538624559400015373"
"2019-06-30T00:00:00.000","King","WA","Passenger","19471","7282","26753","1389202","1415955","1.889396202562934556536048109"
"2019-06-30T00:00:00.000","Kitsap","WA","Truck","1","0","1","54129","54130","0.001847404396822464437465361168"
"2019-06-30T00:00:00.000","Kitsap","WA","Passenger","1121","629","1750","180816","182566","0.9585574531950089282779926164"
"2019-06-30T00:00:00.000","Kittitas","WA","Passenger","84","39","123","29611","29734","0.4136678549808300262325956817"
"2019-06-30T00:00:00.000","Kittitas","WA","Truck","0","0","0","14422","14422","0"
"2019-06-30T00:00:00.000","Klickitat","WA","Passenger","39","33","72","15556","15628","0.4607115433836703352956232403"
"2019-06-30T00:00:00.000","Klickitat","WA","Truck","0","0","0","8253","8253","0"
"2019-06-30T00:00:00.000","Lewis","WA","Truck","0","0","0","25957","25957","0"
"2019-06-30T00:00:00.000","Lewis","WA","Passenger","107","96","203","59113","59316","0.3422348101692629307438127992"
"2019-06-30T00:00:00.000","Lincoln","WA","Passenger","4","9","13","7781","7794","0.1667949704901206055940467026"
"2019-06-30T00:00:00.000","Lincoln","WA","Truck","0","0","0","4675","4675","0"
"2019-06-30T00:00:00.000","Mason","WA","Passenger","145","126","271","47181","47452","0.5711034308353704796425861924"
"2019-06-30T00:00:00.000","Mason","WA","Truck","0","0","0","20359","20359","0"
"2019-06-30T00:00:00.000","Okanogan","WA","Passenger","23","25","48","26081","26129","0.1837039304986796279995407402"
"2019-06-30T00:00:00.000","Okanogan","WA","Truck","0","0","0","16487","16487","0"
"2019-06-30T00:00:00.000","Pacific","WA","Passenger","35","32","67","15967","16034","0.4178620431582886366471248597"
"2019-06-30T00:00:00.000","Pacific","WA","Truck","0","0","0","7656","7656","0"
"2019-06-30T00:00:00.000","Pend Oreille","WA","Passenger","5","5","10","9532","9542","0.1047998323202682875707398868"
"2019-06-30T00:00:00.000","Pend Oreille","WA","Truck","0","0","0","5729","5729","0"
"2019-06-30T00:00:00.000","Pierce","WA","Passenger","2024","1657","3681","543044","546725","0.6732818144405322602771045773"
"2019-06-30T00:00:00.000","Pierce","WA","Truck","0","0","0","139852","139852","0"
"2019-06-30T00:00:00.000","San Juan","WA","Passenger","213","74","287","14409","14696","1.952912357103973870440936309"
"2019-06-30T00:00:00.000","San Juan","WA","Truck","0","0","0","5870","5870","0"
"2019-06-30T00:00:00.000","Skagit","WA","Passenger","329","217","546","91924","92470","0.5904617713853141559424678274"
"2019-06-30T00:00:00.000","Skagit","WA","Truck","1","0","1","32456","32457","0.003080999476230089040884863050"
"2019-06-30T00:00:00.000","Skamania","WA","Passenger","25","18","43","8726","8769","0.4903637815030220093511232752"
"2019-06-30T00:00:00.000","Skamania","WA","Truck","0","0","0","4064","4064","0"
"2019-06-30T00:00:00.000","Snohomish","WA","Truck","0","0","0","122407","122407","0"
"2019-06-30T00:00:00.000","Snohomish","WA","Passenger","3619","1693","5312","531449","536761","0.9896397092933353950827276944"
"2019-06-30T00:00:00.000","Spokane","WA","Truck","1","0","1","94892","94893","0.001053818511375970830303605113"
"2019-06-30T00:00:00.000","Spokane","WA","Passenger","575","460","1035","311852","312887","0.3307903492315116959157779006"
"2019-06-30T00:00:00.000","Stevens","WA","Truck","0","0","0","18660","18660","0"
"2019-06-30T00:00:00.000","Stevens","WA","Passenger","22","34","56","31691","31747","0.1763946199640910952215957413"
"2019-06-30T00:00:00.000","Thurston","WA","Passenger","962","681","1643","197709","199352","0.8241703118102652594405875035"
"2019-06-30T00:00:00.000","Thurston","WA","Truck","0","0","0","55150","55150","0"
"2019-06-30T00:00:00.000","Wahkiakum","WA","Truck","0","0","0","1756","1756","0"
"2019-06-30T00:00:00.000","Wahkiakum","WA","Passenger","2","3","5","3009","3014","0.1658925016589250165892501659"
"2019-06-30T00:00:00.000","Walla Walla","WA","Truck","0","0","0","13600","13600","0"
"2019-06-30T00:00:00.000","Walla Walla","WA","Passenger","50","62","112","36202","36314","0.3084209946577077711075618219"
"2019-06-30T00:00:00.000","Whatcom","WA","Passenger","906","444","1350","150705","152055","0.8878366380585972181118674164"
"2019-06-30T00:00:00.000","Whatcom","WA","Truck","2","0","2","42924","42926","0.004659180915994968084610725434"
"2019-06-30T00:00:00.000","Whitman","WA","Truck","0","0","0","8590","8590","0"
"2019-06-30T00:00:00.000","Whitman","WA","Passenger","32","50","82","22729","22811","0.3594756915523212485204506598"
"2019-06-30T00:00:00.000","Yakima","WA","Passenger","116","113","229","165158","165387","0.1384631198340861131769727971"
"2019-06-30T00:00:00.000","Yakima","WA","Truck","0","0","0","59142","59142","0"
"2019-06-30T00:00:00.000","Ozaukee","WI","Passenger","0","1","1","3","4","25.00"
"2019-06-30T00:00:00.000",,,"Passenger","2","0","2","239","241","0.8298755186721991701244813278"
"2019-07-31T00:00:00.000","Fairbanks North Star","AK","Passenger","0","1","1","98","99","1.010101010101010101010101010"
"2019-07-31T00:00:00.000","Juneau","AK","Passenger","0","2","2","30","32","6.2500"
"2019-07-31T00:00:00.000","Dale","AL","Passenger","0","1","1","62","63","1.587301587301587301587301587"
"2019-07-31T00:00:00.000","Montgomery","AL","Passenger","0","1","1","41","42","2.380952380952380952380952381"
"2019-07-31T00:00:00.000","Cochise","AZ","Passenger","0","1","1","118","119","0.8403361344537815126050420168"
"2019-07-31T00:00:00.000","Maricopa","AZ","Passenger","8","5","13","1402","1415","0.9187279151943462897526501767"
"2019-07-31T00:00:00.000","Pima","AZ","Passenger","0","1","1","378","379","0.2638522427440633245382585752"
"2019-07-31T00:00:00.000","Pinal","AZ","Passenger","2","0","2","169","171","1.169590643274853801169590643"
"2019-07-31T00:00:00.000","Alameda","CA","Passenger","4","2","6","293","299","2.006688963210702341137123746"
"2019-07-31T00:00:00.000","Contra Costa","CA","Passenger","2","2","4","410","414","0.9661835748792270531400966184"
"2019-07-31T00:00:00.000","Fresno","CA","Passenger","1","0","1","192","193","0.5181347150259067357512953368"
"2019-07-31T00:00:00.000","Kern","CA","Passenger","0","1","1","224","225","0.4444444444444444444444444444"
"2019-07-31T00:00:00.000","Los Angeles","CA","Passenger","9","5","14","1083","1097","1.276207839562443026435733820"
"2019-07-31T00:00:00.000","Orange","CA","Passenger","5","1","6","514","520","1.153846153846153846153846154"
"2019-07-31T00:00:00.000","Riverside","CA","Passenger","2","2","4","630","634","0.6309148264984227129337539432"
"2019-07-31T00:00:00.000","San Diego","CA","Passenger","10","4","14","2762","2776","0.5043227665706051873198847262"
"2019-07-31T00:00:00.000","San Francisco","CA","Passenger","2","1","3","99","102","2.941176470588235294117647059"
"2019-07-31T00:00:00.000","San Mateo","CA","Passenger","2","1","3","115","118","2.542372881355932203389830508"
"2019-07-31T00:00:00.000","Santa Barbara","CA","Passenger","2","0","2","93","95","2.105263157894736842105263158"
"2019-07-31T00:00:00.000","Santa Clara","CA","Passenger","3","2","5","352","357","1.400560224089635854341736695"
"2019-07-31T00:00:00.000","Santa Cruz","CA","Passenger","1","0","1","38","39","2.564102564102564102564102564"
"2019-07-31T00:00:00.000","Shasta","CA","Passenger","1","0","1","40","41","2.439024390243902439024390244"
"2019-07-31T00:00:00.000","Solano","CA","Passenger","1","0","1","220","221","0.4524886877828054298642533937"
"2019-07-31T00:00:00.000","Tuolumne","CA","Passenger","0","1","1","10","11","9.090909090909090909090909091"
"2019-07-31T00:00:00.000","Ventura","CA","Passenger","0","2","2","314","316","0.6329113924050632911392405063"
"2019-07-31T00:00:00.000","Denver","CO","Passenger","1","0","1","124","125","0.800"
"2019-07-31T00:00:00.000","El Paso","CO","Passenger","2","1","3","721","724","0.4143646408839779005524861878"
"2019-07-31T00:00:00.000","Jefferson","CO","Passenger","0","2","2","60","62","3.225806451612903225806451613"
"2019-07-31T00:00:00.000","Larimer","CO","Passenger","1","1","2","54","56","3.571428571428571428571428571"
"2019-07-31T00:00:00.000","New London","CT","Passenger","0","2","2","262","264","0.7575757575757575757575757576"
"2019-07-31T00:00:00.000","District of Columbia","DC","Passenger","1","3","4","208","212","1.886792452830188679245283019"
"2019-07-31T00:00:00.000","Kent","DE","Passenger","0","1","1","75","76","1.315789473684210526315789474"
"2019-07-31T00:00:00.000","New Castle","DE","Passenger","1","0","1","23","24","4.166666666666666666666666667"
"2019-07-31T00:00:00.000","Brevard","FL","Passenger","0","1","1","76","77","1.298701298701298701298701299"
"2019-07-31T00:00:00.000","Broward","FL","Passenger","1","1","2","123","125","1.600"
"2019-07-31T00:00:00.000","Clay","FL","Passenger","0","1","1","84","85","1.176470588235294117647058824"
"2019-07-31T00:00:00.000","Duval","FL","Passenger","1","1","2","366","368","0.5434782608695652173913043478"
"2019-07-31T00:00:00.000","Lake","FL","Passenger","1","0","1","15","16","6.2500"
"2019-07-31T00:00:00.000","Manatee","FL","Passenger","1","0","1","30","31","3.225806451612903225806451613"
"2019-07-31T00:00:00.000","Osceola","FL","Passenger","1","0","1","39","40","2.500"
"2019-07-31T00:00:00.000","Palm Beach","FL","Passenger","0","1","1","74","75","1.333333333333333333333333333"
"2019-07-31T00:00:00.000","Pinellas","FL","Passenger","1","0","1","101","102","0.9803921568627450980392156863"
"2019-07-31T00:00:00.000","Polk","FL","Passenger","1","0","1","68","69","1.449275362318840579710144928"
"2019-07-31T00:00:00.000","Santa Rosa","FL","Passenger","1","0","1","94","95","1.052631578947368421052631579"
"2019-07-31T00:00:00.000","Sarasota","FL","Passenger","1","0","1","25","26","3.846153846153846153846153846"
"2019-07-31T00:00:00.000","Sumter","FL","Passenger","0","1","1","10","11","9.090909090909090909090909091"
"2019-07-31T00:00:00.000","Volusia","FL","Passenger","0","1","1","35","36","2.777777777777777777777777778"
"2019-07-31T00:00:00.000","Bryan","GA","Passenger","1","0","1","51","52","1.923076923076923076923076923"
"2019-07-31T00:00:00.000","Camden","GA","Passenger","0","1","1","158","159","0.6289308176100628930817610063"
"2019-07-31T00:00:00.000","Columbia","GA","Passenger","1","1","2","142","144","1.388888888888888888888888889"
"2019-07-31T00:00:00.000","DeKalb","GA","Passenger","1","0","1","73","74","1.351351351351351351351351351"
"2019-07-31T00:00:00.000","Fulton","GA","Passenger","0","2","2","100","102","1.960784313725490196078431373"
"2019-07-31T00:00:00.000","Houston","GA","Passenger","1","0","1","56","57","1.754385964912280701754385965"
"2019-07-31T00:00:00.000","Liberty","GA","Passenger","1","0","1","124","125","0.800"
"2019-07-31T00:00:00.000","Honolulu","HI","Passenger","3","2","5","481","486","1.028806584362139917695473251"
"2019-07-31T00:00:00.000","Maui","HI","Passenger","1","0","1","42","43","2.325581395348837209302325581"
"2019-07-31T00:00:00.000","Ada","ID","Passenger","0","2","2","293","295","0.6779661016949152542372881356"
"2019-07-31T00:00:00.000","Kootenai","ID","Passenger","1","1","2","206","208","0.9615384615384615384615384615"
"2019-07-31T00:00:00.000","Twin Falls","ID","Passenger","0","1","1","22","23","4.347826086956521739130434783"
"2019-07-31T00:00:00.000","Cook","IL","Passenger","1","0","1","226","227","0.4405286343612334801762114537"
"2019-07-31T00:00:00.000","DuPage","IL","Passenger","3","0","3","52","55","5.454545454545454545454545455"
"2019-07-31T00:00:00.000","Lake","IL","Passenger","1","0","1","175","176","0.5681818181818181818181818182"
"2019-07-31T00:00:00.000","Monroe","IL","Passenger","1","0","1","4","5","20.0"
"2019-07-31T00:00:00.000","Sangamon","IL","Passenger","1","0","1","7","8","12.500"
"2019-07-31T00:00:00.000","St. Clair","IL","Passenger","0","1","1","158","159","0.6289308176100628930817610063"
"2019-07-31T00:00:00.000","DeKalb","IN","Passenger","1","0","1","1","2","50.0"
"2019-07-31T00:00:00.000","Vigo","IN","Passenger","1","0","1","5","6","16.66666666666666666666666667"
"2019-07-31T00:00:00.000","Sedgwick","KS","Passenger","1","0","1","97","98","1.020408163265306122448979592"
"2019-07-31T00:00:00.000","Oldham","KY","Passenger","0","1","1","5","6","16.66666666666666666666666667"
"2019-07-31T00:00:00.000","Caddo","LA","Passenger","0","1","1","22","23","4.347826086956521739130434783"
"2019-07-31T00:00:00.000","Berkshire","MA","Passenger","0","1","1","5","6","16.66666666666666666666666667"
"2019-07-31T00:00:00.000","Franklin","MA","Passenger","0","1","1","1","2","50.0"
"2019-07-31T00:00:00.000","Middlesex","MA","Passenger","1","1","2","111","113","1.769911504424778761061946903"
"2019-07-31T00:00:00.000","Nantucket","MA","Passenger","1","0","1","1","2","50.0"
"2019-07-31T00:00:00.000","Norfolk","MA","Passenger","1","0","1","31","32","3.12500"
"2019-07-31T00:00:00.000","Suffolk","MA","Passenger","0","1","1","40","41","2.439024390243902439024390244"
"2019-07-31T00:00:00.000","Anne Arundel","MD","Passenger","1","2","3","441","444","0.6756756756756756756756756757"
"2019-07-31T00:00:00.000","Calvert","MD","Passenger","0","2","2","89","91","2.197802197802197802197802198"
"2019-07-31T00:00:00.000","Charles","MD","Passenger","0","1","1","86","87","1.149425287356321839080459770"
"2019-07-31T00:00:00.000","Frederick","MD","Passenger","2","1","3","84","87","3.448275862068965517241379310"
"2019-07-31T00:00:00.000","Howard","MD","Passenger","0","1","1","74","75","1.333333333333333333333333333"
"2019-07-31T00:00:00.000","Montgomery","MD","Passenger","1","2","3","284","287","1.045296167247386759581881533"
"2019-07-31T00:00:00.000","St. Mary's","MD","Passenger","1","0","1","211","212","0.4716981132075471698113207547"
"2019-07-31T00:00:00.000","Penobscot","ME","Passenger","0","1","1","15","16","6.2500"
"2019-07-31T00:00:00.000","Kent","MI","Passenger","0","1","1","21","22","4.545454545454545454545454545"
"2019-07-31T00:00:00.000","Saginaw","MI","Passenger","1","0","1","12","13","7.692307692307692307692307692"
"2019-07-31T00:00:00.000","Washtenaw","MI","Passenger","1","0","1","34","35","2.857142857142857142857142857"
"2019-07-31T00:00:00.000","Wayne","MI","Passenger","0","1","1","64","65","1.538461538461538461538461538"
"2019-07-31T00:00:00.000","Hennepin","MN","Passenger","2","1","3","101","104","2.884615384615384615384615385"
"2019-07-31T00:00:00.000","Kanabec","MN","Passenger","1","0","1","0","1","100"
"2019-07-31T00:00:00.000","Ramsey","MN","Passenger","1","0","1","37","38","2.631578947368421052631578947"
"2019-07-31T00:00:00.000","Boone","MO","Passenger","0","1","1","9","10","10.0"
"2019-07-31T00:00:00.000","Harrison","MS","Passenger","1","0","1","63","64","1.562500"
"2019-07-31T00:00:00.000","Cascade","MT","Passenger","0","1","1","61","62","1.612903225806451612903225806"
"2019-07-31T00:00:00.000","Flathead","MT","Passenger","1","0","1","57","58","1.724137931034482758620689655"
"2019-07-31T00:00:00.000","Glacier","MT","Passenger","0","1","1","6","7","14.28571428571428571428571429"
"2019-07-31T00:00:00.000","Cumberland","NC","Passenger","0","2","2","516","518","0.3861003861003861003861003861"
"2019-07-31T00:00:00.000","Guilford","NC","Passenger","1","0","1","29","30","3.333333333333333333333333333"
"2019-07-31T00:00:00.000","Harnett","NC","Passenger","0","1","1","214","215","0.4651162790697674418604651163"
"2019-07-31T00:00:00.000","Mecklenburg","NC","Passenger","1","0","1","87","88","1.136363636363636363636363636"
"2019-07-31T00:00:00.000","Moore","NC","Passenger","0","1","1","186","187","0.5347593582887700534759358289"
"2019-07-31T00:00:00.000","Douglas","NE","Passenger","0","1","1","62","63","1.587301587301587301587301587"
"2019-07-31T00:00:00.000","Carroll","NH","Passenger","0","1","1","2","3","33.33333333333333333333333333"
"2019-07-31T00:00:00.000","Bergen","NJ","Passenger","1","0","1","26","27","3.703703703703703703703703704"
"2019-07-31T00:00:00.000","Camden","NJ","Passenger","0","1","1","24","25","4.00"
"2019-07-31T00:00:00.000","Chaves","NM","Passenger","1","0","1","7","8","12.500"
"2019-07-31T00:00:00.000","Santa Fe","NM","Passenger","0","1","1","36","37","2.702702702702702702702702703"
"2019-07-31T00:00:00.000","Valencia","NM","Passenger","1","0","1","5","6","16.66666666666666666666666667"
"2019-07-31T00:00:00.000","Carson City","NV","Passenger","1","0","1","11","12","8.333333333333333333333333333"
"2019-07-31T00:00:00.000","Clark","NV","Passenger","4","3","7","682","689","1.015965166908563134978229318"
"2019-07-31T00:00:00.000","Washoe","NV","Passenger","2","0","2","96","98","2.040816326530612244897959184"
"2019-07-31T00:00:00.000","Jefferson","NY","Passenger","0","2","2","222","224","0.8928571428571428571428571429"
"2019-07-31T00:00:00.000","Nassau","NY","Passenger","2","0","2","36","38","5.263157894736842105263157895"
"2019-07-31T00:00:00.000","Saratoga","NY","Passenger","1","0","1","53","54","1.851851851851851851851851852"
"2019-07-31T00:00:00.000","Westchester","NY","Passenger","0","1","1","29","30","3.333333333333333333333333333"
"2019-07-31T00:00:00.000","Shelby","OH","Passenger","0","1","1","1","2","50.0"
"2019-07-31T00:00:00.000","Oklahoma","OK","Passenger","0","2","2","120","122","1.639344262295081967213114754"
"2019-07-31T00:00:00.000","Rogers","OK","Passenger","1","0","1","5","6","16.66666666666666666666666667"
"2019-07-31T00:00:00.000","Tulsa","OK","Passenger","1","1","2","42","44","4.545454545454545454545454545"
"2019-07-31T00:00:00.000","Clackamas","OR","Passenger","1","1","2","204","206","0.9708737864077669902912621359"
"2019-07-31T00:00:00.000","Deschutes","OR","Passenger","2","0","2","146","148","1.351351351351351351351351351"
"2019-07-31T00:00:00.000","Douglas","OR","Passenger","1","0","1","48","49","2.040816326530612244897959184"
"2019-07-31T00:00:00.000","Klamath","OR","Passenger","1","0","1","30","31","3.225806451612903225806451613"
"2019-07-31T00:00:00.000","Marion","OR","Passenger","1","0","1","114","115","0.8695652173913043478260869565"
"2019-07-31T00:00:00.000","Multnomah","OR","Passenger","5","5","10","710","720","1.388888888888888888888888889"
"2019-07-31T00:00:00.000","Allegheny","PA","Passenger","1","0","1","72","73","1.369863013698630136986301370"
"2019-07-31T00:00:00.000","Bucks","PA","Passenger","1","0","1","22","23","4.347826086956521739130434783"
"2019-07-31T00:00:00.000","Montgomery","PA","Passenger","2","0","2","31","33","6.060606060606060606060606061"
"2019-07-31T00:00:00.000","RÃ­o Grande","PR","Passenger","1","0","1","1","2","50.0"
"2019-07-31T00:00:00.000","Newport","RI","Passenger","1","0","1","90","91","1.098901098901098901098901099"
"2019-07-31T00:00:00.000","Richland","SC","Passenger","0","1","1","161","162","0.6172839506172839506172839506"
"2019-07-31T00:00:00.000","Spartanburg","SC","Passenger","0","1","1","31","32","3.12500"
"2019-07-31T00:00:00.000","Putnam","TN","Passenger","0","1","1","2","3","33.33333333333333333333333333"
"2019-07-31T00:00:00.000","Shelby","TN","Passenger","0","1","1","91","92","1.086956521739130434782608696"
"2019-07-31T00:00:00.000","Bell","TX","Passenger","0","1","1","440","441","0.2267573696145124716553287982"
"2019-07-31T00:00:00.000","Bexar","TX","Passenger","4","5","9","634","643","1.399688958009331259720062208"
"2019-07-31T00:00:00.000","Dallas","TX","Passenger","1","0","1","195","196","0.5102040816326530612244897959"
"2019-07-31T00:00:00.000","El Paso","TX","Passenger","2","0","2","482","484","0.4132231404958677685950413223"
"2019-07-31T00:00:00.000","Guadalupe","TX","Passenger","1","0","1","64","65","1.538461538461538461538461538"
"2019-07-31T00:00:00.000","Harris","TX","Passenger","1","1","2","241","243","0.8230452674897119341563786008"
"2019-07-31T00:00:00.000","Hidalgo","TX","Passenger","0","1","1","84","85","1.176470588235294117647058824"
"2019-07-31T00:00:00.000","Montgomery","TX","Passenger","1","0","1","54","55","1.818181818181818181818181818"
"2019-07-31T00:00:00.000","Nueces","TX","Passenger","1","1","2","92","94","2.127659574468085106382978723"
"2019-07-31T00:00:00.000","Tarrant","TX","Passenger","2","0","2","185","187","1.069518716577540106951871658"
"2019-07-31T00:00:00.000","Travis","TX","Passenger","2","1","3","187","190","1.578947368421052631578947368"
"2019-07-31T00:00:00.000","Albemarle","VA","Passenger","1","0","1","23","24","4.166666666666666666666666667"
"2019-07-31T00:00:00.000","Alexandria","VA","Passenger","3","0","3","146","149","2.013422818791946308724832215"
"2019-07-31T00:00:00.000","Arlington","VA","Passenger","0","2","2","156","158","1.265822784810126582278481013"
"2019-07-31T00:00:00.000","Fairfax","VA","Passenger","3","3","6","781","787","0.7623888182973316391359593393"
"2019-07-31T00:00:00.000","Goochland","VA","Passenger","1","1","2","235","237","0.8438818565400843881856540084"
"2019-07-31T00:00:00.000","Loudoun","VA","Passenger","1","0","1","91","92","1.086956521739130434782608696"
"2019-07-31T00:00:00.000","Manassas","VA","Passenger","0","1","1","8","9","11.11111111111111111111111111"
"2019-07-31T00:00:00.000","Norfolk","VA","Passenger","2","1","3","353","356","0.8426966292134831460674157303"
"2019-07-31T00:00:00.000","Portsmouth","VA","Passenger","0","1","1","67","68","1.470588235294117647058823529"
"2019-07-31T00:00:00.000","Powhatan","VA","Passenger","1","0","1","0","1","100"
"2019-07-31T00:00:00.000","Prince William","VA","Passenger","1","3","4","243","247","1.619433198380566801619433198"
"2019-07-31T00:00:00.000","Virginia Beach","VA","Passenger","1","0","1","690","691","0.1447178002894356005788712012"
"2019-07-31T00:00:00.000","Adams","WA","Truck","0","0","0","5131","5131","0"
"2019-07-31T00:00:00.000","Adams","WA","Passenger","5","6","11","12836","12847","0.08562310266988401961547442983"
"2019-07-31T00:00:00.000","Asotin","WA","Truck","0","0","0","6666","6666","0"
"2019-07-31T00:00:00.000","Asotin","WA","Passenger","13","9","22","12660","12682","0.1734742154234347894653840088"
"2019-07-31T00:00:00.000","Benton","WA","Truck","0","0","0","42078","42078","0"
"2019-07-31T00:00:00.000","Benton","WA","Passenger","282","298","580","134176","134756","0.4304075514262815755884710143"
"2019-07-31T00:00:00.000","Chelan","WA","Truck","0","0","0","22355","22355","0"
"2019-07-31T00:00:00.000","Chelan","WA","Passenger","162","69","231","54440","54671","0.4225274825776005560534835653"
"2019-07-31T00:00:00.000","Clallam","WA","Truck","1","0","1","21812","21813","0.004584422133590060972814376748"
"2019-07-31T00:00:00.000","Clallam","WA","Passenger","188","150","338","50633","50971","0.6631221675070137921563241843"
"2019-07-31T00:00:00.000","Clark","WA","Truck","0","0","0","80622","80622","0"
"2019-07-31T00:00:00.000","Clark","WA","Passenger","1684","984","2668","314842","317510","0.8402884948505558880035274480"
"2019-07-31T00:00:00.000","Columbia","WA","Passenger","2","2","4","2453","2457","0.1628001628001628001628001628"
"2019-07-31T00:00:00.000","Columbia","WA","Truck","0","0","0","1530","1530","0"
"2019-07-31T00:00:00.000","Cowlitz","WA","Passenger","117","121","238","73134","73372","0.3243744207599629286376274328"
"2019-07-31T00:00:00.000","Cowlitz","WA","Truck","0","0","0","28879","28879","0"
"2019-07-31T00:00:00.000","Douglas","WA","Passenger","61","37","98","28085","28183","0.3477273533690522655501543484"
"2019-07-31T00:00:00.000","Douglas","WA","Truck","0","0","0","12223","12223","0"
"2019-07-31T00:00:00.000","Ferry","WA","Truck","0","0","0","3580","3580","0"
"2019-07-31T00:00:00.000","Ferry","WA","Passenger","5","2","7","4400","4407","0.1588382119355570683004311323"
"2019-07-31T00:00:00.000","Franklin","WA","Passenger","59","75","134","60154","60288","0.2222664543524416135881104034"
"2019-07-31T00:00:00.000","Franklin","WA","Truck","0","0","0","19372","19372","0"
"2019-07-31T00:00:00.000","Garfield","WA","Passenger","1","1","2","1300","1302","0.1536098310291858678955453149"
"2019-07-31T00:00:00.000","Garfield","WA","Truck","0","0","0","961","961","0"
"2019-07-31T00:00:00.000","Grant","WA","Passenger","46","66","112","65027","65139","0.1719400052196073013095073612"
"2019-07-31T00:00:00.000","Grant","WA","Truck","0","0","0","26711","26711","0"
"2019-07-31T00:00:00.000","Grays Harbor","WA","Passenger","95","90","185","47994","48179","0.3839847236347786379958073019"
"2019-07-31T00:00:00.000","Grays Harbor","WA","Truck","0","0","0","20539","20539","0"
"2019-07-31T00:00:00.000","Island","WA","Passenger","342","255","597","63513","64110","0.9312119794103883949461862424"
"2019-07-31T00:00:00.000","Island","WA","Truck","0","0","0","21322","21322","0"
"2019-07-31T00:00:00.000","Jefferson","WA","Truck","0","0","0","9686","9686","0"
"2019-07-31T00:00:00.000","Jefferson","WA","Passenger","211","128","339","25068","25407","1.334277954894320462864564884"
"2019-07-31T00:00:00.000","King","WA","Passenger","20022","7395","27417","1391299","1418716","1.932522083348605358648242495"
"2019-07-31T00:00:00.000","King","WA","Truck","5","1","6","182322","182328","0.003290772673423719889430038173"
"2019-07-31T00:00:00.000","Kitsap","WA","Passenger","1165","650","1815","181253","183068","0.9914348766578539122074857430"
"2019-07-31T00:00:00.000","Kitsap","WA","Truck","1","0","1","54163","54164","0.001846244738202496122886049775"
"2019-07-31T00:00:00.000","Kittitas","WA","Passenger","82","42","124","29685","29809","0.4159817504780435438961387500"
"2019-07-31T00:00:00.000","Kittitas","WA","Truck","0","0","0","14488","14488","0"
"2019-07-31T00:00:00.000","Klickitat","WA","Passenger","40","34","74","15580","15654","0.4727226268046505685447808867"
"2019-07-31T00:00:00.000","Klickitat","WA","Truck","0","0","0","8257","8257","0"
"2019-07-31T00:00:00.000","Lewis","WA","Truck","0","0","0","25970","25970","0"
"2019-07-31T00:00:00.000","Lewis","WA","Passenger","108","100","208","59358","59566","0.3491924923614142295940637276"
"2019-07-31T00:00:00.000","Lincoln","WA","Passenger","4","11","15","7798","7813","0.1919877127863816715730193268"
"2019-07-31T00:00:00.000","Lincoln","WA","Truck","0","0","0","4683","4683","0"
"2019-07-31T00:00:00.000","Mason","WA","Passenger","148","130","278","47310","47588","0.5841808859376313356308313020"
"2019-07-31T00:00:00.000","Mason","WA","Truck","0","0","0","20410","20410","0"
"2019-07-31T00:00:00.000","Okanogan","WA","Passenger","24","26","50","26127","26177","0.1910073728845933453031287008"
"2019-07-31T00:00:00.000","Okanogan","WA","Truck","0","0","0","16497","16497","0"
"2019-07-31T00:00:00.000","Pacific","WA","Passenger","34","33","67","16021","16088","0.4164594728990551964196916957"
"2019-07-31T00:00:00.000","Pacific","WA","Truck","0","0","0","7671","7671","0"
"2019-07-31T00:00:00.000","Pend Oreille","WA","Passenger","5","6","11","9538","9549","0.1151953084092575138757985129"
"2019-07-31T00:00:00.000","Pend Oreille","WA","Truck","0","0","0","5727","5727","0"
"2019-07-31T00:00:00.000","Pierce","WA","Passenger","2093","1670","3763","544352","548115","0.6865347600412322231648467931"
"2019-07-31T00:00:00.000","Pierce","WA","Truck","0","0","0","140081","140081","0"
"2019-07-31T00:00:00.000","San Juan","WA","Passenger","221","74","295","14446","14741","2.001221084051285530153992266"
"2019-07-31T00:00:00.000","San Juan","WA","Truck","0","0","0","5894","5894","0"
"2019-07-31T00:00:00.000","Skagit","WA","Passenger","338","227","565","92197","92762","0.6090856169552187318082835644"
"2019-07-31T00:00:00.000","Skagit","WA","Truck","1","0","1","32538","32539","0.003073235194689449583576631120"
"2019-07-31T00:00:00.000","Skamania","WA","Truck","0","0","0","4065","4065","0"
"2019-07-31T00:00:00.000","Skamania","WA","Passenger","27","18","45","8741","8786","0.5121784657409515137719098566"
"2019-07-31T00:00:00.000","Snohomish","WA","Truck","0","0","0","122656","122656","0"
"2019-07-31T00:00:00.000","Snohomish","WA","Passenger","3704","1720","5424","532685","538109","1.007974220836298965451237575"
"2019-07-31T00:00:00.000","Spokane","WA","Truck","1","0","1","95277","95278","0.001049560234261844287243644913"
"2019-07-31T00:00:00.000","Spokane","WA","Passenger","593","465","1058","312777","313835","0.3371198241113961157933308904"
"2019-07-31T00:00:00.000","Stevens","WA","Truck","0","0","0","18704","18704","0"
"2019-07-31T00:00:00.000","Stevens","WA","Passenger","22","33","55","31718","31773","0.1731029490447864539074056589"
"2019-07-31T00:00:00.000","Thurston","WA","Passenger","989","697","1686","198183","199869","0.8435525269051228554703330682"
"2019-07-31T00:00:00.000","Thurston","WA","Truck","0","0","0","55293","55293","0"
"2019-07-31T00:00:00.000","Wahkiakum","WA","Truck","0","0","0","1762","1762","0"
"2019-07-31T00:00:00.000","Wahkiakum","WA","Passenger","2","3","5","3007","3012","0.1660026560424966799468791501"
"2019-07-31T00:00:00.000","Walla Walla","WA","Truck","0","0","0","13624","13624","0"
"2019-07-31T00:00:00.000","Walla Walla","WA","Passenger","53","62","115","36225","36340","0.3164556962025316455696202532"
"2019-07-31T00:00:00.000","Whatcom","WA","Passenger","935","454","1389","151110","152499","0.9108256447583262841067810281"
"2019-07-31T00:00:00.000","Whatcom","WA","Truck","2","0","2","42943","42945","0.004657119571544999417860053557"
"2019-07-31T00:00:00.000","Whitman","WA","Truck","0","0","0","8635","8635","0"
"2019-07-31T00:00:00.000","Whitman","WA","Passenger","34","49","83","22719","22802","0.3640031576177528286992369090"
"2019-07-31T00:00:00.000","Yakima","WA","Passenger","120","116","236","165408","165644","0.1424742218251189297529641883"
"2019-07-31T00:00:00.000","Yakima","WA","Truck","0","0","0","59266","59266","0"
"2019-07-31T00:00:00.000","Ozaukee","WI","Passenger","0","1","1","3","4","25.00"
"2019-07-31T00:00:00.000",,,"Passenger","2","0","2","238","240","0.8333333333333333333333333333"
"2019-08-31T00:00:00.000","Fairbanks North Star","AK","Passenger","0","1","1","98","99","1.010101010101010101010101010"
"2019-08-31T00:00:00.000","Juneau","AK","Passenger","0","2","2","30","32","6.2500"
"2019-08-31T00:00:00.000","Dale","AL","Passenger","0","1","1","59","60","1.666666666666666666666666667"
"2019-08-31T00:00:00.000","Montgomery","AL","Passenger","0","1","1","39","40","2.500"
"2019-08-31T00:00:00.000","Cochise","AZ","Passenger","0","1","1","114","115","0.8695652173913043478260869565"
"2019-08-31T00:00:00.000","Maricopa","AZ","Passenger","8","5","13","1400","1413","0.9200283085633404104741684360"
"2019-08-31T00:00:00.000","Pima","AZ","Passenger","1","1","2","372","374","0.5347593582887700534759358289"
"2019-08-31T00:00:00.000","Pinal","AZ","Passenger","2","0","2","170","172","1.162790697674418604651162791"
"2019-08-31T00:00:00.000","Alameda","CA","Passenger","4","1","5","283","288","1.736111111111111111111111111"
"2019-08-31T00:00:00.000","Contra Costa","CA","Passenger","2","2","4","404","408","0.9803921568627450980392156863"
"2019-08-31T00:00:00.000","Fresno","CA","Passenger","1","0","1","192","193","0.5181347150259067357512953368"
"2019-08-31T00:00:00.000","Kern","CA","Passenger","0","1","1","229","230","0.4347826086956521739130434783"
"2019-08-31T00:00:00.000","Los Angeles","CA","Passenger","9","6","15","1076","1091","1.374885426214482126489459212"
"2019-08-31T00:00:00.000","Orange","CA","Passenger","5","3","8","516","524","1.526717557251908396946564885"
"2019-08-31T00:00:00.000","Riverside","CA","Passenger","2","2","4","631","635","0.6299212598425196850393700787"
"2019-08-31T00:00:00.000","San Diego","CA","Passenger","10","5","15","2789","2804","0.5349500713266761768901569187"
"2019-08-31T00:00:00.000","San Francisco","CA","Passenger","2","1","3","101","104","2.884615384615384615384615385"
"2019-08-31T00:00:00.000","San Mateo","CA","Passenger","2","1","3","113","116","2.586206896551724137931034483"
"2019-08-31T00:00:00.000","Santa Barbara","CA","Passenger","2","0","2","96","98","2.040816326530612244897959184"
"2019-08-31T00:00:00.000","Santa Clara","CA","Passenger","3","2","5","352","357","1.400560224089635854341736695"
"2019-08-31T00:00:00.000","Santa Cruz","CA","Passenger","1","0","1","37","38","2.631578947368421052631578947"
"2019-08-31T00:00:00.000","Shasta","CA","Passenger","1","0","1","40","41","2.439024390243902439024390244"
"2019-08-31T00:00:00.000","Solano","CA","Passenger","1","0","1","214","215","0.4651162790697674418604651163"
"2019-08-31T00:00:00.000","Tuolumne","CA","Passenger","0","1","1","9","10","10.0"
"2019-08-31T00:00:00.000","Ventura","CA","Passenger","0","2","2","313","315","0.6349206349206349206349206349"
"2019-08-31T00:00:00.000","Denver","CO","Passenger","1","0","1","123","124","0.8064516129032258064516129032"
"2019-08-31T00:00:00.000","El Paso","CO","Passenger","2","1","3","719","722","0.4155124653739612188365650970"
"2019-08-31T00:00:00.000","Jefferson","CO","Passenger","0","2","2","62","64","3.12500"
"2019-08-31T00:00:00.000","Larimer","CO","Passenger","1","1","2","54","56","3.571428571428571428571428571"
"2019-08-31T00:00:00.000","New London","CT","Passenger","0","2","2","261","263","0.7604562737642585551330798479"
"2019-08-31T00:00:00.000","District of Columbia","DC","Passenger","1","3","4","208","212","1.886792452830188679245283019"
"2019-08-31T00:00:00.000","Kent","DE","Passenger","0","1","1","75","76","1.315789473684210526315789474"
"2019-08-31T00:00:00.000","New Castle","DE","Passenger","1","0","1","24","25","4.00"
"2019-08-31T00:00:00.000","Brevard","FL","Passenger","0","1","1","77","78","1.282051282051282051282051282"
"2019-08-31T00:00:00.000","Broward","FL","Passenger","1","1","2","124","126","1.587301587301587301587301587"
"2019-08-31T00:00:00.000","Clay","FL","Passenger","0","1","1","81","82","1.219512195121951219512195122"
"2019-08-31T00:00:00.000","Duval","FL","Passenger","1","1","2","367","369","0.5420054200542005420054200542"
"2019-08-31T00:00:00.000","Lake","FL","Passenger","1","0","1","16","17","5.882352941176470588235294118"
"2019-08-31T00:00:00.000","Manatee","FL","Passenger","1","0","1","33","34","2.941176470588235294117647059"
"2019-08-31T00:00:00.000","Osceola","FL","Passenger","1","0","1","39","40","2.500"
"2019-08-31T00:00:00.000","Palm Beach","FL","Passenger","0","1","1","75","76","1.315789473684210526315789474"
"2019-08-31T00:00:00.000","Pinellas","FL","Passenger","1","1","2","104","106","1.886792452830188679245283019"
"2019-08-31T00:00:00.000","Polk","FL","Passenger","1","0","1","70","71","1.408450704225352112676056338"
"2019-08-31T00:00:00.000","Santa Rosa","FL","Passenger","1","0","1","91","92","1.086956521739130434782608696"
"2019-08-31T00:00:00.000","Sarasota","FL","Passenger","1","0","1","28","29","3.448275862068965517241379310"
"2019-08-31T00:00:00.000","Sumter","FL","Passenger","0","1","1","9","10","10.0"
"2019-08-31T00:00:00.000","Volusia","FL","Passenger","0","1","1","35","36","2.777777777777777777777777778"
"2019-08-31T00:00:00.000","Bryan","GA","Passenger","1","0","1","51","52","1.923076923076923076923076923"
"2019-08-31T00:00:00.000","Camden","GA","Passenger","0","1","1","158","159","0.6289308176100628930817610063"
"2019-08-31T00:00:00.000","Columbia","GA","Passenger","1","1","2","142","144","1.388888888888888888888888889"
"2019-08-31T00:00:00.000","DeKalb","GA","Passenger","1","0","1","74","75","1.333333333333333333333333333"
"2019-08-31T00:00:00.000","Fulton","GA","Passenger","0","2","2","100","102","1.960784313725490196078431373"
"2019-08-31T00:00:00.000","Houston","GA","Passenger","1","0","1","56","57","1.754385964912280701754385965"
"2019-08-31T00:00:00.000","Jones","GA","Passenger","1","0","1","1","2","50.0"
"2019-08-31T00:00:00.000","Liberty","GA","Passenger","1","0","1","125","126","0.7936507936507936507936507937"
"2019-08-31T00:00:00.000","Honolulu","HI","Passenger","4","1","5","474","479","1.043841336116910229645093946"
"2019-08-31T00:00:00.000","Maui","HI","Passenger","1","0","1","40","41","2.439024390243902439024390244"
"2019-08-31T00:00:00.000","Ada","ID","Passenger","0","2","2","291","293","0.6825938566552901023890784983"
"2019-08-31T00:00:00.000","Kootenai","ID","Passenger","1","1","2","205","207","0.9661835748792270531400966184"
"2019-08-31T00:00:00.000","Twin Falls","ID","Passenger","0","1","1","24","25","4.00"
"2019-08-31T00:00:00.000","Cook","IL","Passenger","1","0","1","224","225","0.4444444444444444444444444444"
"2019-08-31T00:00:00.000","DuPage","IL","Passenger","3","0","3","54","57","5.263157894736842105263157895"
"2019-08-31T00:00:00.000","Lake","IL","Passenger","1","0","1","174","175","0.5714285714285714285714285714"
"2019-08-31T00:00:00.000","Monroe","IL","Passenger","1","0","1","4","5","20.0"
"2019-08-31T00:00:00.000","Sangamon","IL","Passenger","1","0","1","7","8","12.500"
"2019-08-31T00:00:00.000","DeKalb","IN","Passenger","1","0","1","1","2","50.0"
"2019-08-31T00:00:00.000","Vigo","IN","Passenger","1","0","1","5","6","16.66666666666666666666666667"
"2019-08-31T00:00:00.000","Sedgwick","KS","Passenger","1","0","1","96","97","1.030927835051546391752577320"
"2019-08-31T00:00:00.000","Oldham","KY","Passenger","0","1","1","5","6","16.66666666666666666666666667"
"2019-08-31T00:00:00.000","Caddo","LA","Passenger","0","1","1","20","21","4.761904761904761904761904762"
"2019-08-31T00:00:00.000","Berkshire","MA","Passenger","0","1","1","5","6","16.66666666666666666666666667"
"2019-08-31T00:00:00.000","Franklin","MA","Passenger","0","1","1","1","2","50.0"
"2019-08-31T00:00:00.000","Middlesex","MA","Passenger","1","1","2","110","112","1.785714285714285714285714286"
"2019-08-31T00:00:00.000","Nantucket","MA","Passenger","1","0","1","1","2","50.0"
"2019-08-31T00:00:00.000","Norfolk","MA","Passenger","1","0","1","31","32","3.12500"
"2019-08-31T00:00:00.000","Suffolk","MA","Passenger","0","1","1","40","41","2.439024390243902439024390244"
"2019-08-31T00:00:00.000","Anne Arundel","MD","Passenger","1","2","3","439","442","0.6787330316742081447963800905"
"2019-08-31T00:00:00.000","Calvert","MD","Passenger","0","2","2","89","91","2.197802197802197802197802198"
"2019-08-31T00:00:00.000","Charles","MD","Passenger","0","1","1","84","85","1.176470588235294117647058824"
"2019-08-31T00:00:00.000","Frederick","MD","Passenger","2","1","3","84","87","3.448275862068965517241379310"
"2019-08-31T00:00:00.000","Howard","MD","Passenger","0","1","1","74","75","1.333333333333333333333333333"
"2019-08-31T00:00:00.000","Montgomery","MD","Passenger","0","2","2","282","284","0.7042253521126760563380281690"
"2019-08-31T00:00:00.000","St. Mary's","MD","Passenger","1","0","1","211","212","0.4716981132075471698113207547"
"2019-08-31T00:00:00.000","Penobscot","ME","Passenger","0","1","1","15","16","6.2500"
"2019-08-31T00:00:00.000","Kent","MI","Passenger","0","1","1","23","24","4.166666666666666666666666667"
"2019-08-31T00:00:00.000","Saginaw","MI","Passenger","1","0","1","13","14","7.142857142857142857142857143"
"2019-08-31T00:00:00.000","Washtenaw","MI","Passenger","1","0","1","34","35","2.857142857142857142857142857"
"2019-08-31T00:00:00.000","Wayne","MI","Passenger","0","1","1","62","63","1.587301587301587301587301587"
"2019-08-31T00:00:00.000","Hennepin","MN","Passenger","2","1","3","102","105","2.857142857142857142857142857"
"2019-08-31T00:00:00.000","Kanabec","MN","Passenger","1","0","1","0","1","100"
"2019-08-31T00:00:00.000","Ramsey","MN","Passenger","1","0","1","36","37","2.702702702702702702702702703"
"2019-08-31T00:00:00.000","Boone","MO","Passenger","0","1","1","9","10","10.0"
"2019-08-31T00:00:00.000","Greene","MO","Passenger","0","1","1","27","28","3.571428571428571428571428571"
"2019-08-31T00:00:00.000","Harrison","MS","Passenger","1","0","1","63","64","1.562500"
"2019-08-31T00:00:00.000","Cascade","MT","Passenger","0","1","1","60","61","1.639344262295081967213114754"
"2019-08-31T00:00:00.000","Flathead","MT","Passenger","1","0","1","60","61","1.639344262295081967213114754"
"2019-08-31T00:00:00.000","Glacier","MT","Passenger","0","1","1","6","7","14.28571428571428571428571429"
"2019-08-31T00:00:00.000","Cumberland","NC","Passenger","0","2","2","511","513","0.3898635477582846003898635478"
"2019-08-31T00:00:00.000","Guilford","NC","Passenger","1","0","1","31","32","3.12500"
"2019-08-31T00:00:00.000","Harnett","NC","Passenger","0","1","1","211","212","0.4716981132075471698113207547"
"2019-08-31T00:00:00.000","Moore","NC","Passenger","0","1","1","186","187","0.5347593582887700534759358289"
"2019-08-31T00:00:00.000","Douglas","NE","Passenger","0","1","1","60","61","1.639344262295081967213114754"
"2019-08-31T00:00:00.000","Carroll","NH","Passenger","0","1","1","2","3","33.33333333333333333333333333"
"2019-08-31T00:00:00.000","Bergen","NJ","Passenger","1","0","1","26","27","3.703703703703703703703703704"
"2019-08-31T00:00:00.000","Camden","NJ","Passenger","0","1","1","23","24","4.166666666666666666666666667"
"2019-08-31T00:00:00.000","Chaves","NM","Passenger","1","0","1","8","9","11.11111111111111111111111111"
"2019-08-31T00:00:00.000","Santa Fe","NM","Passenger","0","1","1","36","37","2.702702702702702702702702703"
"2019-08-31T00:00:00.000","Valencia","NM","Passenger","1","0","1","5","6","16.66666666666666666666666667"
"2019-08-31T00:00:00.000","Carson City","NV","Passenger","1","0","1","11","12","8.333333333333333333333333333"
"2019-08-31T00:00:00.000","Clark","NV","Passenger","4","3","7","682","689","1.015965166908563134978229318"
"2019-08-31T00:00:00.000","Washoe","NV","Passenger","2","0","2","94","96","2.083333333333333333333333333"
"2019-08-31T00:00:00.000","Jefferson","NY","Passenger","0","2","2","224","226","0.8849557522123893805309734513"
"2019-08-31T00:00:00.000","Nassau","NY","Passenger","2","0","2","36","38","5.263157894736842105263157895"
"2019-08-31T00:00:00.000","Saratoga","NY","Passenger","1","0","1","51","52","1.923076923076923076923076923"
"2019-08-31T00:00:00.000","Westchester","NY","Passenger","0","1","1","30","31","3.225806451612903225806451613"
"2019-08-31T00:00:00.000","Shelby","OH","Passenger","0","1","1","1","2","50.0"
"2019-08-31T00:00:00.000","Oklahoma","OK","Passenger","0","2","2","119","121","1.652892561983471074380165289"
"2019-08-31T00:00:00.000","Rogers","OK","Passenger","1","0","1","5","6","16.66666666666666666666666667"
"2019-08-31T00:00:00.000","Tulsa","OK","Passenger","1","1","2","44","46","4.347826086956521739130434783"
"2019-08-31T00:00:00.000","Clackamas","OR","Passenger","1","1","2","205","207","0.9661835748792270531400966184"
"2019-08-31T00:00:00.000","Deschutes","OR","Passenger","2","0","2","145","147","1.360544217687074829931972789"
"2019-08-31T00:00:00.000","Douglas","OR","Passenger","1","0","1","48","49","2.040816326530612244897959184"
"2019-08-31T00:00:00.000","Klamath","OR","Passenger","1","0","1","30","31","3.225806451612903225806451613"
"2019-08-31T00:00:00.000","Multnomah","OR","Passenger","5","5","10","708","718","1.392757660167130919220055710"
"2019-08-31T00:00:00.000","Allegheny","PA","Passenger","1","0","1","73","74","1.351351351351351351351351351"
"2019-08-31T00:00:00.000","Bucks","PA","Passenger","1","0","1","23","24","4.166666666666666666666666667"
"2019-08-31T00:00:00.000","Montgomery","PA","Passenger","2","0","2","31","33","6.060606060606060606060606061"
"2019-08-31T00:00:00.000","RÃ­o Grande","PR","Passenger","1","0","1","1","2","50.0"
"2019-08-31T00:00:00.000","Newport","RI","Passenger","1","0","1","89","90","1.111111111111111111111111111"
"2019-08-31T00:00:00.000","Richland","SC","Passenger","0","1","1","159","160","0.62500"
"2019-08-31T00:00:00.000","Spartanburg","SC","Passenger","0","1","1","32","33","3.030303030303030303030303030"
"2019-08-31T00:00:00.000","Putnam","TN","Passenger","0","1","1","2","3","33.33333333333333333333333333"
"2019-08-31T00:00:00.000","Shelby","TN","Passenger","0","1","1","93","94","1.063829787234042553191489362"
"2019-08-31T00:00:00.000","Bell","TX","Passenger","0","1","1","436","437","0.2288329519450800915331807780"
"2019-08-31T00:00:00.000","Bexar","TX","Passenger","4","5","9","627","636","1.415094339622641509433962264"
"2019-08-31T00:00:00.000","Dallas","TX","Passenger","1","0","1","198","199","0.5025125628140703517587939698"
"2019-08-31T00:00:00.000","El Paso","TX","Passenger","2","0","2","477","479","0.4175365344467640918580375783"
"2019-08-31T00:00:00.000","Guadalupe","TX","Passenger","1","0","1","61","62","1.612903225806451612903225806"
"2019-08-31T00:00:00.000","Harris","TX","Passenger","1","1","2","243","245","0.8163265306122448979591836735"
"2019-08-31T00:00:00.000","Hidalgo","TX","Passenger","0","1","1","83","84","1.190476190476190476190476190"
"2019-08-31T00:00:00.000","Montgomery","TX","Passenger","1","0","1","55","56","1.785714285714285714285714286"
"2019-08-31T00:00:00.000","Nueces","TX","Passenger","1","1","2","91","93","2.150537634408602150537634409"
"2019-08-31T00:00:00.000","Tarrant","TX","Passenger","2","0","2","185","187","1.069518716577540106951871658"
"2019-08-31T00:00:00.000","Travis","TX","Passenger","2","1","3","188","191","1.570680628272251308900523560"
"2019-08-31T00:00:00.000","Albemarle","VA","Passenger","1","0","1","22","23","4.347826086956521739130434783"
"2019-08-31T00:00:00.000","Alexandria","VA","Passenger","3","0","3","146","149","2.013422818791946308724832215"
"2019-08-31T00:00:00.000","Arlington","VA","Passenger","0","2","2","155","157","1.273885350318471337579617834"
"2019-08-31T00:00:00.000","Fairfax","VA","Passenger","3","3","6","761","767","0.7822685788787483702737940026"
"2019-08-31T00:00:00.000","Goochland","VA","Passenger","1","1","2","234","236","0.8474576271186440677966101695"
"2019-08-31T00:00:00.000","Loudoun","VA","Passenger","1","0","1","89","90","1.111111111111111111111111111"
"2019-08-31T00:00:00.000","Manassas","VA","Passenger","0","1","1","7","8","12.500"
"2019-08-31T00:00:00.000","Norfolk","VA","Passenger","2","1","3","349","352","0.8522727272727272727272727273"
"2019-08-31T00:00:00.000","Portsmouth","VA","Passenger","0","1","1","69","70","1.428571428571428571428571429"
"2019-08-31T00:00:00.000","Powhatan","VA","Passenger","1","0","1","0","1","100"
"2019-08-31T00:00:00.000","Prince William","VA","Passenger","1","3","4","245","249","1.606425702811244979919678715"
"2019-08-31T00:00:00.000","Stafford","VA","Passenger","1","1","2","98","100","2.00"
"2019-08-31T00:00:00.000","Virginia Beach","VA","Passenger","1","0","1","679","680","0.1470588235294117647058823529"
"2019-08-31T00:00:00.000","Adams","WA","Passenger","5","5","10","12844","12854","0.07779679477205539131787770344"
"2019-08-31T00:00:00.000","Adams","WA","Truck","0","0","0","5137","5137","0"
"2019-08-31T00:00:00.000","Asotin","WA","Truck","0","0","0","6690","6690","0"
"2019-08-31T00:00:00.000","Asotin","WA","Passenger","13","8","21","12645","12666","0.1657981999052581714827096163"
"2019-08-31T00:00:00.000","Benton","WA","Passenger","292","300","592","134353","134945","0.4386972470265663788951054133"
"2019-08-31T00:00:00.000","Benton","WA","Truck","0","0","0","42184","42184","0"
"2019-08-31T00:00:00.000","Chelan","WA","Truck","0","0","0","22373","22373","0"
"2019-08-31T00:00:00.000","Chelan","WA","Passenger","167","71","238","54462","54700","0.4351005484460694698354661792"
"2019-08-31T00:00:00.000","Clallam","WA","Truck","1","0","1","21824","21825","0.004581901489117983963344788087"
"2019-08-31T00:00:00.000","Clallam","WA","Passenger","196","154","350","50720","51070","0.6853338554924613275895829254"
"2019-08-31T00:00:00.000","Clark","WA","Passenger","1744","1001","2745","315471","318216","0.8626216155064484501093596802"
"2019-08-31T00:00:00.000","Clark","WA","Truck","0","0","0","80870","80870","0"
"2019-08-31T00:00:00.000","Columbia","WA","Truck","0","0","0","1532","1532","0"
"2019-08-31T00:00:00.000","Columbia","WA","Passenger","2","2","4","2454","2458","0.1627339300244100895036615134"
"2019-08-31T00:00:00.000","Cowlitz","WA","Passenger","118","122","240","73278","73518","0.3264506651432302293315922631"
"2019-08-31T00:00:00.000","Cowlitz","WA","Truck","0","0","0","28911","28911","0"
"2019-08-31T00:00:00.000","Douglas","WA","Passenger","62","36","98","28188","28286","0.3464611468571024535105706003"
"2019-08-31T00:00:00.000","Douglas","WA","Truck","0","0","0","12266","12266","0"
"2019-08-31T00:00:00.000","Ferry","WA","Passenger","5","2","7","4416","4423","0.1582636219760343658150576532"
"2019-08-31T00:00:00.000","Ferry","WA","Truck","0","0","0","3578","3578","0"
"2019-08-31T00:00:00.000","Franklin","WA","Truck","0","0","0","19497","19497","0"
"2019-08-31T00:00:00.000","Franklin","WA","Passenger","57","76","133","60242","60375","0.2202898550724637681159420290"
"2019-08-31T00:00:00.000","Garfield","WA","Passenger","0","1","1","1308","1309","0.07639419404125286478227654698"
"2019-08-31T00:00:00.000","Garfield","WA","Truck","0","0","0","959","959","0"
"2019-08-31T00:00:00.000","Grant","WA","Passenger","48","66","114","65178","65292","0.1746002573056423451571402316"
"2019-08-31T00:00:00.000","Grant","WA","Truck","0","0","0","26748","26748","0"
"2019-08-31T00:00:00.000","Grays Harbor","WA","Passenger","101","90","191","48116","48307","0.3953878319912228041484670959"
"2019-08-31T00:00:00.000","Grays Harbor","WA","Truck","0","0","0","20574","20574","0"
"2019-08-31T00:00:00.000","Island","WA","Passenger","350","256","606","63488","64094","0.9454863169719474521796111961"
"2019-08-31T00:00:00.000","Island","WA","Truck","0","0","0","21286","21286","0"
"2019-08-31T00:00:00.000","Jefferson","WA","Truck","0","0","0","9678","9678","0"
"2019-08-31T00:00:00.000","Jefferson","WA","Passenger","214","132","346","25078","25424","1.360918816865953429830081812"
"2019-08-31T00:00:00.000","King","WA","Passenger","20406","7493","27899","1393135","1421034","1.963288703859302451595106099"
"2019-08-31T00:00:00.000","King","WA","Truck","6","1","7","182319","182326","0.003839276899619363118809165999"
"2019-08-31T00:00:00.000","Kitsap","WA","Passenger","1185","659","1844","181525","183369","1.005622542523545419345690929"
"2019-08-31T00:00:00.000","Kitsap","WA","Truck","1","0","1","54197","54198","0.001845086534558470792280157939"
"2019-08-31T00:00:00.000","Kittitas","WA","Truck","0","0","0","14523","14523","0"
"2019-08-31T00:00:00.000","Kittitas","WA","Passenger","82","45","127","29749","29876","0.4250903735439817914044718168"
"2019-08-31T00:00:00.000","Klickitat","WA","Passenger","42","36","78","15626","15704","0.4966887417218543046357615894"
"2019-08-31T00:00:00.000","Klickitat","WA","Truck","0","0","0","8294","8294","0"
"2019-08-31T00:00:00.000","Lewis","WA","Truck","0","0","0","25989","25989","0"
"2019-08-31T00:00:00.000","Lewis","WA","Passenger","113","100","213","59350","59563","0.3576045531621980088309856790"
"2019-08-31T00:00:00.000","Lincoln","WA","Passenger","4","10","14","7791","7805","0.1793721973094170403587443946"
"2019-08-31T00:00:00.000","Lincoln","WA","Truck","0","0","0","4682","4682","0"
"2019-08-31T00:00:00.000","Mason","WA","Passenger","151","132","283","47421","47704","0.5932416568841187321817876908"
"2019-08-31T00:00:00.000","Mason","WA","Truck","0","0","0","20412","20412","0"
"2019-08-31T00:00:00.000","Okanogan","WA","Truck","0","0","0","16484","16484","0"
"2019-08-31T00:00:00.000","Okanogan","WA","Passenger","26","26","52","26196","26248","0.1981103322157878695519658641"
"2019-08-31T00:00:00.000","Pacific","WA","Truck","0","0","0","7683","7683","0"
"2019-08-31T00:00:00.000","Pacific","WA","Passenger","33","32","65","16036","16101","0.4037016334389168374635115831"
"2019-08-31T00:00:00.000","Pend Oreille","WA","Truck","0","0","0","5718","5718","0"
"2019-08-31T00:00:00.000","Pend Oreille","WA","Passenger","6","6","12","9496","9508","0.1262095077829196466133782078"
"2019-08-31T00:00:00.000","Pierce","WA","Passenger","2149","1686","3835","544797","548632","0.6990113591624258154828737660"
"2019-08-31T00:00:00.000","Pierce","WA","Truck","0","0","0","140390","140390","0"
"2019-08-31T00:00:00.000","San Juan","WA","Truck","0","0","0","5895","5895","0"
"2019-08-31T00:00:00.000","San Juan","WA","Passenger","226","75","301","14441","14742","2.041785375118708452041785375"
"2019-08-31T00:00:00.000","Skagit","WA","Passenger","340","226","566","92293","92859","0.6095262710130412776359857418"
"2019-08-31T00:00:00.000","Skagit","WA","Truck","1","0","1","32566","32567","0.003070592931495071698344950410"
"2019-08-31T00:00:00.000","Skamania","WA","Truck","0","0","0","4077","4077","0"
"2019-08-31T00:00:00.000","Skamania","WA","Passenger","28","18","46","8756","8802","0.5226084980686207680072710748"
"2019-08-31T00:00:00.000","Snohomish","WA","Truck","0","0","0","122901","122901","0"
"2019-08-31T00:00:00.000","Snohomish","WA","Passenger","3789","1743","5532","533059","538591","1.027124478500383407817806090"
"2019-08-31T00:00:00.000","Spokane","WA","Truck","1","0","1","95569","95570","0.001046353458198179344982735168"
"2019-08-31T00:00:00.000","Spokane","WA","Passenger","611","470","1081","313200","314281","0.3439597048501182063185493237"
"2019-08-31T00:00:00.000","Stevens","WA","Passenger","25","32","57","31706","31763","0.1794540817932814910430374965"
"2019-08-31T00:00:00.000","Stevens","WA","Truck","0","0","0","18717","18717","0"
"2019-08-31T00:00:00.000","Thurston","WA","Passenger","1013","707","1720","198389","200109","0.8595315553023602136835424694"
"2019-08-31T00:00:00.000","Thurston","WA","Truck","0","0","0","55476","55476","0"
"2019-08-31T00:00:00.000","Wahkiakum","WA","Truck","0","0","0","1764","1764","0"
"2019-08-31T00:00:00.000","Wahkiakum","WA","Passenger","2","3","5","3026","3031","0.1649620587264929066314747608"
"2019-08-31T00:00:00.000","Walla Walla","WA","Truck","0","0","0","13659","13659","0"
"2019-08-31T00:00:00.000","Walla Walla","WA","Passenger","57","64","121","36249","36370","0.3326917789386857299972504812"
"2019-08-31T00:00:00.000","Whatcom","WA","Truck","2","0","2","43012","43014","0.004649648951504161435811596224"
"2019-08-31T00:00:00.000","Whatcom","WA","Passenger","954","468","1422","151209","152631","0.9316587062916445545138274662"
"2019-08-31T00:00:00.000","Whitman","WA","Passenger","35","48","83","22728","22811","0.3638595414493007759414317654"
"2019-08-31T00:00:00.000","Whitman","WA","Truck","0","0","0","8632","8632","0"
"2019-08-31T00:00:00.000","Yakima","WA","Passenger","122","118","240","165649","165889","0.1446750538010356322601257467"
"2019-08-31T00:00:00.000","Yakima","WA","Truck","0","0","0","59398","59398","0"
"2019-08-31T00:00:00.000","Ozaukee","WI","Passenger","0","1","1","3","4","25.00"
"2019-08-31T00:00:00.000",,,"Passenger","2","0","2","243","245","0.8163265306122448979591836735"
"2019-09-30T00:00:00.000","Fairbanks North Star","AK","Passenger","0","1","1","98","99","1.010101010101010101010101010"
"2019-09-30T00:00:00.000","Juneau","AK","Passenger","0","2","2","27","29","6.896551724137931034482758621"
"2019-09-30T00:00:00.000","Montgomery","AL","Passenger","0","1","1","40","41","2.439024390243902439024390244"
"2019-09-30T00:00:00.000","Cochise","AZ","Passenger","0","1","1","114","115","0.8695652173913043478260869565"
"2019-09-30T00:00:00.000","Maricopa","AZ","Passenger","8","5","13","1390","1403","0.9265858873841767640769779045"
"2019-09-30T00:00:00.000","Pima","AZ","Passenger","2","1","3","362","365","0.8219178082191780821917808219"
"2019-09-30T00:00:00.000","Pinal","AZ","Passenger","2","0","2","168","170","1.176470588235294117647058824"
"2019-09-30T00:00:00.000","Alameda","CA","Passenger","4","1","5","284","289","1.730103806228373702422145329"
"2019-09-30T00:00:00.000","Contra Costa","CA","Passenger","2","2","4","405","409","0.9779951100244498777506112469"
"2019-09-30T00:00:00.000","Fresno","CA","Passenger","1","0","1","193","194","0.5154639175257731958762886598"
"2019-09-30T00:00:00.000","Kern","CA","Passenger","0","1","1","223","224","0.4464285714285714285714285714"
"2019-09-30T00:00:00.000","Los Angeles","CA","Passenger","9","7","16","1059","1075","1.488372093023255813953488372"
"2019-09-30T00:00:00.000","Orange","CA","Passenger","6","3","9","507","516","1.744186046511627906976744186"
"2019-09-30T00:00:00.000","Riverside","CA","Passenger","3","1","4","628","632","0.6329113924050632911392405063"
"2019-09-30T00:00:00.000","San Bernardino","CA","Passenger","0","1","1","445","446","0.2242152466367713004484304933"
"2019-09-30T00:00:00.000","San Diego","CA","Passenger","10","5","15","2805","2820","0.5319148936170212765957446809"
"2019-09-30T00:00:00.000","San Francisco","CA","Passenger","2","1","3","99","102","2.941176470588235294117647059"
"2019-09-30T00:00:00.000","San Mateo","CA","Passenger","2","1","3","118","121","2.479338842975206611570247934"
"2019-09-30T00:00:00.000","Santa Barbara","CA","Passenger","2","0","2","95","97","2.061855670103092783505154639"
"2019-09-30T00:00:00.000","Santa Clara","CA","Passenger","3","2","5","345","350","1.428571428571428571428571429"
"2019-09-30T00:00:00.000","Santa Cruz","CA","Passenger","1","0","1","35","36","2.777777777777777777777777778"
"2019-09-30T00:00:00.000","Shasta","CA","Passenger","1","0","1","39","40","2.500"
"2019-09-30T00:00:00.000","Solano","CA","Passenger","1","0","1","213","214","0.4672897196261682242990654206"
"2019-09-30T00:00:00.000","Tuolumne","CA","Passenger","0","1","1","9","10","10.0"
"2019-09-30T00:00:00.000","Ventura","CA","Passenger","0","2","2","308","310","0.6451612903225806451612903226"
"2019-09-30T00:00:00.000","Boulder","CO","Passenger","0","1","1","43","44","2.272727272727272727272727273"
"2019-09-30T00:00:00.000","Denver","CO","Passenger","1","0","1","125","126","0.7936507936507936507936507937"
"2019-09-30T00:00:00.000","El Paso","CO","Passenger","2","1","3","721","724","0.4143646408839779005524861878"
"2019-09-30T00:00:00.000","Jefferson","CO","Passenger","0","2","2","62","64","3.12500"
"2019-09-30T00:00:00.000","Larimer","CO","Passenger","1","1","2","56","58","3.448275862068965517241379310"
"2019-09-30T00:00:00.000","New London","CT","Passenger","0","2","2","262","264","0.7575757575757575757575757576"
"2019-09-30T00:00:00.000","District of Columbia","DC","Passenger","1","3","4","206","210","1.904761904761904761904761905"
"2019-09-30T00:00:00.000","Kent","DE","Passenger","0","1","1","75","76","1.315789473684210526315789474"
"2019-09-30T00:00:00.000","New Castle","DE","Passenger","1","0","1","24","25","4.00"
"2019-09-30T00:00:00.000","Brevard","FL","Passenger","0","1","1","80","81","1.234567901234567901234567901"
"2019-09-30T00:00:00.000","Broward","FL","Passenger","1","1","2","124","126","1.587301587301587301587301587"
"2019-09-30T00:00:00.000","Clay","FL","Passenger","0","1","1","82","83","1.204819277108433734939759036"
"2019-09-30T00:00:00.000","Duval","FL","Passenger","1","1","2","362","364","0.5494505494505494505494505495"
"2019-09-30T00:00:00.000","Lake","FL","Passenger","1","0","1","17","18","5.555555555555555555555555556"
"2019-09-30T00:00:00.000","Osceola","FL","Passenger","1","0","1","38","39","2.564102564102564102564102564"
"2019-09-30T00:00:00.000","Palm Beach","FL","Passenger","0","1","1","73","74","1.351351351351351351351351351"
"2019-09-30T00:00:00.000","Pinellas","FL","Passenger","1","1","2","100","102","1.960784313725490196078431373"
"2019-09-30T00:00:00.000","Polk","FL","Passenger","1","0","1","68","69","1.449275362318840579710144928"
"2019-09-30T00:00:00.000","Santa Rosa","FL","Passenger","1","0","1","91","92","1.086956521739130434782608696"
"2019-09-30T00:00:00.000","Sarasota","FL","Passenger","1","0","1","27","28","3.571428571428571428571428571"
"2019-09-30T00:00:00.000","Sumter","FL","Passenger","0","1","1","9","10","10.0"
"2019-09-30T00:00:00.000","Volusia","FL","Passenger","0","1","1","35","36","2.777777777777777777777777778"
"2019-09-30T00:00:00.000","Bryan","GA","Passenger","1","0","1","51","52","1.923076923076923076923076923"
"2019-09-30T00:00:00.000","Camden","GA","Passenger","0","1","1","158","159","0.6289308176100628930817610063"
"2019-09-30T00:00:00.000","Columbia","GA","Passenger","1","1","2","139","141","1.418439716312056737588652482"
"2019-09-30T00:00:00.000","DeKalb","GA","Passenger","1","0","1","75","76","1.315789473684210526315789474"
"2019-09-30T00:00:00.000","Fulton","GA","Passenger","0","2","2","100","102","1.960784313725490196078431373"
"2019-09-30T00:00:00.000","Houston","GA","Passenger","1","0","1","56","57","1.754385964912280701754385965"
"2019-09-30T00:00:00.000","Jones","GA","Passenger","1","0","1","1","2","50.0"
"2019-09-30T00:00:00.000","Liberty","GA","Passenger","1","0","1","124","125","0.800"
"2019-09-30T00:00:00.000","Honolulu","HI","Passenger","4","1","5","478","483","1.035196687370600414078674948"
"2019-09-30T00:00:00.000","Maui","HI","Passenger","1","0","1","38","39","2.564102564102564102564102564"
"2019-09-30T00:00:00.000","Ada","ID","Passenger","0","2","2","288","290","0.6896551724137931034482758621"
"2019-09-30T00:00:00.000","Kootenai","ID","Passenger","1","1","2","207","209","0.9569377990430622009569377990"
"2019-09-30T00:00:00.000","Twin Falls","ID","Passenger","0","1","1","24","25","4.00"
"2019-09-30T00:00:00.000","Cook","IL","Passenger","1","0","1","225","226","0.4424778761061946902654867257"
"2019-09-30T00:00:00.000","DuPage","IL","Passenger","3","0","3","56","59","5.084745762711864406779661017"
"2019-09-30T00:00:00.000","Lake","IL","Passenger","1","0","1","174","175","0.5714285714285714285714285714"
"2019-09-30T00:00:00.000","Monroe","IL","Passenger","1","0","1","4","5","20.0"
"2019-09-30T00:00:00.000","Sangamon","IL","Passenger","1","0","1","7","8","12.500"
"2019-09-30T00:00:00.000","DeKalb","IN","Passenger","1","0","1","1","2","50.0"
"2019-09-30T00:00:00.000","Vigo","IN","Passenger","1","0","1","5","6","16.66666666666666666666666667"
"2019-09-30T00:00:00.000","Sedgwick","KS","Passenger","1","0","1","97","98","1.020408163265306122448979592"
"2019-09-30T00:00:00.000","Oldham","KY","Passenger","0","1","1","5","6","16.66666666666666666666666667"
"2019-09-30T00:00:00.000","Berkshire","MA","Passenger","0","1","1","5","6","16.66666666666666666666666667"
"2019-09-30T00:00:00.000","Franklin","MA","Passenger","0","1","1","1","2","50.0"
"2019-09-30T00:00:00.000","Middlesex","MA","Passenger","1","1","2","108","110","1.818181818181818181818181818"
"2019-09-30T00:00:00.000","Norfolk","MA","Passenger","1","0","1","29","30","3.333333333333333333333333333"
"2019-09-30T00:00:00.000","Suffolk","MA","Passenger","0","1","1","41","42","2.380952380952380952380952381"
"2019-09-30T00:00:00.000","Anne Arundel","MD","Passenger","1","2","3","440","443","0.6772009029345372460496613995"
"2019-09-30T00:00:00.000","Calvert","MD","Passenger","0","2","2","91","93","2.150537634408602150537634409"
"2019-09-30T00:00:00.000","Charles","MD","Passenger","0","1","1","83","84","1.190476190476190476190476190"
"2019-09-30T00:00:00.000","Frederick","MD","Passenger","2","1","3","84","87","3.448275862068965517241379310"
"2019-09-30T00:00:00.000","Howard","MD","Passenger","0","1","1","76","77","1.298701298701298701298701299"
"2019-09-30T00:00:00.000","Montgomery","MD","Passenger","0","2","2","279","281","0.7117437722419928825622775801"
"2019-09-30T00:00:00.000","St. Mary's","MD","Passenger","1","0","1","211","212","0.4716981132075471698113207547"
"2019-09-30T00:00:00.000","Penobscot","ME","Passenger","0","1","1","15","16","6.2500"
"2019-09-30T00:00:00.000","Kent","MI","Passenger","0","1","1","22","23","4.347826086956521739130434783"
"2019-09-30T00:00:00.000","Saginaw","MI","Passenger","1","0","1","12","13","7.692307692307692307692307692"
"2019-09-30T00:00:00.000","Washtenaw","MI","Passenger","1","0","1","34","35","2.857142857142857142857142857"
"2019-09-30T00:00:00.000","Wayne","MI","Passenger","0","1","1","61","62","1.612903225806451612903225806"
"2019-09-30T00:00:00.000","Hennepin","MN","Passenger","2","1","3","100","103","2.912621359223300970873786408"
"2019-09-30T00:00:00.000","Kanabec","MN","Passenger","1","0","1","0","1","100"
"2019-09-30T00:00:00.000","Ramsey","MN","Passenger","1","0","1","38","39","2.564102564102564102564102564"
"2019-09-30T00:00:00.000","Boone","MO","Passenger","0","1","1","9","10","10.0"
"2019-09-30T00:00:00.000","Greene","MO","Passenger","0","1","1","25","26","3.846153846153846153846153846"
"2019-09-30T00:00:00.000","Harrison","MS","Passenger","1","0","1","62","63","1.587301587301587301587301587"
"2019-09-30T00:00:00.000","Cascade","MT","Passenger","0","1","1","59","60","1.666666666666666666666666667"
"2019-09-30T00:00:00.000","Flathead","MT","Passenger","1","0","1","59","60","1.666666666666666666666666667"
"2019-09-30T00:00:00.000","Glacier","MT","Passenger","0","1","1","6","7","14.28571428571428571428571429"
"2019-09-30T00:00:00.000","Cumberland","NC","Passenger","0","2","2","509","511","0.3913894324853228962818003914"
"2019-09-30T00:00:00.000","Guilford","NC","Passenger","1","0","1","30","31","3.225806451612903225806451613"
"2019-09-30T00:00:00.000","Harnett","NC","Passenger","0","1","1","213","214","0.4672897196261682242990654206"
"2019-09-30T00:00:00.000","Moore","NC","Passenger","0","1","1","184","185","0.5405405405405405405405405405"
"2019-09-30T00:00:00.000","Douglas","NE","Passenger","0","1","1","60","61","1.639344262295081967213114754"
"2019-09-30T00:00:00.000","Carroll","NH","Passenger","0","1","1","2","3","33.33333333333333333333333333"
"2019-09-30T00:00:00.000","Camden","NJ","Passenger","0","1","1","23","24","4.166666666666666666666666667"
"2019-09-30T00:00:00.000","Hudson","NJ","Passenger","1","0","1","169","170","0.5882352941176470588235294118"
"2019-09-30T00:00:00.000","Chaves","NM","Passenger","1","0","1","8","9","11.11111111111111111111111111"
"2019-09-30T00:00:00.000","Santa Fe","NM","Passenger","0","1","1","38","39","2.564102564102564102564102564"
"2019-09-30T00:00:00.000","Valencia","NM","Passenger","1","0","1","5","6","16.66666666666666666666666667"
"2019-09-30T00:00:00.000","Carson City","NV","Passenger","1","0","1","10","11","9.090909090909090909090909091"
"2019-09-30T00:00:00.000","Clark","NV","Passenger","4","3","7","676","683","1.024890190336749633967789165"
"2019-09-30T00:00:00.000","Washoe","NV","Passenger","2","0","2","92","94","2.127659574468085106382978723"
"2019-09-30T00:00:00.000","Jefferson","NY","Passenger","0","2","2","228","230","0.8695652173913043478260869565"
"2019-09-30T00:00:00.000","Nassau","NY","Passenger","2","0","2","35","37","5.405405405405405405405405405"
"2019-09-30T00:00:00.000","Westchester","NY","Passenger","0","1","1","31","32","3.12500"
"2019-09-30T00:00:00.000","Shelby","OH","Passenger","0","1","1","1","2","50.0"
"2019-09-30T00:00:00.000","Oklahoma","OK","Passenger","0","2","2","120","122","1.639344262295081967213114754"
"2019-09-30T00:00:00.000","Rogers","OK","Passenger","1","0","1","5","6","16.66666666666666666666666667"
"2019-09-30T00:00:00.000","Tulsa","OK","Passenger","1","1","2","46","48","4.166666666666666666666666667"
"2019-09-30T00:00:00.000","Clackamas","OR","Passenger","2","1","3","201","204","1.470588235294117647058823529"
"2019-09-30T00:00:00.000","Deschutes","OR","Passenger","3","0","3","144","147","2.040816326530612244897959184"
"2019-09-30T00:00:00.000","Douglas","OR","Passenger","1","0","1","47","48","2.083333333333333333333333333"
"2019-09-30T00:00:00.000","Klamath","OR","Passenger","1","0","1","30","31","3.225806451612903225806451613"
"2019-09-30T00:00:00.000","Multnomah","OR","Passenger","5","5","10","703","713","1.402524544179523141654978962"
"2019-09-30T00:00:00.000","Allegheny","PA","Passenger","1","0","1","72","73","1.369863013698630136986301370"
"2019-09-30T00:00:00.000","Bucks","PA","Passenger","1","0","1","23","24","4.166666666666666666666666667"
"2019-09-30T00:00:00.000","Montgomery","PA","Passenger","2","0","2","30","32","6.2500"
"2019-09-30T00:00:00.000","RÃ­o Grande","PR","Passenger","1","0","1","1","2","50.0"
"2019-09-30T00:00:00.000","Newport","RI","Passenger","1","0","1","86","87","1.149425287356321839080459770"
"2019-09-30T00:00:00.000","Richland","SC","Passenger","0","1","1","155","156","0.6410256410256410256410256410"
"2019-09-30T00:00:00.000","Spartanburg","SC","Passenger","0","1","1","33","34","2.941176470588235294117647059"
"2019-09-30T00:00:00.000","Davidson","TN","Passenger","1","0","1","69","70","1.428571428571428571428571429"
"2019-09-30T00:00:00.000","Putnam","TN","Passenger","0","1","1","2","3","33.33333333333333333333333333"
"2019-09-30T00:00:00.000","Shelby","TN","Passenger","0","1","1","95","96","1.041666666666666666666666667"
"2019-09-30T00:00:00.000","Bell","TX","Passenger","0","1","1","433","434","0.2304147465437788018433179724"
"2019-09-30T00:00:00.000","Bexar","TX","Passenger","3","5","8","627","635","1.259842519685039370078740157"
"2019-09-30T00:00:00.000","Dallas","TX","Passenger","1","0","1","200","201","0.4975124378109452736318407960"
"2019-09-30T00:00:00.000","El Paso","TX","Passenger","2","0","2","468","470","0.4255319148936170212765957447"
"2019-09-30T00:00:00.000","Guadalupe","TX","Passenger","1","0","1","61","62","1.612903225806451612903225806"
"2019-09-30T00:00:00.000","Harris","TX","Passenger","1","1","2","239","241","0.8298755186721991701244813278"
"2019-09-30T00:00:00.000","Hidalgo","TX","Passenger","0","1","1","81","82","1.219512195121951219512195122"
"2019-09-30T00:00:00.000","Montgomery","TX","Passenger","1","0","1","53","54","1.851851851851851851851851852"
"2019-09-30T00:00:00.000","Nueces","TX","Passenger","1","1","2","91","93","2.150537634408602150537634409"
"2019-09-30T00:00:00.000","Tarrant","TX","Passenger","2","0","2","181","183","1.092896174863387978142076503"
"2019-09-30T00:00:00.000","Travis","TX","Passenger","2","1","3","191","194","1.546391752577319587628865979"
"2019-09-30T00:00:00.000","Albemarle","VA","Passenger","1","0","1","24","25","4.00"
"2019-09-30T00:00:00.000","Alexandria","VA","Passenger","3","0","3","146","149","2.013422818791946308724832215"
"2019-09-30T00:00:00.000","Arlington","VA","Passenger","0","2","2","151","153","1.307189542483660130718954248"
"2019-09-30T00:00:00.000","Chesapeake","VA","Passenger","0","1","1","448","449","0.2227171492204899777282850780"
"2019-09-30T00:00:00.000","Fairfax","VA","Passenger","3","3","6","754","760","0.7894736842105263157894736842"
"2019-09-30T00:00:00.000","Goochland","VA","Passenger","2","1","3","237","240","1.2500"
"2019-09-30T00:00:00.000","Loudoun","VA","Passenger","1","0","1","89","90","1.111111111111111111111111111"
"2019-09-30T00:00:00.000","Manassas","VA","Passenger","0","1","1","6","7","14.28571428571428571428571429"
"2019-09-30T00:00:00.000","Norfolk","VA","Passenger","2","1","3","347","350","0.8571428571428571428571428571"
"2019-09-30T00:00:00.000","Portsmouth","VA","Passenger","0","1","1","69","70","1.428571428571428571428571429"
"2019-09-30T00:00:00.000","Powhatan","VA","Passenger","1","0","1","0","1","100"
"2019-09-30T00:00:00.000","Prince William","VA","Passenger","1","3","4","236","240","1.666666666666666666666666667"
"2019-09-30T00:00:00.000","Stafford","VA","Passenger","1","1","2","96","98","2.040816326530612244897959184"
"2019-09-30T00:00:00.000","Virginia Beach","VA","Passenger","1","0","1","676","677","0.1477104874446085672082717873"
"2019-09-30T00:00:00.000","Adams","WA","Passenger","5","5","10","12888","12898","0.07753140021708792060784617770"
"2019-09-30T00:00:00.000","Adams","WA","Truck","0","0","0","5137","5137","0"
"2019-09-30T00:00:00.000","Asotin","WA","Truck","0","0","0","6688","6688","0"
"2019-09-30T00:00:00.000","Asotin","WA","Passenger","13","9","22","12636","12658","0.1738031284563122136198451572"
"2019-09-30T00:00:00.000","Benton","WA","Passenger","302","307","609","134627","135236","0.4503238782572687745866485255"
"2019-09-30T00:00:00.000","Benton","WA","Truck","0","0","0","42234","42234","0"
"2019-09-30T00:00:00.000","Chelan","WA","Passenger","176","72","248","54519","54767","0.4528274325780123066810305476"
"2019-09-30T00:00:00.000","Chelan","WA","Truck","0","0","0","22427","22427","0"
"2019-09-30T00:00:00.000","Clallam","WA","Truck","1","0","1","21843","21844","0.004577916132576451199414026735"
"2019-09-30T00:00:00.000","Clallam","WA","Passenger","198","157","355","50843","51198","0.6933864604086097113168483144"
"2019-09-30T00:00:00.000","Clark","WA","Passenger","1796","1024","2820","316019","318839","0.8844589275465046622276446733"
"2019-09-30T00:00:00.000","Clark","WA","Truck","0","0","0","80977","80977","0"
"2019-09-30T00:00:00.000","Columbia","WA","Truck","0","0","0","1537","1537","0"
"2019-09-30T00:00:00.000","Columbia","WA","Passenger","3","2","5","2445","2450","0.2040816326530612244897959184"
"2019-09-30T00:00:00.000","Cowlitz","WA","Truck","0","0","0","28969","28969","0"
"2019-09-30T00:00:00.000","Cowlitz","WA","Passenger","117","119","236","73301","73537","0.3209268803459482981356324027"
"2019-09-30T00:00:00.000","Douglas","WA","Passenger","63","37","100","28212","28312","0.3532071206555524159367052840"
"2019-09-30T00:00:00.000","Douglas","WA","Truck","0","0","0","12277","12277","0"
"2019-09-30T00:00:00.000","Ferry","WA","Passenger","5","2","7","4425","4432","0.1579422382671480144404332130"
"2019-09-30T00:00:00.000","Ferry","WA","Truck","0","0","0","3582","3582","0"
"2019-09-30T00:00:00.000","Franklin","WA","Truck","0","0","0","19539","19539","0"
"2019-09-30T00:00:00.000","Franklin","WA","Passenger","57","77","134","60374","60508","0.2214583195610497785416804390"
"2019-09-30T00:00:00.000","Garfield","WA","Passenger","0","1","1","1312","1313","0.07616146230007616146230007616"
"2019-09-30T00:00:00.000","Garfield","WA","Truck","0","0","0","970","970","0"
"2019-09-30T00:00:00.000","Grant","WA","Passenger","51","68","119","65181","65300","0.1822358346094946401225114855"
"2019-09-30T00:00:00.000","Grant","WA","Truck","0","0","0","26798","26798","0"
"2019-09-30T00:00:00.000","Grays Harbor","WA","Passenger","102","95","197","48094","48291","0.4079435091424903191070799942"
"2019-09-30T00:00:00.000","Grays Harbor","WA","Truck","0","0","0","20638","20638","0"
"2019-09-30T00:00:00.000","Island","WA","Truck","0","0","0","21307","21307","0"
"2019-09-30T00:00:00.000","Island","WA","Passenger","361","264","625","63503","64128","0.9746132734530938123752495010"
"2019-09-30T00:00:00.000","Jefferson","WA","Passenger","217","136","353","25127","25480","1.385400313971742543171114600"
"2019-09-30T00:00:00.000","Jefferson","WA","Truck","0","0","0","9686","9686","0"
"2019-09-30T00:00:00.000","King","WA","Passenger","20822","7576","28398","1394924","1423322","1.995191530799074278343199922"
"2019-09-30T00:00:00.000","King","WA","Truck","6","1","7","182452","182459","0.003836478332118448528162491299"
"2019-09-30T00:00:00.000","Kitsap","WA","Passenger","1207","670","1877","181632","183509","1.022838116931594635685443221"
"2019-09-30T00:00:00.000","Kitsap","WA","Truck","1","0","1","54246","54247","0.001843419912621896141722122882"
"2019-09-30T00:00:00.000","Kittitas","WA","Truck","0","0","0","14566","14566","0"
"2019-09-30T00:00:00.000","Kittitas","WA","Passenger","84","45","129","29836","29965","0.4305022526280660770899382613"
"2019-09-30T00:00:00.000","Klickitat","WA","Truck","0","0","0","8299","8299","0"
"2019-09-30T00:00:00.000","Klickitat","WA","Passenger","43","37","80","15625","15705","0.5093919134033747214262973575"
"2019-09-30T00:00:00.000","Lewis","WA","Truck","0","0","0","25972","25972","0"
"2019-09-30T00:00:00.000","Lewis","WA","Passenger","115","106","221","59350","59571","0.3709858823924392741434590657"
"2019-09-30T00:00:00.000","Lincoln","WA","Truck","0","0","0","4689","4689","0"
"2019-09-30T00:00:00.000","Lincoln","WA","Passenger","4","10","14","7812","7826","0.1788908765652951699463327370"
"2019-09-30T00:00:00.000","Mason","WA","Truck","0","0","0","20440","20440","0"
"2019-09-30T00:00:00.000","Mason","WA","Passenger","154","134","288","47436","47724","0.6034699522252954488307769676"
"2019-09-30T00:00:00.000","Okanogan","WA","Truck","0","0","0","16501","16501","0"
"2019-09-30T00:00:00.000","Okanogan","WA","Passenger","25","26","51","26240","26291","0.1939827317332927617815982656"
"2019-09-30T00:00:00.000","Pacific","WA","Truck","0","0","0","7678","7678","0"
"2019-09-30T00:00:00.000","Pacific","WA","Passenger","35","31","66","16068","16134","0.4090740052063964298995909260"
"2019-09-30T00:00:00.000","Pend Oreille","WA","Passenger","7","6","13","9473","9486","0.1370440649378030782205355260"
"2019-09-30T00:00:00.000","Pend Oreille","WA","Truck","0","0","0","5710","5710","0"
"2019-09-30T00:00:00.000","Pierce","WA","Truck","0","0","0","140526","140526","0"
"2019-09-30T00:00:00.000","Pierce","WA","Passenger","2187","1705","3892","545450","549342","0.7084839680927364010033822282"
"2019-09-30T00:00:00.000","San Juan","WA","Passenger","230","75","305","14431","14736","2.069761129207383279044516830"
"2019-09-30T00:00:00.000","San Juan","WA","Truck","0","0","0","5920","5920","0"
"2019-09-30T00:00:00.000","Skagit","WA","Truck","1","0","1","32528","32529","0.003074179962495004457560945618"
"2019-09-30T00:00:00.000","Skagit","WA","Passenger","344","227","571","92505","93076","0.6134771584511581933043964072"
"2019-09-30T00:00:00.000","Skamania","WA","Passenger","29","18","47","8788","8835","0.5319750990379173740803621958"
"2019-09-30T00:00:00.000","Skamania","WA","Truck","0","0","0","4088","4088","0"
"2019-09-30T00:00:00.000","Snohomish","WA","Truck","0","0","0","123006","123006","0"
"2019-09-30T00:00:00.000","Snohomish","WA","Passenger","3888","1765","5653","533889","539542","1.047740491009041001441963740"
"2019-09-30T00:00:00.000","Spokane","WA","Passenger","632","475","1107","313616","314723","0.3517378774350778303460503363"
"2019-09-30T00:00:00.000","Spokane","WA","Truck","1","0","1","95803","95804","0.001043797753747233935952569830"
"2019-09-30T00:00:00.000","Stevens","WA","Passenger","30","31","61","31671","31732","0.1922349678557922601789991176"
"2019-09-30T00:00:00.000","Stevens","WA","Truck","0","0","0","18754","18754","0"
"2019-09-30T00:00:00.000","Thurston","WA","Truck","0","0","0","55574","55574","0"
"2019-09-30T00:00:00.000","Thurston","WA","Passenger","1039","716","1755","198621","200376","0.8758533956162414660438375853"
"2019-09-30T00:00:00.000","Wahkiakum","WA","Truck","0","0","0","1760","1760","0"
"2019-09-30T00:00:00.000","Wahkiakum","WA","Passenger","2","4","6","3049","3055","0.1963993453355155482815057283"
"2019-09-30T00:00:00.000","Walla Walla","WA","Passenger","60","64","124","36271","36395","0.3407061409534276686358016211"
"2019-09-30T00:00:00.000","Walla Walla","WA","Truck","0","0","0","13695","13695","0"
"2019-09-30T00:00:00.000","Whatcom","WA","Passenger","974","478","1452","151334","152786","0.9503488539525872789391698192"
"2019-09-30T00:00:00.000","Whatcom","WA","Truck","2","0","2","43043","43045","0.004646300383319781623881983970"
"2019-09-30T00:00:00.000","Whitman","WA","Passenger","37","48","85","22726","22811","0.3726272412432598307833939766"
"2019-09-30T00:00:00.000","Whitman","WA","Truck","0","0","0","8610","8610","0"
"2019-09-30T00:00:00.000","Yakima","WA","Passenger","122","123","245","165675","165920","0.1476615236258437801350048216"
"2019-09-30T00:00:00.000","Yakima","WA","Truck","0","0","0","59406","59406","0"
"2019-09-30T00:00:00.000","Ozaukee","WI","Passenger","0","1","1","3","4","25.00"
"2019-09-30T00:00:00.000",,,"Passenger","2","0","2","243","245","0.8163265306122448979591836735"
"2019-10-31T00:00:00.000","Fairbanks North Star","AK","Passenger","0","1","1","102","103","0.9708737864077669902912621359"
"2019-10-31T00:00:00.000","Juneau","AK","Passenger","0","2","2","27","29","6.896551724137931034482758621"
"2019-10-31T00:00:00.000","Montgomery","AL","Passenger","0","1","1","39","40","2.500"
"2019-10-31T00:00:00.000","Cochise","AZ","Passenger","0","1","1","113","114","0.8771929824561403508771929825"
"2019-10-31T00:00:00.000","Maricopa","AZ","Passenger","7","6","13","1383","1396","0.9312320916905444126074498567"
"2019-10-31T00:00:00.000","Pima","AZ","Passenger","2","1","3","359","362","0.8287292817679558011049723757"
"2019-10-31T00:00:00.000","Pinal","AZ","Passenger","1","0","1","167","168","0.5952380952380952380952380952"
"2019-10-31T00:00:00.000","Alameda","CA","Passenger","5","1","6","284","290","2.068965517241379310344827586"
"2019-10-31T00:00:00.000","Contra Costa","CA","Passenger","2","2","4","395","399","1.002506265664160401002506266"
"2019-10-31T00:00:00.000","Fresno","CA","Passenger","1","0","1","190","191","0.5235602094240837696335078534"
"2019-10-31T00:00:00.000","Kern","CA","Passenger","1","1","2","227","229","0.8733624454148471615720524017"
"2019-10-31T00:00:00.000","Los Angeles","CA","Passenger","9","8","17","1046","1063","1.599247412982126058325493885"
"2019-10-31T00:00:00.000","Orange","CA","Passenger","6","3","9","505","514","1.750972762645914396887159533"
"2019-10-31T00:00:00.000","Riverside","CA","Passenger","4","1","5","621","626","0.7987220447284345047923322684"
"2019-10-31T00:00:00.000","San Bernardino","CA","Passenger","0","1","1","446","447","0.2237136465324384787472035794"
"2019-10-31T00:00:00.000","San Diego","CA","Passenger","10","5","15","2837","2852","0.5259467040673211781206171108"
"2019-10-31T00:00:00.000","San Francisco","CA","Passenger","2","1","3","94","97","3.092783505154639175257731959"
"2019-10-31T00:00:00.000","San Mateo","CA","Passenger","1","1","2","119","121","1.652892561983471074380165289"
"2019-10-31T00:00:00.000","Santa Barbara","CA","Passenger","2","0","2","92","94","2.127659574468085106382978723"
"2019-10-31T00:00:00.000","Santa Clara","CA","Passenger","5","2","7","350","357","1.960784313725490196078431373"
"2019-10-31T00:00:00.000","Santa Cruz","CA","Passenger","1","0","1","35","36","2.777777777777777777777777778"
"2019-10-31T00:00:00.000","Shasta","CA","Passenger","1","0","1","41","42","2.380952380952380952380952381"
"2019-10-31T00:00:00.000","Solano","CA","Passenger","1","0","1","211","212","0.4716981132075471698113207547"
"2019-10-31T00:00:00.000","Tuolumne","CA","Passenger","0","1","1","9","10","10.0"
"2019-10-31T00:00:00.000","Ventura","CA","Passenger","0","3","3","309","312","0.9615384615384615384615384615"
"2019-10-31T00:00:00.000","Arapahoe","CO","Passenger","1","0","1","142","143","0.6993006993006993006993006993"
"2019-10-31T00:00:00.000","Boulder","CO","Passenger","0","1","1","45","46","2.173913043478260869565217391"
"2019-10-31T00:00:00.000","Denver","CO","Passenger","1","0","1","126","127","0.7874015748031496062992125984"
"2019-10-31T00:00:00.000","El Paso","CO","Passenger","2","1","3","711","714","0.4201680672268907563025210084"
"2019-10-31T00:00:00.000","Jefferson","CO","Passenger","0","2","2","62","64","3.12500"
"2019-10-31T00:00:00.000","Larimer","CO","Passenger","1","1","2","55","57","3.508771929824561403508771930"
"2019-10-31T00:00:00.000","New London","CT","Passenger","0","2","2","261","263","0.7604562737642585551330798479"
"2019-10-31T00:00:00.000","District of Columbia","DC","Passenger","1","3","4","206","210","1.904761904761904761904761905"
"2019-10-31T00:00:00.000","Kent","DE","Passenger","0","1","1","75","76","1.315789473684210526315789474"
"2019-10-31T00:00:00.000","New Castle","DE","Passenger","1","0","1","26","27","3.703703703703703703703703704"
"2019-10-31T00:00:00.000","Brevard","FL","Passenger","0","1","1","83","84","1.190476190476190476190476190"
"2019-10-31T00:00:00.000","Broward","FL","Passenger","1","1","2","120","122","1.639344262295081967213114754"
"2019-10-31T00:00:00.000","Clay","FL","Passenger","0","1","1","83","84","1.190476190476190476190476190"
"2019-10-31T00:00:00.000","Duval","FL","Passenger","1","1","2","362","364","0.5494505494505494505494505495"
"2019-10-31T00:00:00.000","Lake","FL","Passenger","1","0","1","17","18","5.555555555555555555555555556"
"2019-10-31T00:00:00.000","Osceola","FL","Passenger","1","0","1","37","38","2.631578947368421052631578947"
"2019-10-31T00:00:00.000","Palm Beach","FL","Passenger","0","1","1","73","74","1.351351351351351351351351351"
"2019-10-31T00:00:00.000","Pinellas","FL","Passenger","1","1","2","96","98","2.040816326530612244897959184"
"2019-10-31T00:00:00.000","Polk","FL","Passenger","1","0","1","68","69","1.449275362318840579710144928"
"2019-10-31T00:00:00.000","Santa Rosa","FL","Passenger","1","0","1","91","92","1.086956521739130434782608696"
"2019-10-31T00:00:00.000","Sarasota","FL","Passenger","2","0","2","27","29","6.896551724137931034482758621"
"2019-10-31T00:00:00.000","Sumter","FL","Passenger","0","1","1","9","10","10.0"
"2019-10-31T00:00:00.000","Volusia","FL","Passenger","0","1","1","36","37","2.702702702702702702702702703"
"2019-10-31T00:00:00.000","Bryan","GA","Passenger","1","0","1","52","53","1.886792452830188679245283019"
"2019-10-31T00:00:00.000","Camden","GA","Passenger","0","1","1","159","160","0.62500"
"2019-10-31T00:00:00.000","Columbia","GA","Passenger","1","1","2","140","142","1.408450704225352112676056338"
"2019-10-31T00:00:00.000","DeKalb","GA","Passenger","1","0","1","76","77","1.298701298701298701298701299"
"2019-10-31T00:00:00.000","Fulton","GA","Passenger","0","2","2","100","102","1.960784313725490196078431373"
"2019-10-31T00:00:00.000","Houston","GA","Passenger","1","0","1","57","58","1.724137931034482758620689655"
"2019-10-31T00:00:00.000","Jones","GA","Passenger","1","0","1","1","2","50.0"
"2019-10-31T00:00:00.000","Liberty","GA","Passenger","1","0","1","122","123","0.8130081300813008130081300813"
"2019-10-31T00:00:00.000","Honolulu","HI","Passenger","4","1","5","473","478","1.046025104602510460251046025"
"2019-10-31T00:00:00.000","Maui","HI","Passenger","1","0","1","39","40","2.500"
"2019-10-31T00:00:00.000","Ada","ID","Passenger","0","2","2","284","286","0.6993006993006993006993006993"
"2019-10-31T00:00:00.000","Kootenai","ID","Passenger","1","1","2","206","208","0.9615384615384615384615384615"
"2019-10-31T00:00:00.000","Twin Falls","ID","Passenger","0","1","1","24","25","4.00"
"2019-10-31T00:00:00.000","Cook","IL","Passenger","1","0","1","218","219","0.4566210045662100456621004566"
"2019-10-31T00:00:00.000","DuPage","IL","Passenger","3","0","3","55","58","5.172413793103448275862068966"
"2019-10-31T00:00:00.000","Lake","IL","Passenger","1","0","1","175","176","0.5681818181818181818181818182"
"2019-10-31T00:00:00.000","Monroe","IL","Passenger","1","0","1","4","5","20.0"
"2019-10-31T00:00:00.000","Sangamon","IL","Passenger","1","0","1","6","7","14.28571428571428571428571429"
"2019-10-31T00:00:00.000","DeKalb","IN","Passenger","1","0","1","1","2","50.0"
"2019-10-31T00:00:00.000","Vigo","IN","Passenger","1","0","1","5","6","16.66666666666666666666666667"
"2019-10-31T00:00:00.000","Sedgwick","KS","Passenger","1","0","1","95","96","1.041666666666666666666666667"
"2019-10-31T00:00:00.000","Oldham","KY","Passenger","0","1","1","5","6","16.66666666666666666666666667"
"2019-10-31T00:00:00.000","Berkshire","MA","Passenger","0","1","1","5","6","16.66666666666666666666666667"
"2019-10-31T00:00:00.000","Franklin","MA","Passenger","0","1","1","1","2","50.0"
"2019-10-31T00:00:00.000","Middlesex","MA","Passenger","1","1","2","107","109","1.834862385321100917431192661"
"2019-10-31T00:00:00.000","Norfolk","MA","Passenger","1","0","1","29","30","3.333333333333333333333333333"
"2019-10-31T00:00:00.000","Suffolk","MA","Passenger","0","1","1","41","42","2.380952380952380952380952381"
"2019-10-31T00:00:00.000","Anne Arundel","MD","Passenger","1","2","3","441","444","0.6756756756756756756756756757"
"2019-10-31T00:00:00.000","Calvert","MD","Passenger","0","2","2","91","93","2.150537634408602150537634409"
"2019-10-31T00:00:00.000","Charles","MD","Passenger","0","1","1","79","80","1.2500"
"2019-10-31T00:00:00.000","Frederick","MD","Passenger","2","1","3","88","91","3.296703296703296703296703297"
"2019-10-31T00:00:00.000","Howard","MD","Passenger","0","1","1","75","76","1.315789473684210526315789474"
"2019-10-31T00:00:00.000","Montgomery","MD","Passenger","0","2","2","275","277","0.7220216606498194945848375451"
"2019-10-31T00:00:00.000","St. Mary's","MD","Passenger","1","0","1","210","211","0.4739336492890995260663507109"
"2019-10-31T00:00:00.000","Penobscot","ME","Passenger","0","1","1","15","16","6.2500"
"2019-10-31T00:00:00.000","Kent","MI","Passenger","0","1","1","22","23","4.347826086956521739130434783"
"2019-10-31T00:00:00.000","Saginaw","MI","Passenger","1","0","1","12","13","7.692307692307692307692307692"
"2019-10-31T00:00:00.000","Washtenaw","MI","Passenger","1","0","1","33","34","2.941176470588235294117647059"
"2019-10-31T00:00:00.000","Wayne","MI","Passenger","0","1","1","60","61","1.639344262295081967213114754"
"2019-10-31T00:00:00.000","Hennepin","MN","Passenger","2","1","3","96","99","3.030303030303030303030303030"
"2019-10-31T00:00:00.000","Kanabec","MN","Passenger","1","0","1","0","1","100"
"2019-10-31T00:00:00.000","Ramsey","MN","Passenger","1","0","1","38","39","2.564102564102564102564102564"
"2019-10-31T00:00:00.000","Boone","MO","Passenger","0","1","1","10","11","9.090909090909090909090909091"
"2019-10-31T00:00:00.000","Greene","MO","Passenger","0","1","1","25","26","3.846153846153846153846153846"
"2019-10-31T00:00:00.000","Harrison","MS","Passenger","1","0","1","59","60","1.666666666666666666666666667"
"2019-10-31T00:00:00.000","Cascade","MT","Passenger","0","1","1","58","59","1.694915254237288135593220339"
"2019-10-31T00:00:00.000","Flathead","MT","Passenger","1","0","1","58","59","1.694915254237288135593220339"
"2019-10-31T00:00:00.000","Glacier","MT","Passenger","0","1","1","6","7","14.28571428571428571428571429"
"2019-10-31T00:00:00.000","Cumberland","NC","Passenger","0","2","2","510","512","0.39062500"
"2019-10-31T00:00:00.000","Guilford","NC","Passenger","1","0","1","30","31","3.225806451612903225806451613"
"2019-10-31T00:00:00.000","Harnett","NC","Passenger","0","1","1","211","212","0.4716981132075471698113207547"
"2019-10-31T00:00:00.000","Mecklenburg","NC","Passenger","1","0","1","82","83","1.204819277108433734939759036"
"2019-10-31T00:00:00.000","Moore","NC","Passenger","0","1","1","181","182","0.5494505494505494505494505495"
"2019-10-31T00:00:00.000","Douglas","NE","Passenger","0","1","1","59","60","1.666666666666666666666666667"
"2019-10-31T00:00:00.000","Carroll","NH","Passenger","0","1","1","2","3","33.33333333333333333333333333"
"2019-10-31T00:00:00.000","Camden","NJ","Passenger","0","1","1","22","23","4.347826086956521739130434783"
"2019-10-31T00:00:00.000","Hudson","NJ","Passenger","1","0","1","165","166","0.6024096385542168674698795181"
"2019-10-31T00:00:00.000","Chaves","NM","Passenger","1","0","1","8","9","11.11111111111111111111111111"
"2019-10-31T00:00:00.000","Santa Fe","NM","Passenger","0","1","1","37","38","2.631578947368421052631578947"
"2019-10-31T00:00:00.000","Valencia","NM","Passenger","1","0","1","5","6","16.66666666666666666666666667"
"2019-10-31T00:00:00.000","Carson City","NV","Passenger","1","0","1","11","12","8.333333333333333333333333333"
"2019-10-31T00:00:00.000","Clark","NV","Passenger","4","3","7","676","683","1.024890190336749633967789165"
"2019-10-31T00:00:00.000","Washoe","NV","Passenger","2","0","2","91","93","2.150537634408602150537634409"
"2019-10-31T00:00:00.000","Jefferson","NY","Passenger","0","2","2","226","228","0.8771929824561403508771929825"
"2019-10-31T00:00:00.000","Nassau","NY","Passenger","2","0","2","36","38","5.263157894736842105263157895"
"2019-10-31T00:00:00.000","Queens","NY","Passenger","1","0","1","53","54","1.851851851851851851851851852"
"2019-10-31T00:00:00.000","Westchester","NY","Passenger","0","1","1","30","31","3.225806451612903225806451613"
"2019-10-31T00:00:00.000","Shelby","OH","Passenger","0","1","1","1","2","50.0"
"2019-10-31T00:00:00.000","Oklahoma","OK","Passenger","0","2","2","123","125","1.600"
"2019-10-31T00:00:00.000","Rogers","OK","Passenger","1","0","1","5","6","16.66666666666666666666666667"
"2019-10-31T00:00:00.000","Tulsa","OK","Passenger","1","1","2","45","47","4.255319148936170212765957447"
"2019-10-31T00:00:00.000","Clackamas","OR","Passenger","2","1","3","202","205","1.463414634146341463414634146"
"2019-10-31T00:00:00.000","Deschutes","OR","Passenger","3","0","3","141","144","2.083333333333333333333333333"
"2019-10-31T00:00:00.000","Douglas","OR","Passenger","1","0","1","46","47","2.127659574468085106382978723"
"2019-10-31T00:00:00.000","Klamath","OR","Passenger","1","0","1","30","31","3.225806451612903225806451613"
"2019-10-31T00:00:00.000","Multnomah","OR","Passenger","4","5","9","692","701","1.283880171184022824536376605"
"2019-10-31T00:00:00.000","Allegheny","PA","Passenger","1","0","1","70","71","1.408450704225352112676056338"
"2019-10-31T00:00:00.000","Bucks","PA","Passenger","1","0","1","24","25","4.00"
"2019-10-31T00:00:00.000","Montgomery","PA","Passenger","2","0","2","30","32","6.2500"
"2019-10-31T00:00:00.000","RÃ­o Grande","PR","Passenger","1","0","1","1","2","50.0"
"2019-10-31T00:00:00.000","Newport","RI","Passenger","1","0","1","87","88","1.136363636363636363636363636"
"2019-10-31T00:00:00.000","Richland","SC","Passenger","0","1","1","158","159","0.6289308176100628930817610063"
"2019-10-31T00:00:00.000","Spartanburg","SC","Passenger","0","1","1","35","36","2.777777777777777777777777778"
"2019-10-31T00:00:00.000","Davidson","TN","Passenger","1","0","1","68","69","1.449275362318840579710144928"
"2019-10-31T00:00:00.000","Putnam","TN","Passenger","0","1","1","2","3","33.33333333333333333333333333"
"2019-10-31T00:00:00.000","Shelby","TN","Passenger","0","1","1","97","98","1.020408163265306122448979592"
"2019-10-31T00:00:00.000","Bell","TX","Passenger","0","1","1","432","433","0.2309468822170900692840646651"
"2019-10-31T00:00:00.000","Bexar","TX","Passenger","3","5","8","624","632","1.265822784810126582278481013"
"2019-10-31T00:00:00.000","Dallas","TX","Passenger","1","0","1","203","204","0.4901960784313725490196078431"
"2019-10-31T00:00:00.000","El Paso","TX","Passenger","2","0","2","458","460","0.4347826086956521739130434783"
"2019-10-31T00:00:00.000","Guadalupe","TX","Passenger","1","0","1","59","60","1.666666666666666666666666667"
"2019-10-31T00:00:00.000","Harris","TX","Passenger","1","1","2","237","239","0.8368200836820083682008368201"
"2019-10-31T00:00:00.000","Hidalgo","TX","Passenger","0","1","1","81","82","1.219512195121951219512195122"
"2019-10-31T00:00:00.000","Montgomery","TX","Passenger","1","0","1","53","54","1.851851851851851851851851852"
"2019-10-31T00:00:00.000","Nueces","TX","Passenger","1","1","2","90","92","2.173913043478260869565217391"
"2019-10-31T00:00:00.000","Tarrant","TX","Passenger","2","0","2","183","185","1.081081081081081081081081081"
"2019-10-31T00:00:00.000","Travis","TX","Passenger","2","1","3","190","193","1.554404145077720207253886010"
"2019-10-31T00:00:00.000","Albemarle","VA","Passenger","1","0","1","25","26","3.846153846153846153846153846"
"2019-10-31T00:00:00.000","Alexandria","VA","Passenger","3","0","3","146","149","2.013422818791946308724832215"
"2019-10-31T00:00:00.000","Arlington","VA","Passenger","0","2","2","150","152","1.315789473684210526315789474"
"2019-10-31T00:00:00.000","Chesapeake","VA","Passenger","0","1","1","449","450","0.2222222222222222222222222222"
"2019-10-31T00:00:00.000","Fairfax","VA","Passenger","3","3","6","755","761","0.7884362680683311432325886991"
"2019-10-31T00:00:00.000","Goochland","VA","Passenger","3","1","4","239","243","1.646090534979423868312757202"
"2019-10-31T00:00:00.000","Loudoun","VA","Passenger","1","0","1","89","90","1.111111111111111111111111111"
"2019-10-31T00:00:00.000","Manassas","VA","Passenger","0","1","1","6","7","14.28571428571428571428571429"
"2019-10-31T00:00:00.000","Norfolk","VA","Passenger","2","1","3","349","352","0.8522727272727272727272727273"
"2019-10-31T00:00:00.000","Portsmouth","VA","Passenger","0","1","1","69","70","1.428571428571428571428571429"
"2019-10-31T00:00:00.000","Powhatan","VA","Passenger","1","0","1","0","1","100"
"2019-10-31T00:00:00.000","Prince William","VA","Passenger","1","3","4","228","232","1.724137931034482758620689655"
"2019-10-31T00:00:00.000","Stafford","VA","Passenger","1","1","2","95","97","2.061855670103092783505154639"
"2019-10-31T00:00:00.000","Virginia Beach","VA","Passenger","1","0","1","672","673","0.1485884101040118870728083210"
"2019-10-31T00:00:00.000","Adams","WA","Passenger","6","6","12","12913","12925","0.09284332688588007736943907157"
"2019-10-31T00:00:00.000","Adams","WA","Truck","0","0","0","5152","5152","0"
"2019-10-31T00:00:00.000","Asotin","WA","Passenger","13","9","22","12649","12671","0.1736248125641228000947044432"
"2019-10-31T00:00:00.000","Asotin","WA","Truck","0","0","0","6700","6700","0"
"2019-10-31T00:00:00.000","Benton","WA","Passenger","318","312","630","134953","135583","0.4646600237492901027414941401"
"2019-10-31T00:00:00.000","Benton","WA","Truck","0","0","0","42376","42376","0"
"2019-10-31T00:00:00.000","Chelan","WA","Truck","0","0","0","22502","22502","0"
"2019-10-31T00:00:00.000","Chelan","WA","Passenger","193","76","269","54665","54934","0.4896785233188917610223176903"
"2019-10-31T00:00:00.000","Clallam","WA","Passenger","207","155","362","50929","51291","0.7057768419410812813164102864"
"2019-10-31T00:00:00.000","Clallam","WA","Truck","1","0","1","21849","21850","0.004576659038901601830663615561"
"2019-10-31T00:00:00.000","Clark","WA","Passenger","1879","1057","2936","316895","319831","0.9179848107281658125697634063"
"2019-10-31T00:00:00.000","Clark","WA","Truck","0","0","0","81162","81162","0"
"2019-10-31T00:00:00.000","Columbia","WA","Passenger","3","2","5","2434","2439","0.2050020500205002050020500205"
"2019-10-31T00:00:00.000","Columbia","WA","Truck","0","0","0","1534","1534","0"
"2019-10-31T00:00:00.000","Cowlitz","WA","Passenger","123","119","242","73562","73804","0.3278955070185897783317977345"
"2019-10-31T00:00:00.000","Cowlitz","WA","Truck","0","0","0","29035","29035","0"
"2019-10-31T00:00:00.000","Douglas","WA","Truck","0","0","0","12296","12296","0"
"2019-10-31T00:00:00.000","Douglas","WA","Passenger","64","38","102","28277","28379","0.3594206984037492512068783255"
"2019-10-31T00:00:00.000","Ferry","WA","Truck","0","0","0","3574","3574","0"
"2019-10-31T00:00:00.000","Ferry","WA","Passenger","5","2","7","4427","4434","0.1578709968425800631483987370"
"2019-10-31T00:00:00.000","Franklin","WA","Passenger","60","80","140","60639","60779","0.2303427170568781980618305665"
"2019-10-31T00:00:00.000","Franklin","WA","Truck","0","0","0","19659","19659","0"
"2019-10-31T00:00:00.000","Garfield","WA","Passenger","0","1","1","1302","1303","0.07674597083653108211818879509"
"2019-10-31T00:00:00.000","Garfield","WA","Truck","0","0","0","963","963","0"
"2019-10-31T00:00:00.000","Grant","WA","Truck","0","0","0","26901","26901","0"
"2019-10-31T00:00:00.000","Grant","WA","Passenger","58","69","127","65387","65514","0.1938516958207406050615135696"
"2019-10-31T00:00:00.000","Grays Harbor","WA","Truck","0","0","0","20733","20733","0"
"2019-10-31T00:00:00.000","Grays Harbor","WA","Passenger","108","101","209","48300","48509","0.4308478838978333917417386464"
"2019-10-31T00:00:00.000","Island","WA","Passenger","377","265","642","63668","64310","0.9982895350645311771108692272"
"2019-10-31T00:00:00.000","Island","WA","Truck","0","0","0","21332","21332","0"
"2019-10-31T00:00:00.000","Jefferson","WA","Truck","0","0","0","9676","9676","0"
"2019-10-31T00:00:00.000","Jefferson","WA","Passenger","221","136","357","25159","25516","1.399122119454459946700109735"
"2019-10-31T00:00:00.000","King","WA","Passenger","21771","7690","29461","1396169","1425630","2.066524974923367213091755925"
"2019-10-31T00:00:00.000","King","WA","Truck","6","1","7","182447","182454","0.003836583467613754699814747827"
"2019-10-31T00:00:00.000","Kitsap","WA","Truck","1","0","1","54390","54391","0.001838539464249600117666525712"
"2019-10-31T00:00:00.000","Kitsap","WA","Passenger","1252","675","1927","182180","184107","1.046673945042828355249936178"
"2019-10-31T00:00:00.000","Kittitas","WA","Truck","0","0","0","14619","14619","0"
"2019-10-31T00:00:00.000","Kittitas","WA","Passenger","90","47","137","29970","30107","0.4550436775500714119639950842"
"2019-10-31T00:00:00.000","Klickitat","WA","Passenger","48","38","86","15666","15752","0.5459624174707973590655154901"
"2019-10-31T00:00:00.000","Klickitat","WA","Truck","0","0","0","8313","8313","0"
"2019-10-31T00:00:00.000","Lewis","WA","Passenger","117","107","224","59435","59659","0.3754672388072210395749174475"
"2019-10-31T00:00:00.000","Lewis","WA","Truck","0","0","0","26047","26047","0"
"2019-10-31T00:00:00.000","Lincoln","WA","Truck","0","0","0","4690","4690","0"
"2019-10-31T00:00:00.000","Lincoln","WA","Passenger","4","11","15","7836","7851","0.1910584638899503247993886129"
"2019-10-31T00:00:00.000","Mason","WA","Truck","0","0","0","20469","20469","0"
"2019-10-31T00:00:00.000","Mason","WA","Passenger","162","134","296","47553","47849","0.6186127191790842023866747476"
"2019-10-31T00:00:00.000","Okanogan","WA","Truck","0","0","0","16528","16528","0"
"2019-10-31T00:00:00.000","Okanogan","WA","Passenger","25","28","53","26255","26308","0.2014596320510871217880492626"
"2019-10-31T00:00:00.000","Pacific","WA","Passenger","39","31","70","16101","16171","0.4328736627295776389833652835"
"2019-10-31T00:00:00.000","Pacific","WA","Truck","0","0","0","7728","7728","0"
"2019-10-31T00:00:00.000","Pend Oreille","WA","Passenger","8","6","14","9494","9508","0.1472444257467395877156079091"
"2019-10-31T00:00:00.000","Pend Oreille","WA","Truck","0","0","0","5738","5738","0"
"2019-10-31T00:00:00.000","Pierce","WA","Passenger","2281","1736","4017","546985","551002","0.7290354662959481090812737522"
"2019-10-31T00:00:00.000","Pierce","WA","Truck","0","0","0","140745","140745","0"
"2019-10-31T00:00:00.000","San Juan","WA","Passenger","237","78","315","14409","14724","2.139364303178484107579462103"
"2019-10-31T00:00:00.000","San Juan","WA","Truck","0","0","0","5928","5928","0"
"2019-10-31T00:00:00.000","Skagit","WA","Passenger","365","228","593","92586","93179","0.6364094914090084675731656274"
"2019-10-31T00:00:00.000","Skagit","WA","Truck","1","0","1","32571","32572","0.003070121576814441851897335134"
"2019-10-31T00:00:00.000","Skamania","WA","Passenger","28","20","48","8804","8852","0.5422503389064618165386353366"
"2019-10-31T00:00:00.000","Skamania","WA","Truck","0","0","0","4102","4102","0"
"2019-10-31T00:00:00.000","Snohomish","WA","Passenger","4047","1789","5836","535074","540910","1.078922556432678264406278309"
"2019-10-31T00:00:00.000","Snohomish","WA","Truck","0","0","0","123049","123049","0"
"2019-10-31T00:00:00.000","Spokane","WA","Truck","1","0","1","96131","96132","0.001040236341696833520575874839"
"2019-10-31T00:00:00.000","Spokane","WA","Passenger","653","496","1149","314396","315545","0.3641318987783042038378044336"
"2019-10-31T00:00:00.000","Stevens","WA","Passenger","32","31","63","31625","31688","0.1988134309517798535723302196"
"2019-10-31T00:00:00.000","Stevens","WA","Truck","0","0","0","18776","18776","0"
"2019-10-31T00:00:00.000","Thurston","WA","Passenger","1090","732","1822","199142","200964","0.9066300431918154495332497363"
"2019-10-31T00:00:00.000","Thurston","WA","Truck","0","0","0","55677","55677","0"
"2019-10-31T00:00:00.000","Wahkiakum","WA","Passenger","4","4","8","3049","3057","0.2616944717042852469741576709"
"2019-10-31T00:00:00.000","Wahkiakum","WA","Truck","0","0","0","1752","1752","0"
"2019-10-31T00:00:00.000","Walla Walla","WA","Passenger","63","63","126","36344","36470","0.3454894433781190019193857965"
"2019-10-31T00:00:00.000","Walla Walla","WA","Truck","0","0","0","13678","13678","0"
"2019-10-31T00:00:00.000","Whatcom","WA","Truck","2","0","2","43111","43113","0.004638972003803957043119244775"
"2019-10-31T00:00:00.000","Whatcom","WA","Passenger","1001","489","1490","151472","152962","0.9740981420222015925523986350"
"2019-10-31T00:00:00.000","Whitman","WA","Passenger","39","48","87","22734","22821","0.3812278164848166162744840279"
"2019-10-31T00:00:00.000","Whitman","WA","Truck","0","0","0","8601","8601","0"
"2019-10-31T00:00:00.000","Yakima","WA","Truck","0","0","0","59500","59500","0"
"2019-10-31T00:00:00.000","Yakima","WA","Passenger","127","123","250","165928","166178","0.1504410932855131244809782282"
"2019-10-31T00:00:00.000","Ozaukee","WI","Passenger","0","1","1","3","4","25.00"
"2019-10-31T00:00:00.000",,,"Passenger","2","0","2","244","246","0.8130081300813008130081300813"
"2019-11-30T00:00:00.000","Fairbanks North Star","AK","Passenger","0","1","1","99","100","1.00"
"2019-11-30T00:00:00.000","Juneau","AK","Passenger","0","2","2","27","29","6.896551724137931034482758621"
"2019-11-30T00:00:00.000","Montgomery","AL","Passenger","0","1","1","38","39","2.564102564102564102564102564"
"2019-11-30T00:00:00.000","Cochise","AZ","Passenger","0","1","1","111","112","0.8928571428571428571428571429"
"2019-11-30T00:00:00.000","Maricopa","AZ","Passenger","7","6","13","1371","1384","0.9393063583815028901734104046"
"2019-11-30T00:00:00.000","Pima","AZ","Passenger","2","1","3","353","356","0.8426966292134831460674157303"
"2019-11-30T00:00:00.000","Pinal","AZ","Passenger","1","0","1","168","169","0.5917159763313609467455621302"
"2019-11-30T00:00:00.000","Alameda","CA","Passenger","5","1","6","278","284","2.112676056338028169014084507"
"2019-11-30T00:00:00.000","Contra Costa","CA","Passenger","3","2","5","388","393","1.272264631043256997455470738"
"2019-11-30T00:00:00.000","Fresno","CA","Passenger","1","0","1","189","190","0.5263157894736842105263157895"
"2019-11-30T00:00:00.000","Kern","CA","Passenger","1","1","2","224","226","0.8849557522123893805309734513"
"2019-11-30T00:00:00.000","Los Angeles","CA","Passenger","8","9","17","1039","1056","1.609848484848484848484848485"
"2019-11-30T00:00:00.000","Orange","CA","Passenger","6","2","8","501","509","1.571709233791748526522593320"
"2019-11-30T00:00:00.000","Riverside","CA","Passenger","4","1","5","611","616","0.8116883116883116883116883117"
"2019-11-30T00:00:00.000","San Bernardino","CA","Passenger","0","1","1","445","446","0.2242152466367713004484304933"
"2019-11-30T00:00:00.000","San Diego","CA","Passenger","9","5","14","2839","2853","0.4907115317209954433929197336"
"2019-11-30T00:00:00.000","San Francisco","CA","Passenger","2","1","3","93","96","3.12500"
"2019-11-30T00:00:00.000","San Mateo","CA","Passenger","1","1","2","120","122","1.639344262295081967213114754"
"2019-11-30T00:00:00.000","Santa Barbara","CA","Passenger","2","0","2","89","91","2.197802197802197802197802198"
"2019-11-30T00:00:00.000","Santa Clara","CA","Passenger","5","2","7","345","352","1.988636363636363636363636364"
"2019-11-30T00:00:00.000","Santa Cruz","CA","Passenger","1","0","1","36","37","2.702702702702702702702702703"
"2019-11-30T00:00:00.000","Shasta","CA","Passenger","1","0","1","39","40","2.500"
"2019-11-30T00:00:00.000","Solano","CA","Passenger","1","0","1","210","211","0.4739336492890995260663507109"
"2019-11-30T00:00:00.000","Tuolumne","CA","Passenger","0","1","1","8","9","11.11111111111111111111111111"
"2019-11-30T00:00:00.000","Ventura","CA","Passenger","0","3","3","309","312","0.9615384615384615384615384615"
"2019-11-30T00:00:00.000","Arapahoe","CO","Passenger","1","0","1","141","142","0.7042253521126760563380281690"
"2019-11-30T00:00:00.000","Boulder","CO","Passenger","0","1","1","44","45","2.222222222222222222222222222"
"2019-11-30T00:00:00.000","Denver","CO","Passenger","1","0","1","123","124","0.8064516129032258064516129032"
"2019-11-30T00:00:00.000","El Paso","CO","Passenger","2","1","3","718","721","0.4160887656033287101248266297"
"2019-11-30T00:00:00.000","Jefferson","CO","Passenger","0","2","2","62","64","3.12500"
"2019-11-30T00:00:00.000","Larimer","CO","Passenger","1","1","2","52","54","3.703703703703703703703703704"
"2019-11-30T00:00:00.000","New London","CT","Passenger","0","2","2","260","262","0.7633587786259541984732824427"
"2019-11-30T00:00:00.000","District of Columbia","DC","Passenger","1","3","4","207","211","1.895734597156398104265402844"
"2019-11-30T00:00:00.000","Kent","DE","Passenger","0","1","1","75","76","1.315789473684210526315789474"
"2019-11-30T00:00:00.000","New Castle","DE","Passenger","1","0","1","25","26","3.846153846153846153846153846"
"2019-11-30T00:00:00.000","Brevard","FL","Passenger","0","1","1","80","81","1.234567901234567901234567901"
"2019-11-30T00:00:00.000","Broward","FL","Passenger","1","1","2","120","122","1.639344262295081967213114754"
"2019-11-30T00:00:00.000","Clay","FL","Passenger","0","1","1","84","85","1.176470588235294117647058824"
"2019-11-30T00:00:00.000","Duval","FL","Passenger","1","1","2","358","360","0.5555555555555555555555555556"
"2019-11-30T00:00:00.000","Lake","FL","Passenger","1","0","1","17","18","5.555555555555555555555555556"
"2019-11-30T00:00:00.000","Osceola","FL","Passenger","1","0","1","40","41","2.439024390243902439024390244"
"2019-11-30T00:00:00.000","Palm Beach","FL","Passenger","0","1","1","72","73","1.369863013698630136986301370"
"2019-11-30T00:00:00.000","Pinellas","FL","Passenger","1","1","2","95","97","2.061855670103092783505154639"
"2019-11-30T00:00:00.000","Polk","FL","Passenger","1","0","1","68","69","1.449275362318840579710144928"
"2019-11-30T00:00:00.000","Santa Rosa","FL","Passenger","1","0","1","92","93","1.075268817204301075268817204"
"2019-11-30T00:00:00.000","Sarasota","FL","Passenger","2","0","2","26","28","7.142857142857142857142857143"
"2019-11-30T00:00:00.000","Sumter","FL","Passenger","0","1","1","9","10","10.0"
"2019-11-30T00:00:00.000","Volusia","FL","Passenger","0","1","1","36","37","2.702702702702702702702702703"
"2019-11-30T00:00:00.000","Bryan","GA","Passenger","1","0","1","52","53","1.886792452830188679245283019"
"2019-11-30T00:00:00.000","Camden","GA","Passenger","0","1","1","157","158","0.6329113924050632911392405063"
"2019-11-30T00:00:00.000","Columbia","GA","Passenger","1","1","2","141","143","1.398601398601398601398601399"
"2019-11-30T00:00:00.000","DeKalb","GA","Passenger","1","0","1","77","78","1.282051282051282051282051282"
"2019-11-30T00:00:00.000","Fulton","GA","Passenger","0","2","2","102","104","1.923076923076923076923076923"
"2019-11-30T00:00:00.000","Houston","GA","Passenger","1","0","1","59","60","1.666666666666666666666666667"
"2019-11-30T00:00:00.000","Jones","GA","Passenger","1","0","1","1","2","50.0"
"2019-11-30T00:00:00.000","Liberty","GA","Passenger","1","0","1","121","122","0.8196721311475409836065573770"
"2019-11-30T00:00:00.000","Honolulu","HI","Passenger","4","1","5","468","473","1.057082452431289640591966173"
"2019-11-30T00:00:00.000","Maui","HI","Passenger","1","0","1","38","39","2.564102564102564102564102564"
"2019-11-30T00:00:00.000","Ada","ID","Passenger","0","1","1","278","279","0.3584229390681003584229390681"
"2019-11-30T00:00:00.000","Kootenai","ID","Passenger","1","1","2","208","210","0.9523809523809523809523809524"
"2019-11-30T00:00:00.000","Twin Falls","ID","Passenger","0","1","1","25","26","3.846153846153846153846153846"
"2019-11-30T00:00:00.000","Cook","IL","Passenger","1","0","1","215","216","0.4629629629629629629629629630"
"2019-11-30T00:00:00.000","DuPage","IL","Passenger","3","0","3","58","61","4.918032786885245901639344262"
"2019-11-30T00:00:00.000","Lake","IL","Passenger","1","0","1","174","175","0.5714285714285714285714285714"
"2019-11-30T00:00:00.000","Monroe","IL","Passenger","1","0","1","3","4","25.00"
"2019-11-30T00:00:00.000","Sangamon","IL","Passenger","1","0","1","6","7","14.28571428571428571428571429"
"2019-11-30T00:00:00.000","DeKalb","IN","Passenger","1","0","1","1","2","50.0"
"2019-11-30T00:00:00.000","Vigo","IN","Passenger","1","0","1","5","6","16.66666666666666666666666667"
"2019-11-30T00:00:00.000","Sedgwick","KS","Passenger","1","0","1","94","95","1.052631578947368421052631579"
"2019-11-30T00:00:00.000","Oldham","KY","Passenger","0","1","1","5","6","16.66666666666666666666666667"
"2019-11-30T00:00:00.000","Berkshire","MA","Passenger","0","1","1","6","7","14.28571428571428571428571429"
"2019-11-30T00:00:00.000","Franklin","MA","Passenger","0","1","1","1","2","50.0"
"2019-11-30T00:00:00.000","Middlesex","MA","Passenger","1","1","2","108","110","1.818181818181818181818181818"
"2019-11-30T00:00:00.000","Norfolk","MA","Passenger","1","0","1","29","30","3.333333333333333333333333333"
"2019-11-30T00:00:00.000","Suffolk","MA","Passenger","0","1","1","39","40","2.500"
"2019-11-30T00:00:00.000","Anne Arundel","MD","Passenger","1","2","3","435","438","0.6849315068493150684931506849"
"2019-11-30T00:00:00.000","Calvert","MD","Passenger","0","2","2","91","93","2.150537634408602150537634409"
"2019-11-30T00:00:00.000","Charles","MD","Passenger","0","1","1","80","81","1.234567901234567901234567901"
"2019-11-30T00:00:00.000","Frederick","MD","Passenger","2","1","3","87","90","3.333333333333333333333333333"
"2019-11-30T00:00:00.000","Howard","MD","Passenger","0","1","1","73","74","1.351351351351351351351351351"
"2019-11-30T00:00:00.000","Montgomery","MD","Passenger","0","2","2","273","275","0.7272727272727272727272727273"
"2019-11-30T00:00:00.000","St. Mary's","MD","Passenger","1","0","1","209","210","0.4761904761904761904761904762"
"2019-11-30T00:00:00.000","Penobscot","ME","Passenger","0","1","1","15","16","6.2500"
"2019-11-30T00:00:00.000","Kent","MI","Passenger","0","1","1","23","24","4.166666666666666666666666667"
"2019-11-30T00:00:00.000","Saginaw","MI","Passenger","1","0","1","12","13","7.692307692307692307692307692"
"2019-11-30T00:00:00.000","Washtenaw","MI","Passenger","1","0","1","34","35","2.857142857142857142857142857"
"2019-11-30T00:00:00.000","Wayne","MI","Passenger","0","1","1","59","60","1.666666666666666666666666667"
"2019-11-30T00:00:00.000","Hennepin","MN","Passenger","2","1","3","96","99","3.030303030303030303030303030"
"2019-11-30T00:00:00.000","Kanabec","MN","Passenger","1","0","1","0","1","100"
"2019-11-30T00:00:00.000","Ramsey","MN","Passenger","1","0","1","38","39","2.564102564102564102564102564"
"2019-11-30T00:00:00.000","Boone","MO","Passenger","0","1","1","10","11","9.090909090909090909090909091"
"2019-11-30T00:00:00.000","Greene","MO","Passenger","0","1","1","25","26","3.846153846153846153846153846"
"2019-11-30T00:00:00.000","Harrison","MS","Passenger","1","0","1","59","60","1.666666666666666666666666667"
"2019-11-30T00:00:00.000","Cascade","MT","Passenger","0","1","1","57","58","1.724137931034482758620689655"
"2019-11-30T00:00:00.000","Flathead","MT","Passenger","1","0","1","59","60","1.666666666666666666666666667"
"2019-11-30T00:00:00.000","Glacier","MT","Passenger","0","1","1","6","7","14.28571428571428571428571429"
"2019-11-30T00:00:00.000","Cumberland","NC","Passenger","0","2","2","501","503","0.3976143141153081510934393638"
"2019-11-30T00:00:00.000","Guilford","NC","Passenger","1","0","1","30","31","3.225806451612903225806451613"
"2019-11-30T00:00:00.000","Harnett","NC","Passenger","0","1","1","208","209","0.4784688995215311004784688995"
"2019-11-30T00:00:00.000","Mecklenburg","NC","Passenger","1","0","1","80","81","1.234567901234567901234567901"
"2019-11-30T00:00:00.000","Moore","NC","Passenger","0","1","1","179","180","0.5555555555555555555555555556"
"2019-11-30T00:00:00.000","Douglas","NE","Passenger","0","1","1","60","61","1.639344262295081967213114754"
"2019-11-30T00:00:00.000","Carroll","NH","Passenger","0","1","1","2","3","33.33333333333333333333333333"
"2019-11-30T00:00:00.000","Camden","NJ","Passenger","0","1","1","21","22","4.545454545454545454545454545"
"2019-11-30T00:00:00.000","Hudson","NJ","Passenger","1","0","1","166","167","0.5988023952095808383233532934"
"2019-11-30T00:00:00.000","Chaves","NM","Passenger","1","0","1","8","9","11.11111111111111111111111111"
"2019-11-30T00:00:00.000","Valencia","NM","Passenger","1","0","1","4","5","20.0"
"2019-11-30T00:00:00.000","Carson City","NV","Passenger","1","0","1","10","11","9.090909090909090909090909091"
"2019-11-30T00:00:00.000","Clark","NV","Passenger","4","3","7","674","681","1.027900146842878120411160059"
"2019-11-30T00:00:00.000","Washoe","NV","Passenger","1","0","1","92","93","1.075268817204301075268817204"
"2019-11-30T00:00:00.000","Jefferson","NY","Passenger","0","2","2","227","229","0.8733624454148471615720524017"
"2019-11-30T00:00:00.000","Nassau","NY","Passenger","2","0","2","37","39","5.128205128205128205128205128"
"2019-11-30T00:00:00.000","Queens","NY","Passenger","1","0","1","54","55","1.818181818181818181818181818"
"2019-11-30T00:00:00.000","Westchester","NY","Passenger","0","1","1","30","31","3.225806451612903225806451613"
"2019-11-30T00:00:00.000","Montgomery","OH","Passenger","0","1","1","47","48","2.083333333333333333333333333"
"2019-11-30T00:00:00.000","Shelby","OH","Passenger","0","1","1","1","2","50.0"
"2019-11-30T00:00:00.000","Oklahoma","OK","Passenger","0","2","2","119","121","1.652892561983471074380165289"
"2019-11-30T00:00:00.000","Rogers","OK","Passenger","1","0","1","5","6","16.66666666666666666666666667"
"2019-11-30T00:00:00.000","Tulsa","OK","Passenger","1","1","2","46","48","4.166666666666666666666666667"
"2019-11-30T00:00:00.000","Clackamas","OR","Passenger","2","1","3","200","203","1.477832512315270935960591133"
"2019-11-30T00:00:00.000","Deschutes","OR","Passenger","3","0","3","137","140","2.142857142857142857142857143"
"2019-11-30T00:00:00.000","Douglas","OR","Passenger","1","0","1","47","48","2.083333333333333333333333333"
"2019-11-30T00:00:00.000","Klamath","OR","Passenger","1","0","1","29","30","3.333333333333333333333333333"
"2019-11-30T00:00:00.000","Multnomah","OR","Passenger","4","5","9","690","699","1.287553648068669527896995708"
"2019-11-30T00:00:00.000","Allegheny","PA","Passenger","1","0","1","69","70","1.428571428571428571428571429"
"2019-11-30T00:00:00.000","Bucks","PA","Passenger","1","0","1","22","23","4.347826086956521739130434783"
"2019-11-30T00:00:00.000","Montgomery","PA","Passenger","2","0","2","30","32","6.2500"
"2019-11-30T00:00:00.000","RÃ­o Grande","PR","Passenger","1","0","1","1","2","50.0"
"2019-11-30T00:00:00.000","Newport","RI","Passenger","1","0","1","88","89","1.123595505617977528089887640"
"2019-11-30T00:00:00.000","Richland","SC","Passenger","0","1","1","157","158","0.6329113924050632911392405063"
"2019-11-30T00:00:00.000","Spartanburg","SC","Passenger","0","1","1","37","38","2.631578947368421052631578947"
"2019-11-30T00:00:00.000","Davidson","TN","Passenger","1","0","1","68","69","1.449275362318840579710144928"
"2019-11-30T00:00:00.000","Putnam","TN","Passenger","0","1","1","2","3","33.33333333333333333333333333"
"2019-11-30T00:00:00.000","Shelby","TN","Passenger","0","1","1","97","98","1.020408163265306122448979592"
"2019-11-30T00:00:00.000","Bell","TX","Passenger","0","1","1","426","427","0.2341920374707259953161592506"
"2019-11-30T00:00:00.000","Bexar","TX","Passenger","3","5","8","623","631","1.267828843106180665610142631"
"2019-11-30T00:00:00.000","Dallas","TX","Passenger","1","0","1","200","201","0.4975124378109452736318407960"
"2019-11-30T00:00:00.000","El Paso","TX","Passenger","2","0","2","453","455","0.4395604395604395604395604396"
"2019-11-30T00:00:00.000","Guadalupe","TX","Passenger","1","0","1","58","59","1.694915254237288135593220339"
"2019-11-30T00:00:00.000","Harris","TX","Passenger","1","1","2","235","237","0.8438818565400843881856540084"
"2019-11-30T00:00:00.000","Hidalgo","TX","Passenger","0","1","1","82","83","1.204819277108433734939759036"
"2019-11-30T00:00:00.000","Montgomery","TX","Passenger","1","0","1","51","52","1.923076923076923076923076923"
"2019-11-30T00:00:00.000","Nueces","TX","Passenger","1","1","2","86","88","2.272727272727272727272727273"
"2019-11-30T00:00:00.000","Tarrant","TX","Passenger","2","0","2","180","182","1.098901098901098901098901099"
"2019-11-30T00:00:00.000","Travis","TX","Passenger","2","1","3","188","191","1.570680628272251308900523560"
"2019-11-30T00:00:00.000","Albemarle","VA","Passenger","1","0","1","25","26","3.846153846153846153846153846"
"2019-11-30T00:00:00.000","Alexandria","VA","Passenger","3","0","3","146","149","2.013422818791946308724832215"
"2019-11-30T00:00:00.000","Arlington","VA","Passenger","0","2","2","152","154","1.298701298701298701298701299"
"2019-11-30T00:00:00.000","Chesapeake","VA","Passenger","0","2","2","443","445","0.4494382022471910112359550562"
"2019-11-30T00:00:00.000","Fairfax","VA","Passenger","3","3","6","748","754","0.7957559681697612732095490716"
"2019-11-30T00:00:00.000","Goochland","VA","Passenger","3","1","4","235","239","1.673640167364016736401673640"
"2019-11-30T00:00:00.000","Loudoun","VA","Passenger","1","0","1","90","91","1.098901098901098901098901099"
"2019-11-30T00:00:00.000","Manassas","VA","Passenger","0","1","1","6","7","14.28571428571428571428571429"
"2019-11-30T00:00:00.000","Norfolk","VA","Passenger","1","1","2","347","349","0.5730659025787965616045845272"
"2019-11-30T00:00:00.000","Portsmouth","VA","Passenger","0","1","1","69","70","1.428571428571428571428571429"
"2019-11-30T00:00:00.000","Powhatan","VA","Passenger","1","0","1","0","1","100"
"2019-11-30T00:00:00.000","Prince William","VA","Passenger","1","3","4","226","230","1.739130434782608695652173913"
"2019-11-30T00:00:00.000","Stafford","VA","Passenger","1","1","2","95","97","2.061855670103092783505154639"
"2019-11-30T00:00:00.000","Suffolk","VA","Passenger","1","0","1","114","115","0.8695652173913043478260869565"
"2019-11-30T00:00:00.000","Virginia Beach","VA","Passenger","1","0","1","679","680","0.1470588235294117647058823529"
"2019-11-30T00:00:00.000","Adams","WA","Truck","0","0","0","5182","5182","0"
"2019-11-30T00:00:00.000","Adams","WA","Passenger","6","8","14","12928","12942","0.1081749343223613042806366868"
"2019-11-30T00:00:00.000","Asotin","WA","Truck","0","0","0","6700","6700","0"
"2019-11-30T00:00:00.000","Asotin","WA","Passenger","14","9","23","12661","12684","0.1813308104698833175654367707"
"2019-11-30T00:00:00.000","Benton","WA","Truck","0","0","0","42421","42421","0"
"2019-11-30T00:00:00.000","Benton","WA","Passenger","321","319","640","135120","135760","0.4714201532115497937536829699"
"2019-11-30T00:00:00.000","Chelan","WA","Passenger","198","76","274","54654","54928","0.4988348383338188173609088261"
"2019-11-30T00:00:00.000","Chelan","WA","Truck","0","0","0","22523","22523","0"
"2019-11-30T00:00:00.000","Clallam","WA","Truck","1","0","1","21849","21850","0.004576659038901601830663615561"
"2019-11-30T00:00:00.000","Clallam","WA","Passenger","207","158","365","50901","51266","0.7119728475012678968517145867"
"2019-11-30T00:00:00.000","Clark","WA","Passenger","1903","1067","2970","317458","320428","0.9268852909233899659205812226"
"2019-11-30T00:00:00.000","Clark","WA","Truck","0","0","0","81291","81291","0"
"2019-11-30T00:00:00.000","Columbia","WA","Passenger","3","2","5","2442","2447","0.2043318348998774008990600736"
"2019-11-30T00:00:00.000","Columbia","WA","Truck","0","0","0","1536","1536","0"
"2019-11-30T00:00:00.000","Cowlitz","WA","Passenger","125","119","244","73587","73831","0.3304844848369925911879833674"
"2019-11-30T00:00:00.000","Cowlitz","WA","Truck","0","0","0","29042","29042","0"
"2019-11-30T00:00:00.000","Douglas","WA","Passenger","66","38","104","28294","28398","0.3662229734488344249595041904"
"2019-11-30T00:00:00.000","Douglas","WA","Truck","0","0","0","12302","12302","0"
"2019-11-30T00:00:00.000","Ferry","WA","Passenger","5","2","7","4416","4423","0.1582636219760343658150576532"
"2019-11-30T00:00:00.000","Ferry","WA","Truck","0","0","0","3579","3579","0"
"2019-11-30T00:00:00.000","Franklin","WA","Truck","0","0","0","19732","19732","0"
"2019-11-30T00:00:00.000","Franklin","WA","Passenger","60","79","139","60794","60933","0.2281194098435987067762952751"
"2019-11-30T00:00:00.000","Garfield","WA","Passenger","0","1","1","1305","1306","0.07656967840735068912710566616"
"2019-11-30T00:00:00.000","Garfield","WA","Truck","0","0","0","965","965","0"
"2019-11-30T00:00:00.000","Grant","WA","Passenger","56","69","125","65508","65633","0.1904529733518199686133499916"
"2019-11-30T00:00:00.000","Grant","WA","Truck","0","0","0","26965","26965","0"
"2019-11-30T00:00:00.000","Grays Harbor","WA","Truck","0","0","0","20753","20753","0"
"2019-11-30T00:00:00.000","Grays Harbor","WA","Passenger","112","105","217","48346","48563","0.4468422461544797479562629986"
"2019-11-30T00:00:00.000","Island","WA","Passenger","378","267","645","63703","64348","1.002362155777957356872008454"
"2019-11-30T00:00:00.000","Island","WA","Truck","1","0","1","21331","21332","0.004687792987061691355709731858"
"2019-11-30T00:00:00.000","Jefferson","WA","Passenger","223","142","365","25181","25546","1.428795114695059891959602286"
"2019-11-30T00:00:00.000","Jefferson","WA","Truck","0","0","0","9658","9658","0"
"2019-11-30T00:00:00.000","King","WA","Truck","6","1","7","182395","182402","0.003837677218451552066315062335"
"2019-11-30T00:00:00.000","King","WA","Passenger","22007","7758","29765","1395593","1425358","2.088247303484457939689537646"
"2019-11-30T00:00:00.000","Kitsap","WA","Truck","1","0","1","54446","54447","0.001836648483846676584568479439"
"2019-11-30T00:00:00.000","Kitsap","WA","Passenger","1264","681","1945","182270","184215","1.055831501234970007871237413"
"2019-11-30T00:00:00.000","Kittitas","WA","Passenger","92","48","140","30017","30157","0.4642371588685877242431276321"
"2019-11-30T00:00:00.000","Kittitas","WA","Truck","0","0","0","14622","14622","0"
"2019-11-30T00:00:00.000","Klickitat","WA","Passenger","50","39","89","15674","15763","0.5646133350250586817230222673"
"2019-11-30T00:00:00.000","Klickitat","WA","Truck","0","0","0","8308","8308","0"
"2019-11-30T00:00:00.000","Lewis","WA","Passenger","118","108","226","59496","59722","0.3784200127256287465255684672"
"2019-11-30T00:00:00.000","Lewis","WA","Truck","0","0","0","26113","26113","0"
"2019-11-30T00:00:00.000","Lincoln","WA","Passenger","3","11","14","7804","7818","0.1790739319519058582757738552"
"2019-11-30T00:00:00.000","Lincoln","WA","Truck","0","0","0","4694","4694","0"
"2019-11-30T00:00:00.000","Mason","WA","Passenger","162","136","298","47599","47897","0.6221684030315051047038436645"
"2019-11-30T00:00:00.000","Mason","WA","Truck","0","0","0","20510","20510","0"
"2019-11-30T00:00:00.000","Okanogan","WA","Passenger","28","30","58","26240","26298","0.2205490911856414936497072021"
"2019-11-30T00:00:00.000","Okanogan","WA","Truck","0","0","0","16562","16562","0"
"2019-11-30T00:00:00.000","Pacific","WA","Passenger","38","33","71","16103","16174","0.4389761345369110918758501298"
"2019-11-30T00:00:00.000","Pacific","WA","Truck","0","0","0","7742","7742","0"
"2019-11-30T00:00:00.000","Pend Oreille","WA","Truck","0","0","0","5732","5732","0"
"2019-11-30T00:00:00.000","Pend Oreille","WA","Passenger","8","7","15","9517","9532","0.1573646663869072597566093160"
"2019-11-30T00:00:00.000","Pierce","WA","Passenger","2303","1746","4049","547578","551627","0.7340104817204379045985783872"
"2019-11-30T00:00:00.000","Pierce","WA","Truck","0","0","0","140762","140762","0"
"2019-11-30T00:00:00.000","San Juan","WA","Truck","0","0","0","5933","5933","0"
"2019-11-30T00:00:00.000","San Juan","WA","Passenger","244","80","324","14405","14729","2.199742005567248285694887637"
"2019-11-30T00:00:00.000","Skagit","WA","Passenger","376","229","605","92562","93167","0.6493715585990747796966737149"
"2019-11-30T00:00:00.000","Skagit","WA","Truck","1","0","1","32552","32553","0.003071913494915983165914047860"
"2019-11-30T00:00:00.000","Skamania","WA","Passenger","29","20","49","8790","8839","0.5543613530942414300260210431"
"2019-11-30T00:00:00.000","Skamania","WA","Truck","0","0","0","4097","4097","0"
"2019-11-30T00:00:00.000","Snohomish","WA","Passenger","4093","1810","5903","535378","541281","1.090561094884172915731385362"
"2019-11-30T00:00:00.000","Snohomish","WA","Truck","0","0","0","123202","123202","0"
"2019-11-30T00:00:00.000","Spokane","WA","Passenger","668","503","1171","314695","315866","0.3707268271988754725104949567"
"2019-11-30T00:00:00.000","Spokane","WA","Truck","1","0","1","96262","96263","0.001038820730706501978953491996"
"2019-11-30T00:00:00.000","Stevens","WA","Truck","0","0","0","18798","18798","0"
"2019-11-30T00:00:00.000","Stevens","WA","Passenger","34","33","67","31607","31674","0.2115299614826040285407589821"
"2019-11-30T00:00:00.000","Thurston","WA","Passenger","1123","751","1874","199159","201033","0.9321852631160058298886252506"
"2019-11-30T00:00:00.000","Thurston","WA","Truck","0","0","0","55689","55689","0"
"2019-11-30T00:00:00.000","Wahkiakum","WA","Passenger","4","4","8","3037","3045","0.2627257799671592775041050903"
"2019-11-30T00:00:00.000","Wahkiakum","WA","Truck","0","0","0","1752","1752","0"
"2019-11-30T00:00:00.000","Walla Walla","WA","Passenger","65","62","127","36299","36426","0.3486520617141602152308790424"
"2019-11-30T00:00:00.000","Walla Walla","WA","Truck","0","0","0","13680","13680","0"
"2019-11-30T00:00:00.000","Whatcom","WA","Passenger","1016","489","1505","151590","153095","0.9830497403572944903491296254"
"2019-11-30T00:00:00.000","Whatcom","WA","Truck","2","0","2","43164","43166","0.004633276189593661678172635871"
"2019-11-30T00:00:00.000","Whitman","WA","Truck","0","0","0","8585","8585","0"
"2019-11-30T00:00:00.000","Whitman","WA","Passenger","42","49","91","22722","22813","0.3988953666768947529917152501"
"2019-11-30T00:00:00.000","Yakima","WA","Passenger","129","125","254","166022","166276","0.1527580649041352931270898987"
"2019-11-30T00:00:00.000","Yakima","WA","Truck","0","0","0","59597","59597","0"
"2019-11-30T00:00:00.000","Ozaukee","WI","Passenger","0","1","1","3","4","25.00"
"2019-11-30T00:00:00.000",,,"Passenger","2","0","2","240","242","0.8264462809917355371900826446"
"2019-12-31T00:00:00.000","Fairbanks North Star","AK","Passenger","0","1","1","100","101","0.9900990099009900990099009901"
"2019-12-31T00:00:00.000","Juneau","AK","Passenger","0","2","2","28","30","6.666666666666666666666666667"
"2019-12-31T00:00:00.000","Montgomery","AL","Passenger","0","1","1","38","39","2.564102564102564102564102564"
"2019-12-31T00:00:00.000","Cochise","AZ","Passenger","0","1","1","111","112","0.8928571428571428571428571429"
"2019-12-31T00:00:00.000","Maricopa","AZ","Passenger","8","6","14","1357","1371","1.021152443471918307804522247"
"2019-12-31T00:00:00.000","Pima","AZ","Passenger","3","1","4","349","353","1.133144475920679886685552408"
"2019-12-31T00:00:00.000","Pinal","AZ","Passenger","1","0","1","167","168","0.5952380952380952380952380952"
"2019-12-31T00:00:00.000","Alameda","CA","Passenger","5","1","6","277","283","2.120141342756183745583038869"
"2019-12-31T00:00:00.000","Contra Costa","CA","Passenger","3","2","5","381","386","1.295336787564766839378238342"
"2019-12-31T00:00:00.000","Fresno","CA","Passenger","1","0","1","185","186","0.5376344086021505376344086022"
"2019-12-31T00:00:00.000","Kern","CA","Passenger","1","1","2","226","228","0.8771929824561403508771929825"
"2019-12-31T00:00:00.000","Los Angeles","CA","Passenger","8","9","17","1033","1050","1.619047619047619047619047619"
"2019-12-31T00:00:00.000","Orange","CA","Passenger","6","2","8","498","506","1.581027667984189723320158103"
"2019-12-31T00:00:00.000","Riverside","CA","Passenger","4","1","5","607","612","0.8169934640522875816993464052"
"2019-12-31T00:00:00.000","San Bernardino","CA","Passenger","0","1","1","437","438","0.2283105022831050228310502283"
"2019-12-31T00:00:00.000","San Diego","CA","Passenger","9","5","14","2837","2851","0.4910557699052963872325499825"
"2019-12-31T00:00:00.000","San Francisco","CA","Passenger","2","1","3","92","95","3.157894736842105263157894737"
"2019-12-31T00:00:00.000","San Mateo","CA","Passenger","1","1","2","119","121","1.652892561983471074380165289"
"2019-12-31T00:00:00.000","Santa Barbara","CA","Passenger","2","0","2","89","91","2.197802197802197802197802198"
"2019-12-31T00:00:00.000","Santa Clara","CA","Passenger","6","2","8","335","343","2.332361516034985422740524781"
"2019-12-31T00:00:00.000","Santa Cruz","CA","Passenger","1","0","1","36","37","2.702702702702702702702702703"
"2019-12-31T00:00:00.000","Shasta","CA","Passenger","1","0","1","38","39","2.564102564102564102564102564"
"2019-12-31T00:00:00.000","Solano","CA","Passenger","1","0","1","213","214","0.4672897196261682242990654206"
"2019-12-31T00:00:00.000","Tuolumne","CA","Passenger","0","1","1","8","9","11.11111111111111111111111111"
"2019-12-31T00:00:00.000","Ventura","CA","Passenger","0","3","3","305","308","0.9740259740259740259740259740"
"2019-12-31T00:00:00.000","Arapahoe","CO","Passenger","1","0","1","136","137","0.7299270072992700729927007299"
"2019-12-31T00:00:00.000","Boulder","CO","Passenger","0","1","1","44","45","2.222222222222222222222222222"
"2019-12-31T00:00:00.000","Denver","CO","Passenger","1","0","1","122","123","0.8130081300813008130081300813"
"2019-12-31T00:00:00.000","El Paso","CO","Passenger","2","1","3","718","721","0.4160887656033287101248266297"
"2019-12-31T00:00:00.000","Jefferson","CO","Passenger","0","2","2","61","63","3.174603174603174603174603175"
"2019-12-31T00:00:00.000","Larimer","CO","Passenger","1","1","2","50","52","3.846153846153846153846153846"
"2019-12-31T00:00:00.000","New London","CT","Passenger","0","2","2","261","263","0.7604562737642585551330798479"
"2019-12-31T00:00:00.000","District of Columbia","DC","Passenger","1","3","4","208","212","1.886792452830188679245283019"
"2019-12-31T00:00:00.000","Kent","DE","Passenger","0","1","1","72","73","1.369863013698630136986301370"
"2019-12-31T00:00:00.000","New Castle","DE","Passenger","1","0","1","24","25","4.00"
"2019-12-31T00:00:00.000","Brevard","FL","Passenger","0","1","1","80","81","1.234567901234567901234567901"
"2019-12-31T00:00:00.000","Broward","FL","Passenger","1","1","2","120","122","1.639344262295081967213114754"
"2019-12-31T00:00:00.000","Clay","FL","Passenger","0","1","1","83","84","1.190476190476190476190476190"
"2019-12-31T00:00:00.000","Duval","FL","Passenger","1","1","2","353","355","0.5633802816901408450704225352"
"2019-12-31T00:00:00.000","Lake","FL","Passenger","1","0","1","17","18","5.555555555555555555555555556"
"2019-12-31T00:00:00.000","Osceola","FL","Passenger","1","0","1","39","40","2.500"
"2019-12-31T00:00:00.000","Palm Beach","FL","Passenger","0","1","1","72","73","1.369863013698630136986301370"
"2019-12-31T00:00:00.000","Pinellas","FL","Passenger","1","1","2","95","97","2.061855670103092783505154639"
"2019-12-31T00:00:00.000","Polk","FL","Passenger","1","0","1","67","68","1.470588235294117647058823529"
"2019-12-31T00:00:00.000","Santa Rosa","FL","Passenger","1","0","1","90","91","1.098901098901098901098901099"
"2019-12-31T00:00:00.000","Sarasota","FL","Passenger","2","0","2","26","28","7.142857142857142857142857143"
"2019-12-31T00:00:00.000","Sumter","FL","Passenger","0","1","1","9","10","10.0"
"2019-12-31T00:00:00.000","Bryan","GA","Passenger","1","0","1","52","53","1.886792452830188679245283019"
"2019-12-31T00:00:00.000","Camden","GA","Passenger","0","1","1","158","159","0.6289308176100628930817610063"
"2019-12-31T00:00:00.000","Columbia","GA","Passenger","1","1","2","140","142","1.408450704225352112676056338"
"2019-12-31T00:00:00.000","DeKalb","GA","Passenger","1","0","1","77","78","1.282051282051282051282051282"
"2019-12-31T00:00:00.000","Fulton","GA","Passenger","0","2","2","101","103","1.941747572815533980582524272"
"2019-12-31T00:00:00.000","Houston","GA","Passenger","1","0","1","60","61","1.639344262295081967213114754"
"2019-12-31T00:00:00.000","Jones","GA","Passenger","1","0","1","1","2","50.0"
"2019-12-31T00:00:00.000","Liberty","GA","Passenger","1","0","1","119","120","0.8333333333333333333333333333"
"2019-12-31T00:00:00.000","Honolulu","HI","Passenger","4","1","5","464","469","1.066098081023454157782515991"
"2019-12-31T00:00:00.000","Maui","HI","Passenger","1","0","1","34","35","2.857142857142857142857142857"
"2019-12-31T00:00:00.000","Ada","ID","Passenger","0","1","1","273","274","0.3649635036496350364963503650"
"2019-12-31T00:00:00.000","Kootenai","ID","Passenger","1","1","2","208","210","0.9523809523809523809523809524"
"2019-12-31T00:00:00.000","Twin Falls","ID","Passenger","0","1","1","25","26","3.846153846153846153846153846"
"2019-12-31T00:00:00.000","DuPage","IL","Passenger","3","0","3","59","62","4.838709677419354838709677419"
"2019-12-31T00:00:00.000","Lake","IL","Passenger","1","0","1","170","171","0.5847953216374269005847953216"
"2019-12-31T00:00:00.000","Monroe","IL","Passenger","1","0","1","3","4","25.00"
"2019-12-31T00:00:00.000","DeKalb","IN","Passenger","1","0","1","1","2","50.0"
"2019-12-31T00:00:00.000","Vigo","IN","Passenger","1","0","1","5","6","16.66666666666666666666666667"
"2019-12-31T00:00:00.000","Sedgwick","KS","Passenger","1","0","1","94","95","1.052631578947368421052631579"
"2019-12-31T00:00:00.000","Oldham","KY","Passenger","0","1","1","4","5","20.0"
"2019-12-31T00:00:00.000","Berkshire","MA","Passenger","0","1","1","6","7","14.28571428571428571428571429"
"2019-12-31T00:00:00.000","Middlesex","MA","Passenger","1","1","2","109","111","1.801801801801801801801801802"
"2019-12-31T00:00:00.000","Norfolk","MA","Passenger","1","0","1","29","30","3.333333333333333333333333333"
"2019-12-31T00:00:00.000","Suffolk","MA","Passenger","0","1","1","37","38","2.631578947368421052631578947"
"2019-12-31T00:00:00.000","Anne Arundel","MD","Passenger","1","2","3","432","435","0.6896551724137931034482758621"
"2019-12-31T00:00:00.000","Calvert","MD","Passenger","0","2","2","90","92","2.173913043478260869565217391"
"2019-12-31T00:00:00.000","Charles","MD","Passenger","0","1","1","79","80","1.2500"
"2019-12-31T00:00:00.000","Frederick","MD","Passenger","2","1","3","85","88","3.409090909090909090909090909"
"2019-12-31T00:00:00.000","Howard","MD","Passenger","0","1","1","75","76","1.315789473684210526315789474"
"2019-12-31T00:00:00.000","Montgomery","MD","Passenger","0","2","2","268","270","0.7407407407407407407407407407"
"2019-12-31T00:00:00.000","St. Mary's","MD","Passenger","1","0","1","208","209","0.4784688995215311004784688995"
"2019-12-31T00:00:00.000","Penobscot","ME","Passenger","0","1","1","15","16","6.2500"
"2019-12-31T00:00:00.000","Kent","MI","Passenger","0","1","1","23","24","4.166666666666666666666666667"
"2019-12-31T00:00:00.000","Saginaw","MI","Passenger","1","0","1","12","13","7.692307692307692307692307692"
"2019-12-31T00:00:00.000","Washtenaw","MI","Passenger","1","0","1","35","36","2.777777777777777777777777778"
"2019-12-31T00:00:00.000","Wayne","MI","Passenger","0","1","1","57","58","1.724137931034482758620689655"
"2019-12-31T00:00:00.000","Hennepin","MN","Passenger","2","1","3","96","99","3.030303030303030303030303030"
"2019-12-31T00:00:00.000","Kanabec","MN","Passenger","1","0","1","0","1","100"
"2019-12-31T00:00:00.000","Ramsey","MN","Passenger","1","0","1","37","38","2.631578947368421052631578947"
"2019-12-31T00:00:00.000","Boone","MO","Passenger","0","1","1","10","11","9.090909090909090909090909091"
"2019-12-31T00:00:00.000","Greene","MO","Passenger","0","1","1","25","26","3.846153846153846153846153846"
"2019-12-31T00:00:00.000","Harrison","MS","Passenger","1","0","1","58","59","1.694915254237288135593220339"
"2019-12-31T00:00:00.000","Cascade","MT","Passenger","0","1","1","56","57","1.754385964912280701754385965"
"2019-12-31T00:00:00.000","Flathead","MT","Passenger","1","0","1","58","59","1.694915254237288135593220339"
"2019-12-31T00:00:00.000","Glacier","MT","Passenger","0","1","1","5","6","16.66666666666666666666666667"
"2019-12-31T00:00:00.000","Cumberland","NC","Passenger","0","2","2","501","503","0.3976143141153081510934393638"
"2019-12-31T00:00:00.000","Guilford","NC","Passenger","1","0","1","31","32","3.12500"
"2019-12-31T00:00:00.000","Harnett","NC","Passenger","0","1","1","207","208","0.4807692307692307692307692308"
"2019-12-31T00:00:00.000","Mecklenburg","NC","Passenger","1","0","1","77","78","1.282051282051282051282051282"
"2019-12-31T00:00:00.000","Moore","NC","Passenger","0","1","1","170","171","0.5847953216374269005847953216"
"2019-12-31T00:00:00.000","Douglas","NE","Passenger","0","1","1","59","60","1.666666666666666666666666667"
"2019-12-31T00:00:00.000","Carroll","NH","Passenger","0","1","1","2","3","33.33333333333333333333333333"
"2019-12-31T00:00:00.000","Camden","NJ","Passenger","0","2","2","20","22","9.090909090909090909090909091"
"2019-12-31T00:00:00.000","Hudson","NJ","Passenger","1","0","1","161","162","0.6172839506172839506172839506"
"2019-12-31T00:00:00.000","Chaves","NM","Passenger","1","0","1","8","9","11.11111111111111111111111111"
"2019-12-31T00:00:00.000","Valencia","NM","Passenger","1","0","1","4","5","20.0"
"2019-12-31T00:00:00.000","Carson City","NV","Passenger","1","0","1","10","11","9.090909090909090909090909091"
"2019-12-31T00:00:00.000","Clark","NV","Passenger","3","3","6","671","677","0.8862629246676514032496307238"
"2019-12-31T00:00:00.000","Washoe","NV","Passenger","1","0","1","91","92","1.086956521739130434782608696"
"2019-12-31T00:00:00.000","Jefferson","NY","Passenger","0","2","2","228","230","0.8695652173913043478260869565"
"2019-12-31T00:00:00.000","Nassau","NY","Passenger","2","0","2","37","39","5.128205128205128205128205128"
"2019-12-31T00:00:00.000","Queens","NY","Passenger","1","0","1","51","52","1.923076923076923076923076923"
"2019-12-31T00:00:00.000","Westchester","NY","Passenger","0","1","1","30","31","3.225806451612903225806451613"
"2019-12-31T00:00:00.000","Montgomery","OH","Passenger","0","1","1","47","48","2.083333333333333333333333333"
"2019-12-31T00:00:00.000","Shelby","OH","Passenger","0","1","1","1","2","50.0"
"2019-12-31T00:00:00.000","Oklahoma","OK","Passenger","0","2","2","121","123","1.626016260162601626016260163"
"2019-12-31T00:00:00.000","Rogers","OK","Passenger","1","0","1","5","6","16.66666666666666666666666667"
"2019-12-31T00:00:00.000","Tulsa","OK","Passenger","1","1","2","46","48","4.166666666666666666666666667"
"2019-12-31T00:00:00.000","Clackamas","OR","Passenger","2","1","3","197","200","1.500"
"2019-12-31T00:00:00.000","Deschutes","OR","Passenger","3","0","3","138","141","2.127659574468085106382978723"
"2019-12-31T00:00:00.000","Douglas","OR","Passenger","1","0","1","46","47","2.127659574468085106382978723"
"2019-12-31T00:00:00.000","Klamath","OR","Passenger","1","0","1","29","30","3.333333333333333333333333333"
"2019-12-31T00:00:00.000","Multnomah","OR","Passenger","4","5","9","689","698","1.289398280802292263610315186"
"2019-12-31T00:00:00.000","Washington","OR","Passenger","1","0","1","419","420","0.2380952380952380952380952381"
"2019-12-31T00:00:00.000","Allegheny","PA","Passenger","1","0","1","66","67","1.492537313432835820895522388"
"2019-12-31T00:00:00.000","Bucks","PA","Passenger","1","0","1","21","22","4.545454545454545454545454545"
"2019-12-31T00:00:00.000","Montgomery","PA","Passenger","2","0","2","29","31","6.451612903225806451612903226"
"2019-12-31T00:00:00.000","RÃ­o Grande","PR","Passenger","1","0","1","1","2","50.0"
"2019-12-31T00:00:00.000","Newport","RI","Passenger","1","0","1","86","87","1.149425287356321839080459770"
"2019-12-31T00:00:00.000","Richland","SC","Passenger","0","1","1","156","157","0.6369426751592356687898089172"
"2019-12-31T00:00:00.000","Spartanburg","SC","Passenger","0","1","1","37","38","2.631578947368421052631578947"
"2019-12-31T00:00:00.000","Davidson","TN","Passenger","1","0","1","68","69","1.449275362318840579710144928"
"2019-12-31T00:00:00.000","Putnam","TN","Passenger","0","1","1","2","3","33.33333333333333333333333333"
"2019-12-31T00:00:00.000","Shelby","TN","Passenger","0","1","1","96","97","1.030927835051546391752577320"
"2019-12-31T00:00:00.000","Bell","TX","Passenger","0","1","1","417","418","0.2392344497607655502392344498"
"2019-12-31T00:00:00.000","Bexar","TX","Passenger","3","5","8","619","627","1.275917065390749601275917065"
"2019-12-31T00:00:00.000","Dallas","TX","Passenger","1","0","1","198","199","0.5025125628140703517587939698"
"2019-12-31T00:00:00.000","El Paso","TX","Passenger","2","0","2","449","451","0.4434589800443458980044345898"
"2019-12-31T00:00:00.000","Guadalupe","TX","Passenger","1","0","1","57","58","1.724137931034482758620689655"
"2019-12-31T00:00:00.000","Harris","TX","Passenger","1","0","1","235","236","0.4237288135593220338983050847"
"2019-12-31T00:00:00.000","Hidalgo","TX","Passenger","0","1","1","81","82","1.219512195121951219512195122"
"2019-12-31T00:00:00.000","Montgomery","TX","Passenger","1","0","1","50","51","1.960784313725490196078431373"
"2019-12-31T00:00:00.000","Nueces","TX","Passenger","1","1","2","83","85","2.352941176470588235294117647"
"2019-12-31T00:00:00.000","Tarrant","TX","Passenger","2","0","2","177","179","1.117318435754189944134078212"
"2019-12-31T00:00:00.000","Travis","TX","Passenger","2","1","3","187","190","1.578947368421052631578947368"
"2019-12-31T00:00:00.000","Albemarle","VA","Passenger","1","0","1","25","26","3.846153846153846153846153846"
"2019-12-31T00:00:00.000","Alexandria","VA","Passenger","3","0","3","147","150","2.00"
"2019-12-31T00:00:00.000","Arlington","VA","Passenger","0","2","2","151","153","1.307189542483660130718954248"
"2019-12-31T00:00:00.000","Chesapeake","VA","Passenger","0","2","2","435","437","0.4576659038901601830663615561"
"2019-12-31T00:00:00.000","Fairfax","VA","Passenger","3","3","6","747","753","0.7968127490039840637450199203"
"2019-12-31T00:00:00.000","Goochland","VA","Passenger","2","1","3","233","236","1.271186440677966101694915254"
"2019-12-31T00:00:00.000","Loudoun","VA","Passenger","1","0","1","88","89","1.123595505617977528089887640"
"2019-12-31T00:00:00.000","Manassas","VA","Passenger","0","1","1","5","6","16.66666666666666666666666667"
"2019-12-31T00:00:00.000","Norfolk","VA","Passenger","1","1","2","350","352","0.5681818181818181818181818182"
"2019-12-31T00:00:00.000","Portsmouth","VA","Passenger","0","1","1","71","72","1.388888888888888888888888889"
"2019-12-31T00:00:00.000","Powhatan","VA","Passenger","1","0","1","0","1","100"
"2019-12-31T00:00:00.000","Prince William","VA","Passenger","1","3","4","228","232","1.724137931034482758620689655"
"2019-12-31T00:00:00.000","Stafford","VA","Passenger","1","1","2","94","96","2.083333333333333333333333333"
"2019-12-31T00:00:00.000","Suffolk","VA","Passenger","1","0","1","113","114","0.8771929824561403508771929825"
"2019-12-31T00:00:00.000","Virginia Beach","VA","Passenger","1","0","1","673","674","0.1483679525222551928783382789"
"2019-12-31T00:00:00.000","Adams","WA","Passenger","6","8","14","12936","12950","0.1081081081081081081081081081"
"2019-12-31T00:00:00.000","Adams","WA","Truck","0","0","0","5196","5196","0"
"2019-12-31T00:00:00.000","Asotin","WA","Truck","0","0","0","6715","6715","0"
"2019-12-31T00:00:00.000","Asotin","WA","Passenger","15","10","25","12685","12710","0.1966955153422501966955153423"
"2019-12-31T00:00:00.000","Benton","WA","Passenger","326","319","645","135260","135905","0.4745962253044406018910268202"
"2019-12-31T00:00:00.000","Benton","WA","Truck","0","0","0","42494","42494","0"
"2019-12-31T00:00:00.000","Chelan","WA","Truck","0","0","0","22555","22555","0"
"2019-12-31T00:00:00.000","Chelan","WA","Passenger","203","79","282","54634","54916","0.5135115449049457353048291937"
"2019-12-31T00:00:00.000","Clallam","WA","Passenger","208","162","370","50863","51233","0.7221907754767435051626881112"
"2019-12-31T00:00:00.000","Clallam","WA","Truck","1","0","1","21875","21876","0.004571219601389650758822453831"
"2019-12-31T00:00:00.000","Clark","WA","Truck","0","0","0","81328","81328","0"
"2019-12-31T00:00:00.000","Clark","WA","Passenger","1941","1085","3026","317666","320692","0.9435844985219462911453980767"
"2019-12-31T00:00:00.000","Columbia","WA","Truck","0","0","0","1538","1538","0"
"2019-12-31T00:00:00.000","Columbia","WA","Passenger","3","3","6","2448","2454","0.2444987775061124694376528117"
"2019-12-31T00:00:00.000","Cowlitz","WA","Truck","0","0","0","29047","29047","0"
"2019-12-31T00:00:00.000","Cowlitz","WA","Passenger","129","121","250","73640","73890","0.3383407768304236026525916904"
"2019-12-31T00:00:00.000","Douglas","WA","Truck","0","0","0","12308","12308","0"
"2019-12-31T00:00:00.000","Douglas","WA","Passenger","68","38","106","28306","28412","0.3730817964240461776714064480"
"2019-12-31T00:00:00.000","Ferry","WA","Truck","0","0","0","3578","3578","0"
"2019-12-31T00:00:00.000","Ferry","WA","Passenger","5","2","7","4400","4407","0.1588382119355570683004311323"
"2019-12-31T00:00:00.000","Franklin","WA","Truck","0","0","0","19783","19783","0"
"2019-12-31T00:00:00.000","Franklin","WA","Passenger","61","80","141","60989","61130","0.2306559790610175036806805169"
"2019-12-31T00:00:00.000","Garfield","WA","Passenger","0","1","1","1307","1308","0.07645259938837920489296636086"
"2019-12-31T00:00:00.000","Garfield","WA","Truck","0","0","0","969","969","0"
"2019-12-31T00:00:00.000","Grant","WA","Truck","0","0","0","27013","27013","0"
"2019-12-31T00:00:00.000","Grant","WA","Passenger","58","72","130","65635","65765","0.1976735345548544058389720976"
"2019-12-31T00:00:00.000","Grays Harbor","WA","Passenger","118","106","224","48388","48612","0.4607915740969307989796758002"
"2019-12-31T00:00:00.000","Grays Harbor","WA","Truck","0","0","0","20772","20772","0"
"2019-12-31T00:00:00.000","Island","WA","Truck","1","0","1","21372","21373","0.004678800355588827024750853881"
"2019-12-31T00:00:00.000","Island","WA","Passenger","389","269","658","63650","64308","1.023200845928966847048578715"
"2019-12-31T00:00:00.000","Jefferson","WA","Passenger","229","144","373","25185","25558","1.459425620158071836606933250"
"2019-12-31T00:00:00.000","Jefferson","WA","Truck","0","0","0","9650","9650","0"
"2019-12-31T00:00:00.000","King","WA","Truck","6","1","7","182275","182282","0.003840203640513051206372543641"
"2019-12-31T00:00:00.000","King","WA","Passenger","22357","7847","30204","1394883","1425087","2.119449549395931616806552863"
"2019-12-31T00:00:00.000","Kitsap","WA","Passenger","1274","684","1958","182378","184336","1.062190782050169256140959986"
"2019-12-31T00:00:00.000","Kitsap","WA","Truck","1","0","1","54487","54488","0.001835266480692996623109675525"
"2019-12-31T00:00:00.000","Kittitas","WA","Passenger","93","48","141","30059","30200","0.4668874172185430463576158940"
"2019-12-31T00:00:00.000","Kittitas","WA","Truck","0","0","0","14627","14627","0"
"2019-12-31T00:00:00.000","Klickitat","WA","Truck","0","0","0","8320","8320","0"
"2019-12-31T00:00:00.000","Klickitat","WA","Passenger","51","39","90","15675","15765","0.5708848715509039010466222645"
"2019-12-31T00:00:00.000","Lewis","WA","Truck","0","0","0","26092","26092","0"
"2019-12-31T00:00:00.000","Lewis","WA","Passenger","115","107","222","59542","59764","0.3714610802489793186533699217"
"2019-12-31T00:00:00.000","Lincoln","WA","Truck","0","0","0","4682","4682","0"
"2019-12-31T00:00:00.000","Lincoln","WA","Passenger","3","11","14","7810","7824","0.1789366053169734151329243354"
"2019-12-31T00:00:00.000","Mason","WA","Passenger","164","142","306","47621","47927","0.6384710079913201327018173472"
"2019-12-31T00:00:00.000","Mason","WA","Truck","0","0","0","20529","20529","0"
"2019-12-31T00:00:00.000","Okanogan","WA","Passenger","31","30","61","26243","26304","0.2319038929440389294403892944"
"2019-12-31T00:00:00.000","Okanogan","WA","Truck","0","0","0","16555","16555","0"
"2019-12-31T00:00:00.000","Pacific","WA","Truck","0","0","0","7723","7723","0"
"2019-12-31T00:00:00.000","Pacific","WA","Passenger","39","33","72","16108","16180","0.4449938195302843016069221261"
"2019-12-31T00:00:00.000","Pend Oreille","WA","Passenger","8","7","15","9515","9530","0.1573976915005246589716684155"
"2019-12-31T00:00:00.000","Pend Oreille","WA","Truck","0","0","0","5770","5770","0"
"2019-12-31T00:00:00.000","Pierce","WA","Truck","0","0","0","140922","140922","0"
"2019-12-31T00:00:00.000","Pierce","WA","Passenger","2348","1768","4116","547953","552069","0.7455589790406633953364525087"
"2019-12-31T00:00:00.000","San Juan","WA","Truck","0","0","0","5939","5939","0"
"2019-12-31T00:00:00.000","San Juan","WA","Passenger","254","81","335","14407","14742","2.272418939085605752272418939"
"2019-12-31T00:00:00.000","Skagit","WA","Truck","1","0","1","32575","32576","0.003069744597249508840864440079"
"2019-12-31T00:00:00.000","Skagit","WA","Passenger","392","233","625","92625","93250","0.6702412868632707774798927614"
"2019-12-31T00:00:00.000","Skamania","WA","Passenger","29","19","48","8768","8816","0.5444646098003629764065335753"
"2019-12-31T00:00:00.000","Skamania","WA","Truck","0","0","0","4100","4100","0"
"2019-12-31T00:00:00.000","Snohomish","WA","Truck","0","0","0","123317","123317","0"
"2019-12-31T00:00:00.000","Snohomish","WA","Passenger","4173","1813","5986","536067","542053","1.104320057263773099678444728"
"2019-12-31T00:00:00.000","Spokane","WA","Truck","1","0","1","96424","96425","0.001037075447238786621726730620"
"2019-12-31T00:00:00.000","Spokane","WA","Passenger","681","503","1184","315136","316320","0.3743045017703591299949418311"
"2019-12-31T00:00:00.000","Stevens","WA","Passenger","34","34","68","31607","31675","0.2146803472770323599052880821"
"2019-12-31T00:00:00.000","Stevens","WA","Truck","0","0","0","18764","18764","0"
"2019-12-31T00:00:00.000","Thurston","WA","Truck","0","0","0","55764","55764","0"
"2019-12-31T00:00:00.000","Thurston","WA","Passenger","1142","753","1895","199276","201171","0.9419846797003544248425468880"
"2019-12-31T00:00:00.000","Wahkiakum","WA","Truck","0","0","0","1754","1754","0"
"2019-12-31T00:00:00.000","Wahkiakum","WA","Passenger","4","4","8","3041","3049","0.2623811085601836667759921286"
"2019-12-31T00:00:00.000","Walla Walla","WA","Truck","0","0","0","13670","13670","0"
"2019-12-31T00:00:00.000","Walla Walla","WA","Passenger","64","61","125","36324","36449","0.3429449367609536612801448599"
"2019-12-31T00:00:00.000","Whatcom","WA","Truck","2","0","2","43205","43207","0.004628879579697734163445737959"
"2019-12-31T00:00:00.000","Whatcom","WA","Passenger","1039","497","1536","151705","153241","1.002342715069726770250781449"
"2019-12-31T00:00:00.000","Whitman","WA","Truck","0","0","0","8583","8583","0"
"2019-12-31T00:00:00.000","Whitman","WA","Passenger","43","49","92","22695","22787","0.4037389739763900469565980603"
"2019-12-31T00:00:00.000","Yakima","WA","Passenger","128","123","251","166319","166570","0.1506873986912409197334453983"
"2019-12-31T00:00:00.000","Yakima","WA","Truck","0","0","0","59628","59628","0"
"2019-12-31T00:00:00.000","Ozaukee","WI","Passenger","0","1","1","3","4","25.00"
"2019-12-31T00:00:00.000",,,"Passenger","2","0","2","237","239","0.8368200836820083682008368201"
"2020-01-31T00:00:00.000","Fairbanks North Star","AK","Passenger","0","1","1","101","102","0.9803921568627450980392156863"
"2020-01-31T00:00:00.000","Juneau","AK","Passenger","0","2","2","29","31","6.451612903225806451612903226"
"2020-01-31T00:00:00.000","Montgomery","AL","Passenger","0","1","1","38","39","2.564102564102564102564102564"
"2020-01-31T00:00:00.000","Cochise","AZ","Passenger","0","1","1","109","110","0.9090909090909090909090909091"
"2020-01-31T00:00:00.000","Maricopa","AZ","Passenger","8","7","15","1338","1353","1.108647450110864745011086475"
"2020-01-31T00:00:00.000","Pima","AZ","Passenger","3","1","4","345","349","1.146131805157593123209169054"
"2020-01-31T00:00:00.000","Pinal","AZ","Passenger","1","0","1","167","168","0.5952380952380952380952380952"
"2020-01-31T00:00:00.000","Alameda","CA","Passenger","4","1","5","269","274","1.824817518248175182481751825"
"2020-01-31T00:00:00.000","Contra Costa","CA","Passenger","3","2","5","375","380","1.315789473684210526315789474"
"2020-01-31T00:00:00.000","Fresno","CA","Passenger","1","0","1","186","187","0.5347593582887700534759358289"
"2020-01-31T00:00:00.000","Kern","CA","Passenger","1","1","2","228","230","0.8695652173913043478260869565"
"2020-01-31T00:00:00.000","Los Angeles","CA","Passenger","9","10","19","1028","1047","1.814708691499522445081184336"
"2020-01-31T00:00:00.000","Orange","CA","Passenger","6","2","8","497","505","1.584158415841584158415841584"
"2020-01-31T00:00:00.000","Riverside","CA","Passenger","4","1","5","608","613","0.8156606851549755301794453507"
"2020-01-31T00:00:00.000","Sacramento","CA","Passenger","1","0","1","278","279","0.3584229390681003584229390681"
"2020-01-31T00:00:00.000","San Bernardino","CA","Passenger","0","1","1","440","441","0.2267573696145124716553287982"
"2020-01-31T00:00:00.000","San Diego","CA","Passenger","10","7","17","2823","2840","0.5985915492957746478873239437"
"2020-01-31T00:00:00.000","San Francisco","CA","Passenger","2","1","3","92","95","3.157894736842105263157894737"
"2020-01-31T00:00:00.000","San Mateo","CA","Passenger","1","1","2","116","118","1.694915254237288135593220339"
"2020-01-31T00:00:00.000","Santa Barbara","CA","Passenger","2","0","2","88","90","2.222222222222222222222222222"
"2020-01-31T00:00:00.000","Santa Clara","CA","Passenger","6","2","8","326","334","2.395209580838323353293413174"
"2020-01-31T00:00:00.000","Santa Cruz","CA","Passenger","1","0","1","34","35","2.857142857142857142857142857"
"2020-01-31T00:00:00.000","Shasta","CA","Passenger","1","0","1","36","37","2.702702702702702702702702703"
"2020-01-31T00:00:00.000","Solano","CA","Passenger","1","0","1","213","214","0.4672897196261682242990654206"
"2020-01-31T00:00:00.000","Tuolumne","CA","Passenger","0","1","1","8","9","11.11111111111111111111111111"
"2020-01-31T00:00:00.000","Ventura","CA","Passenger","0","3","3","305","308","0.9740259740259740259740259740"
"2020-01-31T00:00:00.000","Arapahoe","CO","Passenger","1","0","1","137","138","0.7246376811594202898550724638"
"2020-01-31T00:00:00.000","Boulder","CO","Passenger","0","1","1","46","47","2.127659574468085106382978723"
"2020-01-31T00:00:00.000","Denver","CO","Passenger","1","0","1","119","120","0.8333333333333333333333333333"
"2020-01-31T00:00:00.000","El Paso","CO","Passenger","2","1","3","713","716","0.4189944134078212290502793296"
"2020-01-31T00:00:00.000","Jefferson","CO","Passenger","0","2","2","61","63","3.174603174603174603174603175"
"2020-01-31T00:00:00.000","Larimer","CO","Passenger","1","1","2","50","52","3.846153846153846153846153846"
"2020-01-31T00:00:00.000","New London","CT","Passenger","0","2","2","265","267","0.7490636704119850187265917603"
"2020-01-31T00:00:00.000","District of Columbia","DC","Passenger","1","3","4","206","210","1.904761904761904761904761905"
"2020-01-31T00:00:00.000","Kent","DE","Passenger","0","1","1","71","72","1.388888888888888888888888889"
"2020-01-31T00:00:00.000","New Castle","DE","Passenger","1","0","1","24","25","4.00"
"2020-01-31T00:00:00.000","Brevard","FL","Passenger","0","1","1","79","80","1.2500"
"2020-01-31T00:00:00.000","Broward","FL","Passenger","1","1","2","118","120","1.666666666666666666666666667"
"2020-01-31T00:00:00.000","Clay","FL","Passenger","0","1","1","84","85","1.176470588235294117647058824"
"2020-01-31T00:00:00.000","Duval","FL","Passenger","1","1","2","359","361","0.5540166204986149584487534626"
"2020-01-31T00:00:00.000","Lake","FL","Passenger","1","0","1","17","18","5.555555555555555555555555556"
"2020-01-31T00:00:00.000","Osceola","FL","Passenger","1","0","1","38","39","2.564102564102564102564102564"
"2020-01-31T00:00:00.000","Palm Beach","FL","Passenger","0","1","1","73","74","1.351351351351351351351351351"
"2020-01-31T00:00:00.000","Pinellas","FL","Passenger","1","1","2","97","99","2.020202020202020202020202020"
"2020-01-31T00:00:00.000","Polk","FL","Passenger","1","0","1","67","68","1.470588235294117647058823529"
"2020-01-31T00:00:00.000","Santa Rosa","FL","Passenger","1","0","1","90","91","1.098901098901098901098901099"
"2020-01-31T00:00:00.000","Sarasota","FL","Passenger","2","0","2","27","29","6.896551724137931034482758621"
"2020-01-31T00:00:00.000","Sumter","FL","Passenger","0","1","1","9","10","10.0"
"2020-01-31T00:00:00.000","Bryan","GA","Passenger","1","0","1","51","52","1.923076923076923076923076923"
"2020-01-31T00:00:00.000","Camden","GA","Passenger","0","1","1","157","158","0.6329113924050632911392405063"
"2020-01-31T00:00:00.000","Columbia","GA","Passenger","1","1","2","145","147","1.360544217687074829931972789"
"2020-01-31T00:00:00.000","DeKalb","GA","Passenger","1","0","1","78","79","1.265822784810126582278481013"
"2020-01-31T00:00:00.000","Fulton","GA","Passenger","1","2","3","102","105","2.857142857142857142857142857"
"2020-01-31T00:00:00.000","Houston","GA","Passenger","1","0","1","60","61","1.639344262295081967213114754"
"2020-01-31T00:00:00.000","Jones","GA","Passenger","1","0","1","1","2","50.0"
"2020-01-31T00:00:00.000","Liberty","GA","Passenger","1","0","1","117","118","0.8474576271186440677966101695"
"2020-01-31T00:00:00.000","Honolulu","HI","Passenger","4","1","5","460","465","1.075268817204301075268817204"
"2020-01-31T00:00:00.000","Maui","HI","Passenger","1","0","1","34","35","2.857142857142857142857142857"
"2020-01-31T00:00:00.000","Ada","ID","Passenger","0","1","1","271","272","0.3676470588235294117647058824"
"2020-01-31T00:00:00.000","Kootenai","ID","Passenger","1","1","2","212","214","0.9345794392523364485981308411"
"2020-01-31T00:00:00.000","Twin Falls","ID","Passenger","0","1","1","25","26","3.846153846153846153846153846"
"2020-01-31T00:00:00.000","DuPage","IL","Passenger","3","0","3","59","62","4.838709677419354838709677419"
"2020-01-31T00:00:00.000","Lake","IL","Passenger","1","0","1","170","171","0.5847953216374269005847953216"
"2020-01-31T00:00:00.000","Monroe","IL","Passenger","1","0","1","3","4","25.00"
"2020-01-31T00:00:00.000","St. Clair","IL","Passenger","1","0","1","144","145","0.6896551724137931034482758621"
"2020-01-31T00:00:00.000","DeKalb","IN","Passenger","1","0","1","1","2","50.0"
"2020-01-31T00:00:00.000","Vigo","IN","Passenger","1","0","1","5","6","16.66666666666666666666666667"
"2020-01-31T00:00:00.000","Sedgwick","KS","Passenger","1","0","1","93","94","1.063829787234042553191489362"
"2020-01-31T00:00:00.000","Oldham","KY","Passenger","0","1","1","4","5","20.0"
"2020-01-31T00:00:00.000","Berkshire","MA","Passenger","0","1","1","6","7","14.28571428571428571428571429"
"2020-01-31T00:00:00.000","Middlesex","MA","Passenger","1","1","2","105","107","1.869158878504672897196261682"
"2020-01-31T00:00:00.000","Suffolk","MA","Passenger","0","1","1","39","40","2.500"
"2020-01-31T00:00:00.000","Anne Arundel","MD","Passenger","1","2","3","431","434","0.6912442396313364055299539171"
"2020-01-31T00:00:00.000","Calvert","MD","Passenger","0","2","2","90","92","2.173913043478260869565217391"
"2020-01-31T00:00:00.000","Charles","MD","Passenger","0","1","1","76","77","1.298701298701298701298701299"
"2020-01-31T00:00:00.000","Frederick","MD","Passenger","2","1","3","85","88","3.409090909090909090909090909"
"2020-01-31T00:00:00.000","Howard","MD","Passenger","0","1","1","74","75","1.333333333333333333333333333"
"2020-01-31T00:00:00.000","Montgomery","MD","Passenger","0","2","2","263","265","0.7547169811320754716981132075"
"2020-01-31T00:00:00.000","St. Mary's","MD","Passenger","1","0","1","203","204","0.4901960784313725490196078431"
"2020-01-31T00:00:00.000","Penobscot","ME","Passenger","0","1","1","15","16","6.2500"
"2020-01-31T00:00:00.000","Kent","MI","Passenger","0","1","1","23","24","4.166666666666666666666666667"
"2020-01-31T00:00:00.000","Saginaw","MI","Passenger","1","0","1","12","13","7.692307692307692307692307692"
"2020-01-31T00:00:00.000","Washtenaw","MI","Passenger","1","0","1","34","35","2.857142857142857142857142857"
"2020-01-31T00:00:00.000","Wayne","MI","Passenger","0","1","1","56","57","1.754385964912280701754385965"
"2020-01-31T00:00:00.000","Hennepin","MN","Passenger","2","1","3","94","97","3.092783505154639175257731959"
"2020-01-31T00:00:00.000","Kanabec","MN","Passenger","1","0","1","0","1","100"
"2020-01-31T00:00:00.000","Ramsey","MN","Passenger","1","0","1","37","38","2.631578947368421052631578947"
"2020-01-31T00:00:00.000","Boone","MO","Passenger","0","1","1","10","11","9.090909090909090909090909091"
"2020-01-31T00:00:00.000","Greene","MO","Passenger","0","1","1","24","25","4.00"
"2020-01-31T00:00:00.000","Harrison","MS","Passenger","1","0","1","60","61","1.639344262295081967213114754"
"2020-01-31T00:00:00.000","Cascade","MT","Passenger","0","1","1","57","58","1.724137931034482758620689655"
"2020-01-31T00:00:00.000","Flathead","MT","Passenger","1","0","1","56","57","1.754385964912280701754385965"
"2020-01-31T00:00:00.000","Glacier","MT","Passenger","0","1","1","4","5","20.0"
"2020-01-31T00:00:00.000","Cumberland","NC","Passenger","0","2","2","503","505","0.3960396039603960396039603960"
"2020-01-31T00:00:00.000","Guilford","NC","Passenger","1","0","1","31","32","3.12500"
"2020-01-31T00:00:00.000","Harnett","NC","Passenger","0","1","1","206","207","0.4830917874396135265700483092"
"2020-01-31T00:00:00.000","Mecklenburg","NC","Passenger","1","0","1","74","75","1.333333333333333333333333333"
"2020-01-31T00:00:00.000","Moore","NC","Passenger","0","1","1","169","170","0.5882352941176470588235294118"
"2020-01-31T00:00:00.000","Douglas","NE","Passenger","0","1","1","58","59","1.694915254237288135593220339"
"2020-01-31T00:00:00.000","Carroll","NH","Passenger","0","1","1","2","3","33.33333333333333333333333333"
"2020-01-31T00:00:00.000","Camden","NJ","Passenger","0","2","2","20","22","9.090909090909090909090909091"
"2020-01-31T00:00:00.000","Hudson","NJ","Passenger","1","0","1","160","161","0.6211180124223602484472049689"
"2020-01-31T00:00:00.000","Chaves","NM","Passenger","1","0","1","9","10","10.0"
"2020-01-31T00:00:00.000","Valencia","NM","Passenger","1","0","1","4","5","20.0"
"2020-01-31T00:00:00.000","Carson City","NV","Passenger","1","0","1","9","10","10.0"
"2020-01-31T00:00:00.000","Clark","NV","Passenger","3","4","7","678","685","1.021897810218978102189781022"
"2020-01-31T00:00:00.000","Washoe","NV","Passenger","1","0","1","89","90","1.111111111111111111111111111"
"2020-01-31T00:00:00.000","Jefferson","NY","Passenger","0","1","1","229","230","0.4347826086956521739130434783"
"2020-01-31T00:00:00.000","Nassau","NY","Passenger","2","0","2","37","39","5.128205128205128205128205128"
"2020-01-31T00:00:00.000","Queens","NY","Passenger","1","0","1","51","52","1.923076923076923076923076923"
"2020-01-31T00:00:00.000","Westchester","NY","Passenger","0","1","1","30","31","3.225806451612903225806451613"
"2020-01-31T00:00:00.000","Montgomery","OH","Passenger","0","1","1","49","50","2.00"
"2020-01-31T00:00:00.000","Shelby","OH","Passenger","0","1","1","1","2","50.0"
"2020-01-31T00:00:00.000","Oklahoma","OK","Passenger","0","2","2","119","121","1.652892561983471074380165289"
"2020-01-31T00:00:00.000","Rogers","OK","Passenger","1","0","1","5","6","16.66666666666666666666666667"
"2020-01-31T00:00:00.000","Tulsa","OK","Passenger","1","1","2","46","48","4.166666666666666666666666667"
"2020-01-31T00:00:00.000","Clackamas","OR","Passenger","2","1","3","196","199","1.507537688442211055276381910"
"2020-01-31T00:00:00.000","Deschutes","OR","Passenger","3","0","3","135","138","2.173913043478260869565217391"
"2020-01-31T00:00:00.000","Klamath","OR","Passenger","1","0","1","28","29","3.448275862068965517241379310"
"2020-01-31T00:00:00.000","Multnomah","OR","Passenger","4","6","10","692","702","1.424501424501424501424501425"
"2020-01-31T00:00:00.000","Washington","OR","Passenger","1","0","1","421","422","0.2369668246445497630331753555"
"2020-01-31T00:00:00.000","Allegheny","PA","Passenger","1","0","1","66","67","1.492537313432835820895522388"
"2020-01-31T00:00:00.000","Bucks","PA","Passenger","1","0","1","19","20","5.00"
"2020-01-31T00:00:00.000","Montgomery","PA","Passenger","2","0","2","28","30","6.666666666666666666666666667"
"2020-01-31T00:00:00.000","RÃ­o Grande","PR","Passenger","1","0","1","1","2","50.0"
"2020-01-31T00:00:00.000","Newport","RI","Passenger","1","0","1","87","88","1.136363636363636363636363636"
"2020-01-31T00:00:00.000","Richland","SC","Passenger","0","1","1","159","160","0.62500"
"2020-01-31T00:00:00.000","Spartanburg","SC","Passenger","0","1","1","37","38","2.631578947368421052631578947"
"2020-01-31T00:00:00.000","Davidson","TN","Passenger","1","0","1","66","67","1.492537313432835820895522388"
"2020-01-31T00:00:00.000","Putnam","TN","Passenger","0","1","1","2","3","33.33333333333333333333333333"
"2020-01-31T00:00:00.000","Shelby","TN","Passenger","0","1","1","97","98","1.020408163265306122448979592"
"2020-01-31T00:00:00.000","Tipton","TN","Passenger","1","0","1","14","15","6.666666666666666666666666667"
"2020-01-31T00:00:00.000","Bell","TX","Passenger","0","1","1","414","415","0.2409638554216867469879518072"
"2020-01-31T00:00:00.000","Bexar","TX","Passenger","4","5","9","613","622","1.446945337620578778135048232"
"2020-01-31T00:00:00.000","Dallas","TX","Passenger","1","0","1","200","201","0.4975124378109452736318407960"
"2020-01-31T00:00:00.000","Denton","TX","Passenger","1","0","1","76","77","1.298701298701298701298701299"
"2020-01-31T00:00:00.000","El Paso","TX","Passenger","2","0","2","446","448","0.4464285714285714285714285714"
"2020-01-31T00:00:00.000","Guadalupe","TX","Passenger","1","0","1","58","59","1.694915254237288135593220339"
"2020-01-31T00:00:00.000","Harris","TX","Passenger","1","0","1","234","235","0.4255319148936170212765957447"
"2020-01-31T00:00:00.000","Hidalgo","TX","Passenger","0","1","1","79","80","1.2500"
"2020-01-31T00:00:00.000","Montgomery","TX","Passenger","1","0","1","50","51","1.960784313725490196078431373"
"2020-01-31T00:00:00.000","Nueces","TX","Passenger","1","0","1","82","83","1.204819277108433734939759036"
"2020-01-31T00:00:00.000","Tarrant","TX","Passenger","2","0","2","172","174","1.149425287356321839080459770"
"2020-01-31T00:00:00.000","Travis","TX","Passenger","2","2","4","179","183","2.185792349726775956284153005"
"2020-01-31T00:00:00.000","Albemarle","VA","Passenger","1","0","1","25","26","3.846153846153846153846153846"
"2020-01-31T00:00:00.000","Alexandria","VA","Passenger","3","0","3","147","150","2.00"
"2020-01-31T00:00:00.000","Arlington","VA","Passenger","0","2","2","151","153","1.307189542483660130718954248"
"2020-01-31T00:00:00.000","Chesapeake","VA","Passenger","0","2","2","434","436","0.4587155963302752293577981651"
"2020-01-31T00:00:00.000","Fairfax","VA","Passenger","4","3","7","749","756","0.9259259259259259259259259259"
"2020-01-31T00:00:00.000","Goochland","VA","Passenger","2","1","3","233","236","1.271186440677966101694915254"
"2020-01-31T00:00:00.000","Loudoun","VA","Passenger","1","0","1","86","87","1.149425287356321839080459770"
"2020-01-31T00:00:00.000","Manassas","VA","Passenger","0","1","1","5","6","16.66666666666666666666666667"
"2020-01-31T00:00:00.000","Norfolk","VA","Passenger","1","1","2","354","356","0.5617977528089887640449438202"
"2020-01-31T00:00:00.000","Portsmouth","VA","Passenger","0","1","1","70","71","1.408450704225352112676056338"
"2020-01-31T00:00:00.000","Powhatan","VA","Passenger","1","0","1","0","1","100"
"2020-01-31T00:00:00.000","Prince William","VA","Passenger","2","3","5","227","232","2.155172413793103448275862069"
"2020-01-31T00:00:00.000","Stafford","VA","Passenger","1","1","2","93","95","2.105263157894736842105263158"
"2020-01-31T00:00:00.000","Suffolk","VA","Passenger","1","0","1","113","114","0.8771929824561403508771929825"
"2020-01-31T00:00:00.000","Virginia Beach","VA","Passenger","1","0","1","673","674","0.1483679525222551928783382789"
"2020-01-31T00:00:00.000","Adams","WA","Truck","0","0","0","5209","5209","0"
"2020-01-31T00:00:00.000","Adams","WA","Passenger","7","8","15","12913","12928","0.1160272277227722772277227723"
"2020-01-31T00:00:00.000","Asotin","WA","Passenger","18","12","30","12729","12759","0.2351281448389372207853280038"
"2020-01-31T00:00:00.000","Asotin","WA","Truck","0","0","0","6727","6727","0"
"2020-01-31T00:00:00.000","Benton","WA","Truck","0","0","0","42563","42563","0"
"2020-01-31T00:00:00.000","Benton","WA","Passenger","348","326","674","135343","136017","0.4955262945073042340295698332"
"2020-01-31T00:00:00.000","Chelan","WA","Passenger","215","78","293","54629","54922","0.5334838498233858927205855577"
"2020-01-31T00:00:00.000","Chelan","WA","Truck","0","0","0","22579","22579","0"
"2020-01-31T00:00:00.000","Clallam","WA","Passenger","214","167","381","50909","51290","0.7428348605966075258334958081"
"2020-01-31T00:00:00.000","Clallam","WA","Truck","1","0","1","21860","21861","0.004574356159370568592470609762"
"2020-01-31T00:00:00.000","Clark","WA","Truck","0","0","0","81780","81780","0"
"2020-01-31T00:00:00.000","Clark","WA","Passenger","2039","1098","3137","319908","323045","0.9710721416520918138339859772"
"2020-01-31T00:00:00.000","Columbia","WA","Passenger","3","3","6","2446","2452","0.2446982055464926590538336052"
"2020-01-31T00:00:00.000","Columbia","WA","Truck","0","0","0","1535","1535","0"
"2020-01-31T00:00:00.000","Cowlitz","WA","Passenger","138","124","262","73600","73862","0.3547155506214291516612060329"
"2020-01-31T00:00:00.000","Cowlitz","WA","Truck","0","0","0","29039","29039","0"
"2020-01-31T00:00:00.000","Douglas","WA","Truck","0","0","0","12312","12312","0"
"2020-01-31T00:00:00.000","Douglas","WA","Passenger","70","39","109","28374","28483","0.3826844082435136748235789769"
"2020-01-31T00:00:00.000","Ferry","WA","Passenger","5","2","7","4383","4390","0.1594533029612756264236902050"
"2020-01-31T00:00:00.000","Ferry","WA","Truck","0","0","0","3584","3584","0"
"2020-01-31T00:00:00.000","Franklin","WA","Passenger","64","80","144","61101","61245","0.2351212343864805290227773696"
"2020-01-31T00:00:00.000","Franklin","WA","Truck","0","0","0","19855","19855","0"
"2020-01-31T00:00:00.000","Garfield","WA","Truck","0","0","0","969","969","0"
"2020-01-31T00:00:00.000","Garfield","WA","Passenger","0","1","1","1322","1323","0.07558578987150415721844293273"
"2020-01-31T00:00:00.000","Grant","WA","Truck","0","0","0","27046","27046","0"
"2020-01-31T00:00:00.000","Grant","WA","Passenger","61","75","136","65634","65770","0.2067812072373422533069788657"
"2020-01-31T00:00:00.000","Grays Harbor","WA","Passenger","118","111","229","48498","48727","0.4699653169700576682332177232"
"2020-01-31T00:00:00.000","Grays Harbor","WA","Truck","0","0","0","20829","20829","0"
"2020-01-31T00:00:00.000","Island","WA","Truck","1","0","1","21369","21370","0.004679457182966775854000935891"
"2020-01-31T00:00:00.000","Island","WA","Passenger","406","273","679","63650","64329","1.055511511138055931228528346"
"2020-01-31T00:00:00.000","Jefferson","WA","Truck","0","0","0","9665","9665","0"
"2020-01-31T00:00:00.000","Jefferson","WA","Passenger","236","149","385","25207","25592","1.504376367614879649890590810"
"2020-01-31T00:00:00.000","King","WA","Passenger","23608","7935","31543","1399242","1430785","2.204593981625471332170801343"
"2020-01-31T00:00:00.000","King","WA","Truck","6","1","7","182712","182719","0.003831019215297807015143471670"
"2020-01-31T00:00:00.000","Kitsap","WA","Passenger","1334","689","2023","182488","184511","1.096411596056603671325828812"
"2020-01-31T00:00:00.000","Kitsap","WA","Truck","1","0","1","54527","54528","0.001833920187793427230046948357"
"2020-01-31T00:00:00.000","Kittitas","WA","Passenger","96","49","145","30087","30232","0.4796242392167240010584810797"
"2020-01-31T00:00:00.000","Kittitas","WA","Truck","0","0","0","14669","14669","0"
"2020-01-31T00:00:00.000","Klickitat","WA","Passenger","53","40","93","15684","15777","0.5894656778855295683590036129"
"2020-01-31T00:00:00.000","Klickitat","WA","Truck","0","0","0","8301","8301","0"
"2020-01-31T00:00:00.000","Lewis","WA","Truck","0","0","0","26102","26102","0"
"2020-01-31T00:00:00.000","Lewis","WA","Passenger","118","109","227","59584","59811","0.3795288492083396030830449248"
"2020-01-31T00:00:00.000","Lincoln","WA","Passenger","3","11","14","7791","7805","0.1793721973094170403587443946"
"2020-01-31T00:00:00.000","Lincoln","WA","Truck","0","0","0","4670","4670","0"
"2020-01-31T00:00:00.000","Mason","WA","Passenger","172","142","314","47608","47922","0.6552314177204624180960727849"
"2020-01-31T00:00:00.000","Mason","WA","Truck","0","0","0","20565","20565","0"
"2020-01-31T00:00:00.000","Okanogan","WA","Truck","0","0","0","16562","16562","0"
"2020-01-31T00:00:00.000","Okanogan","WA","Passenger","33","30","63","26227","26290","0.2396348421453023963484214530"
"2020-01-31T00:00:00.000","Pacific","WA","Truck","0","0","0","7750","7750","0"
"2020-01-31T00:00:00.000","Pacific","WA","Passenger","39","34","73","16084","16157","0.4518165501021229188586990159"
"2020-01-31T00:00:00.000","Pend Oreille","WA","Truck","0","0","0","5777","5777","0"
"2020-01-31T00:00:00.000","Pend Oreille","WA","Passenger","9","7","16","9471","9487","0.1686518393591230104353325603"
"2020-01-31T00:00:00.000","Pierce","WA","Truck","0","0","0","141407","141407","0"
"2020-01-31T00:00:00.000","Pierce","WA","Passenger","2448","1797","4245","550718","554963","0.7649158592554818969913309536"
"2020-01-31T00:00:00.000","San Juan","WA","Passenger","266","85","351","14402","14753","2.379177116518674167965837457"
"2020-01-31T00:00:00.000","San Juan","WA","Truck","0","0","0","5932","5932","0"
"2020-01-31T00:00:00.000","Skagit","WA","Truck","1","0","1","32602","32603","0.003067202404686685274361255099"
"2020-01-31T00:00:00.000","Skagit","WA","Passenger","407","235","642","92609","93251","0.6884644668689880001286849471"
"2020-01-31T00:00:00.000","Skamania","WA","Truck","0","0","0","4107","4107","0"
"2020-01-31T00:00:00.000","Skamania","WA","Passenger","32","19","51","8770","8821","0.5781657408457091032762725315"
"2020-01-31T00:00:00.000","Snohomish","WA","Truck","0","0","0","123679","123679","0"
"2020-01-31T00:00:00.000","Snohomish","WA","Passenger","4396","1821","6217","537881","544098","1.142625041812320574602369426"
"2020-01-31T00:00:00.000","Spokane","WA","Passenger","722","499","1221","316840","318061","0.3838886251379452369199618941"
"2020-01-31T00:00:00.000","Spokane","WA","Truck","1","0","1","96942","96943","0.001031533994202778952580382286"
"2020-01-31T00:00:00.000","Stevens","WA","Passenger","36","35","71","31497","31568","0.2249113025848960973137354283"
"2020-01-31T00:00:00.000","Stevens","WA","Truck","0","0","0","18793","18793","0"
"2020-01-31T00:00:00.000","Thurston","WA","Passenger","1183","773","1956","199339","201295","0.9717081894731612807074194590"
"2020-01-31T00:00:00.000","Thurston","WA","Truck","0","0","0","55799","55799","0"
"2020-01-31T00:00:00.000","Wahkiakum","WA","Truck","0","0","0","1759","1759","0"
"2020-01-31T00:00:00.000","Wahkiakum","WA","Passenger","4","6","10","3034","3044","0.3285151116951379763469119580"
"2020-01-31T00:00:00.000","Walla Walla","WA","Passenger","66","62","128","36371","36499","0.3506945395764267514178470643"
"2020-01-31T00:00:00.000","Walla Walla","WA","Truck","0","0","0","13716","13716","0"
"2020-01-31T00:00:00.000","Whatcom","WA","Truck","3","0","3","43244","43247","0.006936897357042106966957245589"
"2020-01-31T00:00:00.000","Whatcom","WA","Passenger","1084","506","1590","151803","153393","1.036553167354442510414425691"
"2020-01-31T00:00:00.000","Whitman","WA","Passenger","43","51","94","22682","22776","0.4127151387425360028099754127"
"2020-01-31T00:00:00.000","Whitman","WA","Truck","0","0","0","8571","8571","0"
"2020-01-31T00:00:00.000","Yakima","WA","Truck","0","0","0","59652","59652","0"
"2020-01-31T00:00:00.000","Yakima","WA","Passenger","132","124","256","166274","166530","0.1537260553653996276947096619"
"2020-01-31T00:00:00.000","Ozaukee","WI","Passenger","0","1","1","3","4","25.00"
"2020-01-31T00:00:00.000",,,"Passenger","2","0","2","233","235","0.8510638297872340425531914894"
"2020-02-29T00:00:00.000","Fairbanks North Star","AK","Passenger","0","1","1","99","100","1.00"
"2020-02-29T00:00:00.000","Juneau","AK","Passenger","0","2","2","31","33","6.060606060606060606060606061"
"2020-02-29T00:00:00.000","Montgomery","AL","Passenger","0","1","1","38","39","2.564102564102564102564102564"
"2020-02-29T00:00:00.000","Cochise","AZ","Passenger","0","1","1","108","109","0.9174311926605504587155963303"
"2020-02-29T00:00:00.000","Maricopa","AZ","Passenger","9","7","16","1326","1342","1.192250372578241430700447094"
"2020-02-29T00:00:00.000","Pima","AZ","Passenger","3","1","4","341","345","1.159420289855072463768115942"
"2020-02-29T00:00:00.000","Pinal","AZ","Passenger","1","0","1","168","169","0.5917159763313609467455621302"
"2020-02-29T00:00:00.000","Alameda","CA","Passenger","3","1","4","265","269","1.486988847583643122676579926"
"2020-02-29T00:00:00.000","Contra Costa","CA","Passenger","3","2","5","370","375","1.333333333333333333333333333"
"2020-02-29T00:00:00.000","Fresno","CA","Passenger","1","0","1","184","185","0.5405405405405405405405405405"
"2020-02-29T00:00:00.000","Kern","CA","Passenger","1","1","2","226","228","0.8771929824561403508771929825"
"2020-02-29T00:00:00.000","Los Angeles","CA","Passenger","9","10","19","1011","1030","1.844660194174757281553398058"
"2020-02-29T00:00:00.000","Orange","CA","Passenger","6","2","8","493","501","1.596806387225548902195608782"
"2020-02-29T00:00:00.000","Placer","CA","Passenger","1","0","1","86","87","1.149425287356321839080459770"
"2020-02-29T00:00:00.000","Riverside","CA","Passenger","3","1","4","608","612","0.6535947712418300653594771242"
"2020-02-29T00:00:00.000","Sacramento","CA","Passenger","1","0","1","271","272","0.3676470588235294117647058824"
"2020-02-29T00:00:00.000","San Bernardino","CA","Passenger","0","1","1","445","446","0.2242152466367713004484304933"
"2020-02-29T00:00:00.000","San Diego","CA","Passenger","11","7","18","2828","2846","0.6324666198172874209416725228"
"2020-02-29T00:00:00.000","San Francisco","CA","Passenger","2","1","3","90","93","3.225806451612903225806451613"
"2020-02-29T00:00:00.000","San Mateo","CA","Passenger","0","1","1","116","117","0.8547008547008547008547008547"
"2020-02-29T00:00:00.000","Santa Barbara","CA","Passenger","2","0","2","88","90","2.222222222222222222222222222"
"2020-02-29T00:00:00.000","Santa Clara","CA","Passenger","6","2","8","316","324","2.469135802469135802469135802"
"2020-02-29T00:00:00.000","Santa Cruz","CA","Passenger","1","0","1","36","37","2.702702702702702702702702703"
"2020-02-29T00:00:00.000","Shasta","CA","Passenger","1","0","1","37","38","2.631578947368421052631578947"
"2020-02-29T00:00:00.000","Solano","CA","Passenger","1","0","1","216","217","0.4608294930875576036866359447"
"2020-02-29T00:00:00.000","Tuolumne","CA","Passenger","0","1","1","7","8","12.500"
"2020-02-29T00:00:00.000","Ventura","CA","Passenger","0","3","3","298","301","0.9966777408637873754152823920"
"2020-02-29T00:00:00.000","Arapahoe","CO","Passenger","1","0","1","136","137","0.7299270072992700729927007299"
"2020-02-29T00:00:00.000","Boulder","CO","Passenger","0","1","1","43","44","2.272727272727272727272727273"
"2020-02-29T00:00:00.000","Denver","CO","Passenger","1","0","1","122","123","0.8130081300813008130081300813"
"2020-02-29T00:00:00.000","El Paso","CO","Passenger","2","0","2","711","713","0.2805049088359046283309957924"
"2020-02-29T00:00:00.000","Jefferson","CO","Passenger","0","1","1","63","64","1.562500"
"2020-02-29T00:00:00.000","Larimer","CO","Passenger","1","1","2","48","50","4.00"
"2020-02-29T00:00:00.000","New London","CT","Passenger","0","2","2","265","267","0.7490636704119850187265917603"
"2020-02-29T00:00:00.000","District of Columbia","DC","Passenger","1","3","4","202","206","1.941747572815533980582524272"
"2020-02-29T00:00:00.000","Kent","DE","Passenger","0","1","1","69","70","1.428571428571428571428571429"
"2020-02-29T00:00:00.000","New Castle","DE","Passenger","1","0","1","24","25","4.00"
"2020-02-29T00:00:00.000","Brevard","FL","Passenger","0","1","1","81","82","1.219512195121951219512195122"
"2020-02-29T00:00:00.000","Broward","FL","Passenger","1","1","2","114","116","1.724137931034482758620689655"
"2020-02-29T00:00:00.000","Clay","FL","Passenger","0","1","1","82","83","1.204819277108433734939759036"
"2020-02-29T00:00:00.000","Duval","FL","Passenger","1","1","2","355","357","0.5602240896358543417366946779"
"2020-02-29T00:00:00.000","Lake","FL","Passenger","1","0","1","17","18","5.555555555555555555555555556"
"2020-02-29T00:00:00.000","Osceola","FL","Passenger","1","0","1","38","39","2.564102564102564102564102564"
"2020-02-29T00:00:00.000","Palm Beach","FL","Passenger","0","1","1","72","73","1.369863013698630136986301370"
"2020-02-29T00:00:00.000","Pinellas","FL","Passenger","1","1","2","97","99","2.020202020202020202020202020"
"2020-02-29T00:00:00.000","Polk","FL","Passenger","1","0","1","68","69","1.449275362318840579710144928"
"2020-02-29T00:00:00.000","Santa Rosa","FL","Passenger","1","0","1","89","90","1.111111111111111111111111111"
"2020-02-29T00:00:00.000","Sarasota","FL","Passenger","2","0","2","28","30","6.666666666666666666666666667"
"2020-02-29T00:00:00.000","Sumter","FL","Passenger","0","1","1","9","10","10.0"
"2020-02-29T00:00:00.000","Bryan","GA","Passenger","1","0","1","51","52","1.923076923076923076923076923"
"2020-02-29T00:00:00.000","Camden","GA","Passenger","0","1","1","155","156","0.6410256410256410256410256410"
"2020-02-29T00:00:00.000","Columbia","GA","Passenger","1","1","2","145","147","1.360544217687074829931972789"
"2020-02-29T00:00:00.000","DeKalb","GA","Passenger","1","0","1","78","79","1.265822784810126582278481013"
"2020-02-29T00:00:00.000","Fulton","GA","Passenger","1","2","3","100","103","2.912621359223300970873786408"
"2020-02-29T00:00:00.000","Houston","GA","Passenger","1","0","1","58","59","1.694915254237288135593220339"
"2020-02-29T00:00:00.000","Jones","GA","Passenger","1","0","1","1","2","50.0"
"2020-02-29T00:00:00.000","Liberty","GA","Passenger","1","0","1","117","118","0.8474576271186440677966101695"
"2020-02-29T00:00:00.000","Honolulu","HI","Passenger","4","1","5","451","456","1.096491228070175438596491228"
"2020-02-29T00:00:00.000","Maui","HI","Passenger","1","0","1","33","34","2.941176470588235294117647059"
"2020-02-29T00:00:00.000","Ada","ID","Passenger","0","1","1","269","270","0.3703703703703703703703703704"
"2020-02-29T00:00:00.000","Kootenai","ID","Passenger","1","1","2","210","212","0.9433962264150943396226415094"
"2020-02-29T00:00:00.000","Twin Falls","ID","Passenger","0","1","1","25","26","3.846153846153846153846153846"
"2020-02-29T00:00:00.000","DuPage","IL","Passenger","3","0","3","58","61","4.918032786885245901639344262"
"2020-02-29T00:00:00.000","Lake","IL","Passenger","1","0","1","173","174","0.5747126436781609195402298851"
"2020-02-29T00:00:00.000","Monroe","IL","Passenger","1","0","1","3","4","25.00"
"2020-02-29T00:00:00.000","St. Clair","IL","Passenger","1","0","1","142","143","0.6993006993006993006993006993"
"2020-02-29T00:00:00.000","DeKalb","IN","Passenger","1","0","1","1","2","50.0"
"2020-02-29T00:00:00.000","Vigo","IN","Passenger","1","0","1","4","5","20.0"
"2020-02-29T00:00:00.000","Sedgwick","KS","Passenger","1","0","1","93","94","1.063829787234042553191489362"
"2020-02-29T00:00:00.000","Oldham","KY","Passenger","0","1","1","4","5","20.0"
"2020-02-29T00:00:00.000","Middlesex","MA","Passenger","1","1","2","102","104","1.923076923076923076923076923"
"2020-02-29T00:00:00.000","Suffolk","MA","Passenger","0","1","1","41","42","2.380952380952380952380952381"
"2020-02-29T00:00:00.000","Anne Arundel","MD","Passenger","1","2","3","423","426","0.7042253521126760563380281690"
"2020-02-29T00:00:00.000","Calvert","MD","Passenger","0","2","2","88","90","2.222222222222222222222222222"
"2020-02-29T00:00:00.000","Charles","MD","Passenger","0","1","1","72","73","1.369863013698630136986301370"
"2020-02-29T00:00:00.000","Frederick","MD","Passenger","2","1","3","85","88","3.409090909090909090909090909"
"2020-02-29T00:00:00.000","Howard","MD","Passenger","0","1","1","71","72","1.388888888888888888888888889"
"2020-02-29T00:00:00.000","Montgomery","MD","Passenger","0","2","2","261","263","0.7604562737642585551330798479"
"2020-02-29T00:00:00.000","St. Mary's","MD","Passenger","1","0","1","205","206","0.4854368932038834951456310680"
"2020-02-29T00:00:00.000","Penobscot","ME","Passenger","0","1","1","16","17","5.882352941176470588235294118"
"2020-02-29T00:00:00.000","Kent","MI","Passenger","0","1","1","22","23","4.347826086956521739130434783"
"2020-02-29T00:00:00.000","Saginaw","MI","Passenger","1","0","1","12","13","7.692307692307692307692307692"
"2020-02-29T00:00:00.000","Washtenaw","MI","Passenger","1","0","1","33","34","2.941176470588235294117647059"
"2020-02-29T00:00:00.000","Wayne","MI","Passenger","0","1","1","56","57","1.754385964912280701754385965"
"2020-02-29T00:00:00.000","Hennepin","MN","Passenger","2","1","3","91","94","3.191489361702127659574468085"
"2020-02-29T00:00:00.000","Kanabec","MN","Passenger","1","0","1","0","1","100"
"2020-02-29T00:00:00.000","Ramsey","MN","Passenger","1","0","1","38","39","2.564102564102564102564102564"
"2020-02-29T00:00:00.000","Boone","MO","Passenger","0","1","1","10","11","9.090909090909090909090909091"
"2020-02-29T00:00:00.000","Greene","MO","Passenger","0","1","1","24","25","4.00"
"2020-02-29T00:00:00.000","Harrison","MS","Passenger","1","0","1","61","62","1.612903225806451612903225806"
"2020-02-29T00:00:00.000","Cascade","MT","Passenger","0","1","1","56","57","1.754385964912280701754385965"
"2020-02-29T00:00:00.000","Flathead","MT","Passenger","1","0","1","59","60","1.666666666666666666666666667"
"2020-02-29T00:00:00.000","Glacier","MT","Passenger","0","1","1","5","6","16.66666666666666666666666667"
"2020-02-29T00:00:00.000","Cumberland","NC","Passenger","0","2","2","489","491","0.4073319755600814663951120163"
"2020-02-29T00:00:00.000","Guilford","NC","Passenger","1","0","1","30","31","3.225806451612903225806451613"
"2020-02-29T00:00:00.000","Harnett","NC","Passenger","0","1","1","208","209","0.4784688995215311004784688995"
"2020-02-29T00:00:00.000","Mecklenburg","NC","Passenger","1","0","1","73","74","1.351351351351351351351351351"
"2020-02-29T00:00:00.000","Moore","NC","Passenger","0","1","1","169","170","0.5882352941176470588235294118"
"2020-02-29T00:00:00.000","Williams","ND","Passenger","0","1","1","13","14","7.142857142857142857142857143"
"2020-02-29T00:00:00.000","Douglas","NE","Passenger","0","1","1","59","60","1.666666666666666666666666667"
"2020-02-29T00:00:00.000","Carroll","NH","Passenger","0","1","1","2","3","33.33333333333333333333333333"
"2020-02-29T00:00:00.000","Camden","NJ","Passenger","0","2","2","20","22","9.090909090909090909090909091"
"2020-02-29T00:00:00.000","Hudson","NJ","Passenger","1","0","1","157","158","0.6329113924050632911392405063"
"2020-02-29T00:00:00.000","Chaves","NM","Passenger","1","0","1","8","9","11.11111111111111111111111111"
"2020-02-29T00:00:00.000","Valencia","NM","Passenger","1","0","1","4","5","20.0"
"2020-02-29T00:00:00.000","Carson City","NV","Passenger","1","0","1","10","11","9.090909090909090909090909091"
"2020-02-29T00:00:00.000","Clark","NV","Passenger","3","4","7","673","680","1.029411764705882352941176471"
"2020-02-29T00:00:00.000","Washoe","NV","Passenger","1","0","1","91","92","1.086956521739130434782608696"
"2020-02-29T00:00:00.000","Jefferson","NY","Passenger","0","1","1","228","229","0.4366812227074235807860262009"
"2020-02-29T00:00:00.000","Nassau","NY","Passenger","2","0","2","36","38","5.263157894736842105263157895"
"2020-02-29T00:00:00.000","Queens","NY","Passenger","1","0","1","52","53","1.886792452830188679245283019"
"2020-02-29T00:00:00.000","Westchester","NY","Passenger","0","1","1","28","29","3.448275862068965517241379310"
"2020-02-29T00:00:00.000","Montgomery","OH","Passenger","0","1","1","46","47","2.127659574468085106382978723"
"2020-02-29T00:00:00.000","Shelby","OH","Passenger","0","1","1","1","2","50.0"
"2020-02-29T00:00:00.000","Oklahoma","OK","Passenger","0","2","2","119","121","1.652892561983471074380165289"
"2020-02-29T00:00:00.000","Rogers","OK","Passenger","1","0","1","5","6","16.66666666666666666666666667"
"2020-02-29T00:00:00.000","Tulsa","OK","Passenger","1","1","2","46","48","4.166666666666666666666666667"
"2020-02-29T00:00:00.000","Clackamas","OR","Passenger","2","1","3","198","201","1.492537313432835820895522388"
"2020-02-29T00:00:00.000","Deschutes","OR","Passenger","3","0","3","130","133","2.255639097744360902255639098"
"2020-02-29T00:00:00.000","Klamath","OR","Passenger","1","0","1","29","30","3.333333333333333333333333333"
"2020-02-29T00:00:00.000","Multnomah","OR","Passenger","4","6","10","693","703","1.422475106685633001422475107"
"2020-02-29T00:00:00.000","Washington","OR","Passenger","1","0","1","424","425","0.2352941176470588235294117647"
"2020-02-29T00:00:00.000","Allegheny","PA","Passenger","1","0","1","65","66","1.515151515151515151515151515"
"2020-02-29T00:00:00.000","Bucks","PA","Passenger","1","0","1","19","20","5.00"
"2020-02-29T00:00:00.000","Montgomery","PA","Passenger","2","0","2","28","30","6.666666666666666666666666667"
"2020-02-29T00:00:00.000","RÃ­o Grande","PR","Passenger","1","0","1","1","2","50.0"
"2020-02-29T00:00:00.000","Newport","RI","Passenger","1","0","1","86","87","1.149425287356321839080459770"
"2020-02-29T00:00:00.000","Richland","SC","Passenger","0","1","1","161","162","0.6172839506172839506172839506"
"2020-02-29T00:00:00.000","Spartanburg","SC","Passenger","0","1","1","39","40","2.500"
"2020-02-29T00:00:00.000","Davidson","TN","Passenger","1","0","1","64","65","1.538461538461538461538461538"
"2020-02-29T00:00:00.000","Putnam","TN","Passenger","0","1","1","2","3","33.33333333333333333333333333"
"2020-02-29T00:00:00.000","Shelby","TN","Passenger","0","1","1","93","94","1.063829787234042553191489362"
"2020-02-29T00:00:00.000","Tipton","TN","Passenger","1","0","1","14","15","6.666666666666666666666666667"
"2020-02-29T00:00:00.000","Bell","TX","Passenger","0","1","1","410","411","0.2433090024330900243309002433"
"2020-02-29T00:00:00.000","Bexar","TX","Passenger","4","5","9","609","618","1.456310679611650485436893204"
"2020-02-29T00:00:00.000","Dallas","TX","Passenger","1","0","1","192","193","0.5181347150259067357512953368"
"2020-02-29T00:00:00.000","Denton","TX","Passenger","1","0","1","78","79","1.265822784810126582278481013"
"2020-02-29T00:00:00.000","El Paso","TX","Passenger","2","0","2","437","439","0.4555808656036446469248291572"
"2020-02-29T00:00:00.000","Guadalupe","TX","Passenger","1","0","1","57","58","1.724137931034482758620689655"
"2020-02-29T00:00:00.000","Harris","TX","Passenger","1","0","1","232","233","0.4291845493562231759656652361"
"2020-02-29T00:00:00.000","Hidalgo","TX","Passenger","0","1","1","78","79","1.265822784810126582278481013"
"2020-02-29T00:00:00.000","Montgomery","TX","Passenger","1","0","1","44","45","2.222222222222222222222222222"
"2020-02-29T00:00:00.000","Nueces","TX","Passenger","1","0","1","81","82","1.219512195121951219512195122"
"2020-02-29T00:00:00.000","Tarrant","TX","Passenger","2","0","2","171","173","1.156069364161849710982658960"
"2020-02-29T00:00:00.000","Travis","TX","Passenger","2","2","4","175","179","2.234636871508379888268156425"
"2020-02-29T00:00:00.000","Albemarle","VA","Passenger","1","0","1","25","26","3.846153846153846153846153846"
"2020-02-29T00:00:00.000","Alexandria","VA","Passenger","3","0","3","144","147","2.040816326530612244897959184"
"2020-02-29T00:00:00.000","Arlington","VA","Passenger","0","2","2","150","152","1.315789473684210526315789474"
"2020-02-29T00:00:00.000","Chesapeake","VA","Passenger","0","2","2","435","437","0.4576659038901601830663615561"
"2020-02-29T00:00:00.000","Fairfax","VA","Passenger","4","4","8","747","755","1.059602649006622516556291391"
"2020-02-29T00:00:00.000","Goochland","VA","Passenger","2","1","3","231","234","1.282051282051282051282051282"
"2020-02-29T00:00:00.000","Loudoun","VA","Passenger","1","0","1","85","86","1.162790697674418604651162791"
"2020-02-29T00:00:00.000","Manassas","VA","Passenger","0","1","1","5","6","16.66666666666666666666666667"
"2020-02-29T00:00:00.000","Norfolk","VA","Passenger","1","1","2","354","356","0.5617977528089887640449438202"
"2020-02-29T00:00:00.000","Portsmouth","VA","Passenger","0","1","1","68","69","1.449275362318840579710144928"
"2020-02-29T00:00:00.000","Powhatan","VA","Passenger","1","0","1","0","1","100"
"2020-02-29T00:00:00.000","Prince William","VA","Passenger","2","3","5","227","232","2.155172413793103448275862069"
"2020-02-29T00:00:00.000","Stafford","VA","Passenger","1","1","2","91","93","2.150537634408602150537634409"
"2020-02-29T00:00:00.000","Suffolk","VA","Passenger","1","0","1","111","112","0.8928571428571428571428571429"
"2020-02-29T00:00:00.000","Virginia Beach","VA","Passenger","1","0","1","666","667","0.1499250374812593703148425787"
"2020-02-29T00:00:00.000","Adams","WA","Passenger","7","8","15","12913","12928","0.1160272277227722772277227723"
"2020-02-29T00:00:00.000","Adams","WA","Truck","0","0","0","5220","5220","0"
"2020-02-29T00:00:00.000","Asotin","WA","Passenger","17","12","29","12677","12706","0.2282386274201164804029592319"
"2020-02-29T00:00:00.000","Asotin","WA","Truck","0","0","0","6702","6702","0"
"2020-02-29T00:00:00.000","Benton","WA","Passenger","349","330","679","135341","136020","0.4991912953977356271136597559"
"2020-02-29T00:00:00.000","Benton","WA","Truck","0","0","0","42576","42576","0"
"2020-02-29T00:00:00.000","Chelan","WA","Passenger","218","78","296","54618","54914","0.5390246567359871799541100630"
"2020-02-29T00:00:00.000","Chelan","WA","Truck","0","0","0","22578","22578","0"
"2020-02-29T00:00:00.000","Clallam","WA","Passenger","218","167","385","50797","51182","0.7522175764917353757180258685"
"2020-02-29T00:00:00.000","Clallam","WA","Truck","1","0","1","21844","21845","0.004577706569008926527809567407"
"2020-02-29T00:00:00.000","Clark","WA","Passenger","2069","1101","3170","320481","323651","0.9794500866674288044838421633"
"2020-02-29T00:00:00.000","Clark","WA","Truck","0","0","0","81997","81997","0"
"2020-02-29T00:00:00.000","Columbia","WA","Truck","0","0","0","1536","1536","0"
"2020-02-29T00:00:00.000","Columbia","WA","Passenger","3","3","6","2433","2439","0.2460024600246002460024600246"
"2020-02-29T00:00:00.000","Cowlitz","WA","Passenger","138","124","262","73456","73718","0.3554084484115141485118966874"
"2020-02-29T00:00:00.000","Cowlitz","WA","Truck","0","0","0","29005","29005","0"
"2020-02-29T00:00:00.000","Douglas","WA","Truck","0","0","0","12320","12320","0"
"2020-02-29T00:00:00.000","Douglas","WA","Passenger","70","41","111","28277","28388","0.3910102860363533887558123151"
"2020-02-29T00:00:00.000","Ferry","WA","Truck","0","0","0","3579","3579","0"
"2020-02-29T00:00:00.000","Ferry","WA","Passenger","5","2","7","4375","4382","0.1597444089456869009584664537"
"2020-02-29T00:00:00.000","Franklin","WA","Truck","0","0","0","19900","19900","0"
"2020-02-29T00:00:00.000","Franklin","WA","Passenger","65","80","145","61135","61280","0.2366187989556135770234986945"
"2020-02-29T00:00:00.000","Garfield","WA","Truck","0","0","0","965","965","0"
"2020-02-29T00:00:00.000","Garfield","WA","Passenger","0","1","1","1350","1351","0.07401924500370096225018504811"
"2020-02-29T00:00:00.000","Grant","WA","Passenger","61","74","135","65578","65713","0.2054388020635186340602316132"
"2020-02-29T00:00:00.000","Grant","WA","Truck","0","0","0","27076","27076","0"
"2020-02-29T00:00:00.000","Grays Harbor","WA","Truck","0","0","0","20810","20810","0"
"2020-02-29T00:00:00.000","Grays Harbor","WA","Passenger","123","114","237","48364","48601","0.4876442871545852965988354149"
"2020-02-29T00:00:00.000","Island","WA","Passenger","416","281","697","63526","64223","1.085280974105849929153107142"
"2020-02-29T00:00:00.000","Island","WA","Truck","1","0","1","21348","21349","0.004684060143332240385966555811"
"2020-02-29T00:00:00.000","Jefferson","WA","Passenger","240","149","389","25170","25559","1.521968778121209749990218710"
"2020-02-29T00:00:00.000","Jefferson","WA","Truck","0","0","0","9647","9647","0"
"2020-02-29T00:00:00.000","King","WA","Truck","6","1","7","182670","182677","0.003831900020254328678487165872"
"2020-02-29T00:00:00.000","King","WA","Passenger","23859","7997","31856","1400370","1432226","2.224229974878266418847304825"
"2020-02-29T00:00:00.000","Kitsap","WA","Passenger","1350","694","2044","182361","184405","1.108429814809793660692497492"
"2020-02-29T00:00:00.000","Kitsap","WA","Truck","1","0","1","54436","54437","0.001836985873578632180318533350"
"2020-02-29T00:00:00.000","Kittitas","WA","Truck","0","0","0","14652","14652","0"
"2020-02-29T00:00:00.000","Kittitas","WA","Passenger","97","51","148","30020","30168","0.4905860514452399893927340228"
"2020-02-29T00:00:00.000","Klickitat","WA","Truck","0","0","0","8303","8303","0"
"2020-02-29T00:00:00.000","Klickitat","WA","Passenger","54","42","96","15687","15783","0.6082493822467211556738262688"
"2020-02-29T00:00:00.000","Lewis","WA","Passenger","117","112","229","59563","59792","0.3829943805191329943805191330"
"2020-02-29T00:00:00.000","Lewis","WA","Truck","0","0","0","26105","26105","0"
"2020-02-29T00:00:00.000","Lincoln","WA","Passenger","3","12","15","7785","7800","0.1923076923076923076923076923"
"2020-02-29T00:00:00.000","Lincoln","WA","Truck","0","0","0","4657","4657","0"
"2020-02-29T00:00:00.000","Mason","WA","Passenger","173","142","315","47577","47892","0.6577298922575795539964921072"
"2020-02-29T00:00:00.000","Mason","WA","Truck","0","0","0","20605","20605","0"
"2020-02-29T00:00:00.000","Okanogan","WA","Truck","0","0","0","16504","16504","0"
"2020-02-29T00:00:00.000","Okanogan","WA","Passenger","35","31","66","26127","26193","0.2519757187034703928530523422"
"2020-02-29T00:00:00.000","Pacific","WA","Passenger","39","35","74","16059","16133","0.4586871629579123535610239881"
"2020-02-29T00:00:00.000","Pacific","WA","Truck","0","0","0","7745","7745","0"
"2020-02-29T00:00:00.000","Pend Oreille","WA","Truck","0","0","0","5762","5762","0"
"2020-02-29T00:00:00.000","Pend Oreille","WA","Passenger","9","7","16","9456","9472","0.1689189189189189189189189189"
"2020-02-29T00:00:00.000","Pierce","WA","Passenger","2471","1804","4275","551257","555532","0.7695326281834349776430520654"
"2020-02-29T00:00:00.000","Pierce","WA","Truck","0","0","0","141578","141578","0"
"2020-02-29T00:00:00.000","San Juan","WA","Truck","0","0","0","5929","5929","0"
"2020-02-29T00:00:00.000","San Juan","WA","Passenger","280","84","364","14330","14694","2.477201578875731591125629509"
"2020-02-29T00:00:00.000","Skagit","WA","Passenger","408","235","643","92454","93097","0.6906774654392730163163152411"
"2020-02-29T00:00:00.000","Skagit","WA","Truck","1","0","1","32568","32569","0.003070404372255826092296355430"
"2020-02-29T00:00:00.000","Skamania","WA","Truck","0","0","0","4104","4104","0"
"2020-02-29T00:00:00.000","Skamania","WA","Passenger","31","19","50","8774","8824","0.5666364460562103354487760653"
"2020-02-29T00:00:00.000","Snohomish","WA","Passenger","4453","1832","6285","538132","544417","1.154445948601898912047199114"
"2020-02-29T00:00:00.000","Snohomish","WA","Truck","0","0","0","123771","123771","0"
"2020-02-29T00:00:00.000","Spokane","WA","Passenger","733","502","1235","317648","318883","0.3872893819990404003976380052"
"2020-02-29T00:00:00.000","Spokane","WA","Truck","1","0","1","97202","97203","0.001028774832052508667427960042"
"2020-02-29T00:00:00.000","Stevens","WA","Truck","0","0","0","18758","18758","0"
"2020-02-29T00:00:00.000","Stevens","WA","Passenger","36","36","72","31441","31513","0.2284771364198902040427759972"
"2020-02-29T00:00:00.000","Thurston","WA","Passenger","1199","779","1978","199035","201013","0.9840159591668200564142617642"
"2020-02-29T00:00:00.000","Thurston","WA","Truck","0","0","0","55755","55755","0"
"2020-02-29T00:00:00.000","Wahkiakum","WA","Passenger","5","6","11","3018","3029","0.3631561571475734565863321228"
"2020-02-29T00:00:00.000","Wahkiakum","WA","Truck","0","0","0","1762","1762","0"
"2020-02-29T00:00:00.000","Walla Walla","WA","Passenger","69","63","132","36334","36466","0.3619810234190753030219930895"
"2020-02-29T00:00:00.000","Walla Walla","WA","Truck","0","0","0","13706","13706","0"
"2020-02-29T00:00:00.000","Whatcom","WA","Truck","3","0","3","43160","43163","0.006950397331047424877788846929"
"2020-02-29T00:00:00.000","Whatcom","WA","Passenger","1093","506","1599","151619","153218","1.043611063974206685898523672"
"2020-02-29T00:00:00.000","Whitman","WA","Truck","0","0","0","8559","8559","0"
"2020-02-29T00:00:00.000","Whitman","WA","Passenger","43","51","94","22640","22734","0.4134776106272543327175156154"
"2020-02-29T00:00:00.000","Yakima","WA","Passenger","134","125","259","165989","166248","0.1557913478658389875366921707"
"2020-02-29T00:00:00.000","Yakima","WA","Truck","0","0","0","59639","59639","0"
"2020-02-29T00:00:00.000","Ozaukee","WI","Passenger","0","1","1","3","4","25.00"
"2020-02-29T00:00:00.000",,,"Passenger","2","0","2","225","227","0.8810572687224669603524229075"
"2020-03-31T00:00:00.000","Fairbanks North Star","AK","Passenger","0","1","1","98","99","1.010101010101010101010101010"
"2020-03-31T00:00:00.000","Juneau","AK","Passenger","0","2","2","30","32","6.2500"
"2020-03-31T00:00:00.000","Montgomery","AL","Passenger","0","1","1","36","37","2.702702702702702702702702703"
"2020-03-31T00:00:00.000","Cochise","AZ","Passenger","0","1","1","108","109","0.9174311926605504587155963303"
"2020-03-31T00:00:00.000","Maricopa","AZ","Passenger","8","7","15","1309","1324","1.132930513595166163141993958"
"2020-03-31T00:00:00.000","Pima","AZ","Passenger","3","1","4","335","339","1.179941002949852507374631268"
"2020-03-31T00:00:00.000","Pinal","AZ","Passenger","1","0","1","164","165","0.6060606060606060606060606061"
"2020-03-31T00:00:00.000","Alameda","CA","Passenger","3","1","4","264","268","1.492537313432835820895522388"
"2020-03-31T00:00:00.000","Contra Costa","CA","Passenger","3","2","5","367","372","1.344086021505376344086021505"
"2020-03-31T00:00:00.000","Fresno","CA","Passenger","1","0","1","183","184","0.5434782608695652173913043478"
"2020-03-31T00:00:00.000","Kern","CA","Passenger","1","1","2","223","225","0.8888888888888888888888888889"
"2020-03-31T00:00:00.000","Los Angeles","CA","Passenger","8","10","18","995","1013","1.776900296150049358341559724"
"2020-03-31T00:00:00.000","Monterey","CA","Passenger","1","0","1","180","181","0.5524861878453038674033149171"
"2020-03-31T00:00:00.000","Orange","CA","Passenger","6","2","8","492","500","1.600"
"2020-03-31T00:00:00.000","Placer","CA","Passenger","1","0","1","84","85","1.176470588235294117647058824"
"2020-03-31T00:00:00.000","Riverside","CA","Passenger","3","1","4","603","607","0.6589785831960461285008237232"
"2020-03-31T00:00:00.000","Sacramento","CA","Passenger","1","0","1","263","264","0.3787878787878787878787878788"
"2020-03-31T00:00:00.000","San Bernardino","CA","Passenger","0","1","1","444","445","0.2247191011235955056179775281"
"2020-03-31T00:00:00.000","San Diego","CA","Passenger","12","7","19","2829","2848","0.6671348314606741573033707865"
"2020-03-31T00:00:00.000","San Francisco","CA","Passenger","2","1","3","90","93","3.225806451612903225806451613"
"2020-03-31T00:00:00.000","San Mateo","CA","Passenger","0","1","1","113","114","0.8771929824561403508771929825"
"2020-03-31T00:00:00.000","Santa Barbara","CA","Passenger","2","0","2","89","91","2.197802197802197802197802198"
"2020-03-31T00:00:00.000","Santa Clara","CA","Passenger","6","2","8","307","315","2.539682539682539682539682540"
"2020-03-31T00:00:00.000","Santa Cruz","CA","Passenger","1","0","1","37","38","2.631578947368421052631578947"
"2020-03-31T00:00:00.000","Shasta","CA","Passenger","1","0","1","38","39","2.564102564102564102564102564"
"2020-03-31T00:00:00.000","Solano","CA","Passenger","1","0","1","218","219","0.4566210045662100456621004566"
"2020-03-31T00:00:00.000","Tuolumne","CA","Passenger","0","1","1","7","8","12.500"
"2020-03-31T00:00:00.000","Ventura","CA","Passenger","0","3","3","296","299","1.003344481605351170568561873"
"2020-03-31T00:00:00.000","Arapahoe","CO","Passenger","1","0","1","136","137","0.7299270072992700729927007299"
"2020-03-31T00:00:00.000","Boulder","CO","Passenger","0","1","1","42","43","2.325581395348837209302325581"
"2020-03-31T00:00:00.000","Denver","CO","Passenger","1","0","1","117","118","0.8474576271186440677966101695"
"2020-03-31T00:00:00.000","El Paso","CO","Passenger","2","0","2","704","706","0.2832861189801699716713881020"
"2020-03-31T00:00:00.000","Jefferson","CO","Passenger","0","1","1","60","61","1.639344262295081967213114754"
"2020-03-31T00:00:00.000","Larimer","CO","Passenger","1","1","2","49","51","3.921568627450980392156862745"
"2020-03-31T00:00:00.000","New London","CT","Passenger","0","2","2","260","262","0.7633587786259541984732824427"
"2020-03-31T00:00:00.000","District of Columbia","DC","Passenger","1","3","4","204","208","1.923076923076923076923076923"
"2020-03-31T00:00:00.000","Kent","DE","Passenger","0","1","1","70","71","1.408450704225352112676056338"
"2020-03-31T00:00:00.000","New Castle","DE","Passenger","1","0","1","24","25","4.00"
"2020-03-31T00:00:00.000","Brevard","FL","Passenger","0","1","1","79","80","1.2500"
"2020-03-31T00:00:00.000","Broward","FL","Passenger","2","1","3","111","114","2.631578947368421052631578947"
"2020-03-31T00:00:00.000","Clay","FL","Passenger","0","1","1","81","82","1.219512195121951219512195122"
"2020-03-31T00:00:00.000","Duval","FL","Passenger","0","1","1","352","353","0.2832861189801699716713881020"
"2020-03-31T00:00:00.000","Lake","FL","Passenger","1","0","1","18","19","5.263157894736842105263157895"
"2020-03-31T00:00:00.000","Osceola","FL","Passenger","1","0","1","39","40","2.500"
"2020-03-31T00:00:00.000","Palm Beach","FL","Passenger","0","2","2","68","70","2.857142857142857142857142857"
"2020-03-31T00:00:00.000","Pinellas","FL","Passenger","1","1","2","96","98","2.040816326530612244897959184"
"2020-03-31T00:00:00.000","Polk","FL","Passenger","1","0","1","68","69","1.449275362318840579710144928"
"2020-03-31T00:00:00.000","Sarasota","FL","Passenger","2","0","2","27","29","6.896551724137931034482758621"
"2020-03-31T00:00:00.000","Sumter","FL","Passenger","0","1","1","9","10","10.0"
"2020-03-31T00:00:00.000","Bryan","GA","Passenger","1","0","1","52","53","1.886792452830188679245283019"
"2020-03-31T00:00:00.000","Camden","GA","Passenger","0","1","1","152","153","0.6535947712418300653594771242"
"2020-03-31T00:00:00.000","Columbia","GA","Passenger","1","1","2","144","146","1.369863013698630136986301370"
"2020-03-31T00:00:00.000","DeKalb","GA","Passenger","1","0","1","76","77","1.298701298701298701298701299"
"2020-03-31T00:00:00.000","Fulton","GA","Passenger","1","2","3","101","104","2.884615384615384615384615385"
"2020-03-31T00:00:00.000","Houston","GA","Passenger","1","0","1","57","58","1.724137931034482758620689655"
"2020-03-31T00:00:00.000","Jones","GA","Passenger","1","0","1","1","2","50.0"
"2020-03-31T00:00:00.000","Liberty","GA","Passenger","1","0","1","113","114","0.8771929824561403508771929825"
"2020-03-31T00:00:00.000","Honolulu","HI","Passenger","4","1","5","450","455","1.098901098901098901098901099"
"2020-03-31T00:00:00.000","Maui","HI","Passenger","1","0","1","31","32","3.12500"
"2020-03-31T00:00:00.000","Ada","ID","Passenger","0","1","1","267","268","0.3731343283582089552238805970"
"2020-03-31T00:00:00.000","Kootenai","ID","Passenger","1","1","2","208","210","0.9523809523809523809523809524"
"2020-03-31T00:00:00.000","Twin Falls","ID","Passenger","0","1","1","24","25","4.00"
"2020-03-31T00:00:00.000","DuPage","IL","Passenger","3","0","3","57","60","5.00"
"2020-03-31T00:00:00.000","Lake","IL","Passenger","1","0","1","175","176","0.5681818181818181818181818182"
"2020-03-31T00:00:00.000","Monroe","IL","Passenger","1","0","1","3","4","25.00"
"2020-03-31T00:00:00.000","St. Clair","IL","Passenger","1","0","1","141","142","0.7042253521126760563380281690"
"2020-03-31T00:00:00.000","DeKalb","IN","Passenger","1","0","1","1","2","50.0"
"2020-03-31T00:00:00.000","Hamilton","IN","Passenger","1","0","1","40","41","2.439024390243902439024390244"
"2020-03-31T00:00:00.000","Vigo","IN","Passenger","1","0","1","4","5","20.0"
"2020-03-31T00:00:00.000","Sedgwick","KS","Passenger","1","0","1","91","92","1.086956521739130434782608696"
"2020-03-31T00:00:00.000","Oldham","KY","Passenger","0","1","1","4","5","20.0"
"2020-03-31T00:00:00.000","Middlesex","MA","Passenger","1","1","2","103","105","1.904761904761904761904761905"
"2020-03-31T00:00:00.000","Suffolk","MA","Passenger","0","2","2","41","43","4.651162790697674418604651163"
"2020-03-31T00:00:00.000","Anne Arundel","MD","Passenger","1","1","2","425","427","0.4683840749414519906323185012"
"2020-03-31T00:00:00.000","Calvert","MD","Passenger","0","2","2","88","90","2.222222222222222222222222222"
"2020-03-31T00:00:00.000","Charles","MD","Passenger","0","1","1","70","71","1.408450704225352112676056338"
"2020-03-31T00:00:00.000","Frederick","MD","Passenger","2","1","3","83","86","3.488372093023255813953488372"
"2020-03-31T00:00:00.000","Howard","MD","Passenger","0","1","1","71","72","1.388888888888888888888888889"
"2020-03-31T00:00:00.000","Montgomery","MD","Passenger","0","2","2","256","258","0.7751937984496124031007751938"
"2020-03-31T00:00:00.000","St. Mary's","MD","Passenger","1","0","1","203","204","0.4901960784313725490196078431"
"2020-03-31T00:00:00.000","Penobscot","ME","Passenger","0","1","1","16","17","5.882352941176470588235294118"
"2020-03-31T00:00:00.000","Kent","MI","Passenger","0","1","1","22","23","4.347826086956521739130434783"
"2020-03-31T00:00:00.000","Saginaw","MI","Passenger","1","0","1","12","13","7.692307692307692307692307692"
"2020-03-31T00:00:00.000","Washtenaw","MI","Passenger","1","0","1","29","30","3.333333333333333333333333333"
"2020-03-31T00:00:00.000","Hennepin","MN","Passenger","2","1","3","87","90","3.333333333333333333333333333"
"2020-03-31T00:00:00.000","Kanabec","MN","Passenger","1","0","1","0","1","100"
"2020-03-31T00:00:00.000","Ramsey","MN","Passenger","1","0","1","38","39","2.564102564102564102564102564"
"2020-03-31T00:00:00.000","Boone","MO","Passenger","0","1","1","11","12","8.333333333333333333333333333"
"2020-03-31T00:00:00.000","Greene","MO","Passenger","0","1","1","25","26","3.846153846153846153846153846"
"2020-03-31T00:00:00.000","St. Louis","MO","Passenger","1","0","1","96","97","1.030927835051546391752577320"
"2020-03-31T00:00:00.000","Harrison","MS","Passenger","1","0","1","59","60","1.666666666666666666666666667"
"2020-03-31T00:00:00.000","Cascade","MT","Passenger","0","1","1","56","57","1.754385964912280701754385965"
"2020-03-31T00:00:00.000","Flathead","MT","Passenger","1","0","1","60","61","1.639344262295081967213114754"
"2020-03-31T00:00:00.000","Glacier","MT","Passenger","0","1","1","5","6","16.66666666666666666666666667"
"2020-03-31T00:00:00.000","Cumberland","NC","Passenger","0","2","2","491","493","0.4056795131845841784989858012"
"2020-03-31T00:00:00.000","Guilford","NC","Passenger","1","0","1","29","30","3.333333333333333333333333333"
"2020-03-31T00:00:00.000","Harnett","NC","Passenger","0","1","1","206","207","0.4830917874396135265700483092"
"2020-03-31T00:00:00.000","Mecklenburg","NC","Passenger","1","0","1","72","73","1.369863013698630136986301370"
"2020-03-31T00:00:00.000","Moore","NC","Passenger","0","1","1","168","169","0.5917159763313609467455621302"
"2020-03-31T00:00:00.000","Williams","ND","Passenger","0","1","1","13","14","7.142857142857142857142857143"
"2020-03-31T00:00:00.000","Douglas","NE","Passenger","0","1","1","58","59","1.694915254237288135593220339"
"2020-03-31T00:00:00.000","Carroll","NH","Passenger","0","1","1","2","3","33.33333333333333333333333333"
"2020-03-31T00:00:00.000","Camden","NJ","Passenger","0","2","2","19","21","9.523809523809523809523809524"
"2020-03-31T00:00:00.000","Hudson","NJ","Passenger","1","0","1","154","155","0.6451612903225806451612903226"
"2020-03-31T00:00:00.000","Chaves","NM","Passenger","1","0","1","8","9","11.11111111111111111111111111"
"2020-03-31T00:00:00.000","Valencia","NM","Passenger","1","0","1","4","5","20.0"
"2020-03-31T00:00:00.000","Carson City","NV","Passenger","1","0","1","11","12","8.333333333333333333333333333"
"2020-03-31T00:00:00.000","Clark","NV","Passenger","3","4","7","668","675","1.037037037037037037037037037"
"2020-03-31T00:00:00.000","Washoe","NV","Passenger","1","0","1","91","92","1.086956521739130434782608696"
"2020-03-31T00:00:00.000","Erie","NY","Passenger","1","0","1","39","40","2.500"
"2020-03-31T00:00:00.000","Jefferson","NY","Passenger","0","1","1","222","223","0.4484304932735426008968609865"
"2020-03-31T00:00:00.000","Nassau","NY","Passenger","2","0","2","33","35","5.714285714285714285714285714"
"2020-03-31T00:00:00.000","Queens","NY","Passenger","1","0","1","52","53","1.886792452830188679245283019"
"2020-03-31T00:00:00.000","Westchester","NY","Passenger","0","1","1","27","28","3.571428571428571428571428571"
"2020-03-31T00:00:00.000","Montgomery","OH","Passenger","0","1","1","44","45","2.222222222222222222222222222"
"2020-03-31T00:00:00.000","Shelby","OH","Passenger","0","1","1","1","2","50.0"
"2020-03-31T00:00:00.000","Oklahoma","OK","Passenger","0","2","2","120","122","1.639344262295081967213114754"
"2020-03-31T00:00:00.000","Rogers","OK","Passenger","1","0","1","6","7","14.28571428571428571428571429"
"2020-03-31T00:00:00.000","Tulsa","OK","Passenger","1","1","2","43","45","4.444444444444444444444444444"
"2020-03-31T00:00:00.000","Clackamas","OR","Passenger","2","1","3","193","196","1.530612244897959183673469388"
"2020-03-31T00:00:00.000","Deschutes","OR","Passenger","3","0","3","133","136","2.205882352941176470588235294"
"2020-03-31T00:00:00.000","Klamath","OR","Passenger","1","0","1","28","29","3.448275862068965517241379310"
"2020-03-31T00:00:00.000","Multnomah","OR","Passenger","4","6","10","692","702","1.424501424501424501424501425"
"2020-03-31T00:00:00.000","Washington","OR","Passenger","1","0","1","418","419","0.2386634844868735083532219570"
"2020-03-31T00:00:00.000","Allegheny","PA","Passenger","1","0","1","66","67","1.492537313432835820895522388"
"2020-03-31T00:00:00.000","Bucks","PA","Passenger","1","0","1","20","21","4.761904761904761904761904762"
"2020-03-31T00:00:00.000","Montgomery","PA","Passenger","1","0","1","28","29","3.448275862068965517241379310"
"2020-03-31T00:00:00.000","RÃ­o Grande","PR","Passenger","1","0","1","1","2","50.0"
"2020-03-31T00:00:00.000","Newport","RI","Passenger","1","0","1","82","83","1.204819277108433734939759036"
"2020-03-31T00:00:00.000","Richland","SC","Passenger","0","1","1","156","157","0.6369426751592356687898089172"
"2020-03-31T00:00:00.000","Spartanburg","SC","Passenger","0","1","1","40","41","2.439024390243902439024390244"
"2020-03-31T00:00:00.000","Davidson","TN","Passenger","1","0","1","62","63","1.587301587301587301587301587"
"2020-03-31T00:00:00.000","Putnam","TN","Passenger","0","1","1","2","3","33.33333333333333333333333333"
"2020-03-31T00:00:00.000","Shelby","TN","Passenger","0","1","1","90","91","1.098901098901098901098901099"
"2020-03-31T00:00:00.000","Tipton","TN","Passenger","1","0","1","14","15","6.666666666666666666666666667"
"2020-03-31T00:00:00.000","Bell","TX","Passenger","0","1","1","408","409","0.2444987775061124694376528117"
"2020-03-31T00:00:00.000","Bexar","TX","Passenger","4","5","9","592","601","1.497504159733777038269550749"
"2020-03-31T00:00:00.000","Dallas","TX","Passenger","1","0","1","191","192","0.5208333333333333333333333333"
"2020-03-31T00:00:00.000","Denton","TX","Passenger","1","0","1","78","79","1.265822784810126582278481013"
"2020-03-31T00:00:00.000","El Paso","TX","Passenger","2","0","2","433","435","0.4597701149425287356321839080"
"2020-03-31T00:00:00.000","Guadalupe","TX","Passenger","1","0","1","56","57","1.754385964912280701754385965"
"2020-03-31T00:00:00.000","Harris","TX","Passenger","1","0","1","233","234","0.4273504273504273504273504274"
"2020-03-31T00:00:00.000","Hidalgo","TX","Passenger","0","1","1","72","73","1.369863013698630136986301370"
"2020-03-31T00:00:00.000","Montgomery","TX","Passenger","1","0","1","43","44","2.272727272727272727272727273"
"2020-03-31T00:00:00.000","Nueces","TX","Passenger","1","0","1","81","82","1.219512195121951219512195122"
"2020-03-31T00:00:00.000","Tarrant","TX","Passenger","1","0","1","164","165","0.6060606060606060606060606061"
"2020-03-31T00:00:00.000","Travis","TX","Passenger","2","2","4","172","176","2.272727272727272727272727273"
"2020-03-31T00:00:00.000","Albemarle","VA","Passenger","1","0","1","21","22","4.545454545454545454545454545"
"2020-03-31T00:00:00.000","Alexandria","VA","Passenger","3","0","3","142","145","2.068965517241379310344827586"
"2020-03-31T00:00:00.000","Arlington","VA","Passenger","0","2","2","149","151","1.324503311258278145695364238"
"2020-03-31T00:00:00.000","Chesapeake","VA","Passenger","0","2","2","428","430","0.4651162790697674418604651163"
"2020-03-31T00:00:00.000","Fairfax","VA","Passenger","4","4","8","739","747","1.070950468540829986613119143"
"2020-03-31T00:00:00.000","Goochland","VA","Passenger","2","1","3","229","232","1.293103448275862068965517241"
"2020-03-31T00:00:00.000","Loudoun","VA","Passenger","1","0","1","85","86","1.162790697674418604651162791"
"2020-03-31T00:00:00.000","Manassas","VA","Passenger","0","1","1","4","5","20.0"
"2020-03-31T00:00:00.000","Norfolk","VA","Passenger","1","1","2","350","352","0.5681818181818181818181818182"
"2020-03-31T00:00:00.000","Portsmouth","VA","Passenger","0","1","1","68","69","1.449275362318840579710144928"
"2020-03-31T00:00:00.000","Powhatan","VA","Passenger","1","0","1","0","1","100"
"2020-03-31T00:00:00.000","Prince William","VA","Passenger","2","3","5","223","228","2.192982456140350877192982456"
"2020-03-31T00:00:00.000","Stafford","VA","Passenger","1","1","2","91","93","2.150537634408602150537634409"
"2020-03-31T00:00:00.000","Suffolk","VA","Passenger","1","0","1","111","112","0.8928571428571428571428571429"
"2020-03-31T00:00:00.000","Virginia Beach","VA","Passenger","1","0","1","656","657","0.1522070015220700152207001522"
"2020-03-31T00:00:00.000","Adams","WA","Passenger","7","8","15","12891","12906","0.1162250116225011622501162250"
"2020-03-31T00:00:00.000","Adams","WA","Truck","0","0","0","5218","5218","0"
"2020-03-31T00:00:00.000","Asotin","WA","Truck","0","0","0","6673","6673","0"
"2020-03-31T00:00:00.000","Asotin","WA","Passenger","17","13","30","12603","12633","0.2374732842555212538589408692"
"2020-03-31T00:00:00.000","Benton","WA","Truck","0","0","0","42522","42522","0"
"2020-03-31T00:00:00.000","Benton","WA","Passenger","355","329","684","135197","135881","0.5033816354015646043229001847"
"2020-03-31T00:00:00.000","Chelan","WA","Truck","0","0","0","22557","22557","0"
"2020-03-31T00:00:00.000","Chelan","WA","Passenger","222","79","301","54494","54795","0.5493201934483073273108860297"
"2020-03-31T00:00:00.000","Clallam","WA","Passenger","226","170","396","50655","51051","0.7756948933419521654815772463"
"2020-03-31T00:00:00.000","Clallam","WA","Truck","1","0","1","21822","21823","0.004582321404023278192732438253"
"2020-03-31T00:00:00.000","Clark","WA","Truck","0","0","0","82064","82064","0"
"2020-03-31T00:00:00.000","Clark","WA","Passenger","2082","1103","3185","320233","323418","0.9847936725847046237377016740"
"2020-03-31T00:00:00.000","Columbia","WA","Passenger","3","3","6","2416","2422","0.2477291494632535094962840628"
"2020-03-31T00:00:00.000","Columbia","WA","Truck","0","0","0","1534","1534","0"
"2020-03-31T00:00:00.000","Cowlitz","WA","Passenger","144","127","271","73165","73436","0.3690288142055667520017430143"
"2020-03-31T00:00:00.000","Cowlitz","WA","Truck","0","0","0","28862","28862","0"
"2020-03-31T00:00:00.000","Douglas","WA","Passenger","72","41","113","28180","28293","0.3993920757784611034531509561"
"2020-03-31T00:00:00.000","Douglas","WA","Truck","0","0","0","12333","12333","0"
"2020-03-31T00:00:00.000","Ferry","WA","Truck","0","0","0","3562","3562","0"
"2020-03-31T00:00:00.000","Ferry","WA","Passenger","5","3","8","4367","4375","0.1828571428571428571428571429"
"2020-03-31T00:00:00.000","Franklin","WA","Passenger","63","82","145","61025","61170","0.2370443027627922184077162008"
"2020-03-31T00:00:00.000","Franklin","WA","Truck","0","0","0","19905","19905","0"
"2020-03-31T00:00:00.000","Garfield","WA","Truck","0","0","0","976","976","0"
"2020-03-31T00:00:00.000","Garfield","WA","Passenger","0","1","1","1352","1353","0.07390983000739098300073909830"
"2020-03-31T00:00:00.000","Grant","WA","Passenger","61","75","136","65501","65637","0.2072002072002072002072002072"
"2020-03-31T00:00:00.000","Grant","WA","Truck","0","0","0","27066","27066","0"
"2020-03-31T00:00:00.000","Grays Harbor","WA","Passenger","122","115","237","48309","48546","0.4881967618341366950933135583"
"2020-03-31T00:00:00.000","Grays Harbor","WA","Truck","0","0","0","20789","20789","0"
"2020-03-31T00:00:00.000","Island","WA","Truck","1","0","1","21284","21285","0.004698144233027953958186516326"
"2020-03-31T00:00:00.000","Island","WA","Passenger","421","288","709","63301","64010","1.107639431338853304171223246"
"2020-03-31T00:00:00.000","Jefferson","WA","Passenger","244","152","396","25068","25464","1.555136663524976437323279925"
"2020-03-31T00:00:00.000","Jefferson","WA","Truck","0","0","0","9598","9598","0"
"2020-03-31T00:00:00.000","King","WA","Passenger","24296","8046","32342","1397159","1429501","2.262467812194604970545665935"
"2020-03-31T00:00:00.000","King","WA","Truck","5","1","6","182489","182495","0.003287761308529000794542316228"
"2020-03-31T00:00:00.000","Kitsap","WA","Passenger","1376","708","2084","181851","183935","1.133008943376736347079131215"
"2020-03-31T00:00:00.000","Kitsap","WA","Truck","1","0","1","54260","54261","0.001842944287794179981939145980"
"2020-03-31T00:00:00.000","Kittitas","WA","Passenger","102","51","153","30004","30157","0.5073448950492422986371323408"
"2020-03-31T00:00:00.000","Kittitas","WA","Truck","0","0","0","14623","14623","0"
"2020-03-31T00:00:00.000","Klickitat","WA","Passenger","56","42","98","15598","15696","0.6243628950050968399592252803"
"2020-03-31T00:00:00.000","Klickitat","WA","Truck","0","0","0","8275","8275","0"
"2020-03-31T00:00:00.000","Lewis","WA","Truck","0","0","0","26036","26036","0"
"2020-03-31T00:00:00.000","Lewis","WA","Passenger","114","115","229","59189","59418","0.3854050960988252718031572924"
"2020-03-31T00:00:00.000","Lincoln","WA","Passenger","4","12","16","7754","7770","0.2059202059202059202059202059"
"2020-03-31T00:00:00.000","Lincoln","WA","Truck","0","0","0","4658","4658","0"
"2020-03-31T00:00:00.000","Mason","WA","Truck","0","0","0","20580","20580","0"
"2020-03-31T00:00:00.000","Mason","WA","Passenger","177","144","321","47493","47814","0.6713514870121721671476973271"
"2020-03-31T00:00:00.000","Okanogan","WA","Passenger","35","31","66","26074","26140","0.2524866105585309869931140015"
"2020-03-31T00:00:00.000","Okanogan","WA","Truck","0","0","0","16464","16464","0"
"2020-03-31T00:00:00.000","Pacific","WA","Passenger","39","37","76","16012","16088","0.4724017901541521631029338637"
"2020-03-31T00:00:00.000","Pacific","WA","Truck","0","0","0","7711","7711","0"
"2020-03-31T00:00:00.000","Pend Oreille","WA","Passenger","8","7","15","9372","9387","0.1597954618088846276765739853"
"2020-03-31T00:00:00.000","Pend Oreille","WA","Truck","0","0","0","5756","5756","0"
"2020-03-31T00:00:00.000","Pierce","WA","Truck","0","0","0","141674","141674","0"
"2020-03-31T00:00:00.000","Pierce","WA","Passenger","2523","1809","4332","551272","555604","0.7796920108566532998322546274"
"2020-03-31T00:00:00.000","San Juan","WA","Passenger","293","88","381","14280","14661","2.598731328013095968897073869"
"2020-03-31T00:00:00.000","San Juan","WA","Truck","0","0","0","5936","5936","0"
"2020-03-31T00:00:00.000","Skagit","WA","Truck","1","0","1","32561","32562","0.003071064430931760948344696272"
"2020-03-31T00:00:00.000","Skagit","WA","Passenger","419","238","657","92144","92801","0.7079665089815842501697179987"
"2020-03-31T00:00:00.000","Skamania","WA","Truck","0","0","0","4084","4084","0"
"2020-03-31T00:00:00.000","Skamania","WA","Passenger","32","18","50","8717","8767","0.5703205201323143606706969317"
"2020-03-31T00:00:00.000","Snohomish","WA","Truck","0","0","0","123766","123766","0"
"2020-03-31T00:00:00.000","Snohomish","WA","Passenger","4518","1858","6376","537410","543786","1.172520072234298051071561239"
"2020-03-31T00:00:00.000","Spokane","WA","Truck","1","0","1","97502","97503","0.001025609468426612514486733742"
"2020-03-31T00:00:00.000","Spokane","WA","Passenger","741","506","1247","318074","319321","0.3905161264057171310374200256"
"2020-03-31T00:00:00.000","Stevens","WA","Truck","0","0","0","18703","18703","0"
"2020-03-31T00:00:00.000","Stevens","WA","Passenger","36","35","71","31259","31330","0.2266198531758697733801468241"
"2020-03-31T00:00:00.000","Thurston","WA","Truck","0","0","0","55720","55720","0"
"2020-03-31T00:00:00.000","Thurston","WA","Passenger","1218","782","2000","198681","200681","0.9966065546813101389767840503"
"2020-03-31T00:00:00.000","Wahkiakum","WA","Truck","0","0","0","1760","1760","0"
"2020-03-31T00:00:00.000","Wahkiakum","WA","Passenger","6","6","12","3007","3019","0.3974826101358065584630672408"
"2020-03-31T00:00:00.000","Walla Walla","WA","Truck","0","0","0","13652","13652","0"
"2020-03-31T00:00:00.000","Walla Walla","WA","Passenger","69","64","133","36255","36388","0.3655051115752445861272947125"
"2020-03-31T00:00:00.000","Whatcom","WA","Passenger","1110","510","1620","151219","152839","1.059938889943011927583928186"
"2020-03-31T00:00:00.000","Whatcom","WA","Truck","3","0","3","43040","43043","0.006969774411634876751155820923"
"2020-03-31T00:00:00.000","Whitman","WA","Truck","0","0","0","8552","8552","0"
"2020-03-31T00:00:00.000","Whitman","WA","Passenger","44","49","93","22504","22597","0.4115590565119263619064477586"
"2020-03-31T00:00:00.000","Yakima","WA","Truck","0","0","0","59609","59609","0"
"2020-03-31T00:00:00.000","Yakima","WA","Passenger","139","125","264","165865","166129","0.1589126522160489739900920369"
"2020-03-31T00:00:00.000","Ozaukee","WI","Passenger","0","1","1","3","4","25.00"
"2020-03-31T00:00:00.000",,,"Passenger","3","0","3","219","222","1.351351351351351351351351351"
"2020-04-30T00:00:00.000","Fairbanks North Star","AK","Passenger","0","1","1","98","99","1.010101010101010101010101010"
"2020-04-30T00:00:00.000","Juneau","AK","Passenger","0","2","2","30","32","6.2500"
"2020-04-30T00:00:00.000","Montgomery","AL","Passenger","0","1","1","36","37","2.702702702702702702702702703"
"2020-04-30T00:00:00.000","Cochise","AZ","Passenger","0","1","1","107","108","0.9259259259259259259259259259"
"2020-04-30T00:00:00.000","Maricopa","AZ","Passenger","8","7","15","1297","1312","1.143292682926829268292682927"
"2020-04-30T00:00:00.000","Pima","AZ","Passenger","3","1","4","327","331","1.208459214501510574018126888"
"2020-04-30T00:00:00.000","Pinal","AZ","Passenger","1","0","1","161","162","0.6172839506172839506172839506"
"2020-04-30T00:00:00.000","Alameda","CA","Passenger","3","1","4","263","267","1.498127340823970037453183521"
"2020-04-30T00:00:00.000","Contra Costa","CA","Passenger","3","2","5","362","367","1.362397820163487738419618529"
"2020-04-30T00:00:00.000","Fresno","CA","Passenger","1","0","1","180","181","0.5524861878453038674033149171"
"2020-04-30T00:00:00.000","Kern","CA","Passenger","1","1","2","224","226","0.8849557522123893805309734513"
"2020-04-30T00:00:00.000","Los Angeles","CA","Passenger","8","10","18","970","988","1.821862348178137651821862348"
"2020-04-30T00:00:00.000","Monterey","CA","Passenger","1","0","1","177","178","0.5617977528089887640449438202"
"2020-04-30T00:00:00.000","Orange","CA","Passenger","6","2","8","485","493","1.622718052738336713995943205"
"2020-04-30T00:00:00.000","Placer","CA","Passenger","1","0","1","81","82","1.219512195121951219512195122"
"2020-04-30T00:00:00.000","Riverside","CA","Passenger","3","1","4","595","599","0.6677796327212020033388981636"
"2020-04-30T00:00:00.000","Sacramento","CA","Passenger","1","0","1","260","261","0.3831417624521072796934865900"
"2020-04-30T00:00:00.000","San Bernardino","CA","Passenger","0","1","1","432","433","0.2309468822170900692840646651"
"2020-04-30T00:00:00.000","San Diego","CA","Passenger","13","7","20","2814","2834","0.7057163020465772759350741002"
"2020-04-30T00:00:00.000","San Francisco","CA","Passenger","2","1","3","89","92","3.260869565217391304347826087"
"2020-04-30T00:00:00.000","San Mateo","CA","Passenger","0","1","1","113","114","0.8771929824561403508771929825"
"2020-04-30T00:00:00.000","Santa Barbara","CA","Passenger","2","0","2","89","91","2.197802197802197802197802198"
"2020-04-30T00:00:00.000","Santa Clara","CA","Passenger","6","2","8","300","308","2.597402597402597402597402597"
"2020-04-30T00:00:00.000","Santa Cruz","CA","Passenger","1","0","1","37","38","2.631578947368421052631578947"
"2020-04-30T00:00:00.000","Shasta","CA","Passenger","1","0","1","36","37","2.702702702702702702702702703"
"2020-04-30T00:00:00.000","Solano","CA","Passenger","1","0","1","217","218","0.4587155963302752293577981651"
"2020-04-30T00:00:00.000","Tuolumne","CA","Passenger","0","1","1","7","8","12.500"
"2020-04-30T00:00:00.000","Ventura","CA","Passenger","0","3","3","290","293","1.023890784982935153583617747"
"2020-04-30T00:00:00.000","Arapahoe","CO","Passenger","1","0","1","131","132","0.7575757575757575757575757576"
"2020-04-30T00:00:00.000","Boulder","CO","Passenger","0","1","1","41","42","2.380952380952380952380952381"
"2020-04-30T00:00:00.000","Denver","CO","Passenger","1","0","1","116","117","0.8547008547008547008547008547"
"2020-04-30T00:00:00.000","El Paso","CO","Passenger","2","0","2","697","699","0.2861230329041487839771101574"
"2020-04-30T00:00:00.000","Jefferson","CO","Passenger","0","1","1","61","62","1.612903225806451612903225806"
"2020-04-30T00:00:00.000","Larimer","CO","Passenger","1","1","2","46","48","4.166666666666666666666666667"
"2020-04-30T00:00:00.000","New London","CT","Passenger","0","2","2","256","258","0.7751937984496124031007751938"
"2020-04-30T00:00:00.000","District of Columbia","DC","Passenger","1","3","4","200","204","1.960784313725490196078431373"
"2020-04-30T00:00:00.000","Kent","DE","Passenger","0","1","1","70","71","1.408450704225352112676056338"
"2020-04-30T00:00:00.000","New Castle","DE","Passenger","1","0","1","24","25","4.00"
"2020-04-30T00:00:00.000","Brevard","FL","Passenger","0","1","1","79","80","1.2500"
"2020-04-30T00:00:00.000","Broward","FL","Passenger","2","1","3","110","113","2.654867256637168141592920354"
"2020-04-30T00:00:00.000","Clay","FL","Passenger","0","1","1","78","79","1.265822784810126582278481013"
"2020-04-30T00:00:00.000","Duval","FL","Passenger","0","1","1","346","347","0.2881844380403458213256484150"
"2020-04-30T00:00:00.000","Lake","FL","Passenger","1","0","1","17","18","5.555555555555555555555555556"
"2020-04-30T00:00:00.000","Osceola","FL","Passenger","1","0","1","39","40","2.500"
"2020-04-30T00:00:00.000","Palm Beach","FL","Passenger","0","1","1","68","69","1.449275362318840579710144928"
"2020-04-30T00:00:00.000","Pinellas","FL","Passenger","1","1","2","97","99","2.020202020202020202020202020"
"2020-04-30T00:00:00.000","Polk","FL","Passenger","1","0","1","65","66","1.515151515151515151515151515"
"2020-04-30T00:00:00.000","Sarasota","FL","Passenger","2","0","2","25","27","7.407407407407407407407407407"
"2020-04-30T00:00:00.000","Sumter","FL","Passenger","0","1","1","9","10","10.0"
"2020-04-30T00:00:00.000","Bartow","GA","Passenger","0","1","1","3","4","25.00"
"2020-04-30T00:00:00.000","Bryan","GA","Passenger","1","0","1","52","53","1.886792452830188679245283019"
"2020-04-30T00:00:00.000","Camden","GA","Passenger","0","1","1","152","153","0.6535947712418300653594771242"
"2020-04-30T00:00:00.000","Columbia","GA","Passenger","1","1","2","143","145","1.379310344827586206896551724"
"2020-04-30T00:00:00.000","DeKalb","GA","Passenger","1","0","1","75","76","1.315789473684210526315789474"
"2020-04-30T00:00:00.000","Fulton","GA","Passenger","1","2","3","99","102","2.941176470588235294117647059"
"2020-04-30T00:00:00.000","Houston","GA","Passenger","1","0","1","57","58","1.724137931034482758620689655"
"2020-04-30T00:00:00.000","Jones","GA","Passenger","1","0","1","1","2","50.0"
"2020-04-30T00:00:00.000","Liberty","GA","Passenger","1","0","1","116","117","0.8547008547008547008547008547"
"2020-04-30T00:00:00.000","Honolulu","HI","Passenger","4","1","5","440","445","1.123595505617977528089887640"
"2020-04-30T00:00:00.000","Maui","HI","Passenger","1","0","1","31","32","3.12500"
"2020-04-30T00:00:00.000","Ada","ID","Passenger","0","1","1","261","262","0.3816793893129770992366412214"
"2020-04-30T00:00:00.000","Kootenai","ID","Passenger","1","0","1","205","206","0.4854368932038834951456310680"
"2020-04-30T00:00:00.000","Twin Falls","ID","Passenger","0","1","1","24","25","4.00"
"2020-04-30T00:00:00.000","DuPage","IL","Passenger","3","0","3","54","57","5.263157894736842105263157895"
"2020-04-30T00:00:00.000","Lake","IL","Passenger","1","0","1","173","174","0.5747126436781609195402298851"
"2020-04-30T00:00:00.000","Monroe","IL","Passenger","1","0","1","3","4","25.00"
"2020-04-30T00:00:00.000","St. Clair","IL","Passenger","1","0","1","140","141","0.7092198581560283687943262411"
"2020-04-30T00:00:00.000","DeKalb","IN","Passenger","1","0","1","1","2","50.0"
"2020-04-30T00:00:00.000","Hamilton","IN","Passenger","1","0","1","40","41","2.439024390243902439024390244"
"2020-04-30T00:00:00.000","Vigo","IN","Passenger","1","0","1","4","5","20.0"
"2020-04-30T00:00:00.000","Sedgwick","KS","Passenger","1","0","1","91","92","1.086956521739130434782608696"
"2020-04-30T00:00:00.000","Oldham","KY","Passenger","0","1","1","4","5","20.0"
"2020-04-30T00:00:00.000","Middlesex","MA","Passenger","1","1","2","97","99","2.020202020202020202020202020"
"2020-04-30T00:00:00.000","Suffolk","MA","Passenger","0","2","2","40","42","4.761904761904761904761904762"
"2020-04-30T00:00:00.000","Anne Arundel","MD","Passenger","0","1","1","414","415","0.2409638554216867469879518072"
"2020-04-30T00:00:00.000","Calvert","MD","Passenger","0","2","2","87","89","2.247191011235955056179775281"
"2020-04-30T00:00:00.000","Charles","MD","Passenger","0","1","1","69","70","1.428571428571428571428571429"
"2020-04-30T00:00:00.000","Frederick","MD","Passenger","2","1","3","80","83","3.614457831325301204819277108"
"2020-04-30T00:00:00.000","Howard","MD","Passenger","0","1","1","70","71","1.408450704225352112676056338"
"2020-04-30T00:00:00.000","Montgomery","MD","Passenger","0","2","2","253","255","0.7843137254901960784313725490"
"2020-04-30T00:00:00.000","St. Mary's","MD","Passenger","1","0","1","204","205","0.4878048780487804878048780488"
"2020-04-30T00:00:00.000","Penobscot","ME","Passenger","0","1","1","16","17","5.882352941176470588235294118"
"2020-04-30T00:00:00.000","Kent","MI","Passenger","0","1","1","22","23","4.347826086956521739130434783"
"2020-04-30T00:00:00.000","Saginaw","MI","Passenger","1","0","1","11","12","8.333333333333333333333333333"
"2020-04-30T00:00:00.000","Washtenaw","MI","Passenger","1","0","1","29","30","3.333333333333333333333333333"
"2020-04-30T00:00:00.000","Hennepin","MN","Passenger","2","1","3","83","86","3.488372093023255813953488372"
"2020-04-30T00:00:00.000","Kanabec","MN","Passenger","1","0","1","0","1","100"
"2020-04-30T00:00:00.000","Ramsey","MN","Passenger","1","0","1","37","38","2.631578947368421052631578947"
"2020-04-30T00:00:00.000","Boone","MO","Passenger","0","1","1","11","12","8.333333333333333333333333333"
"2020-04-30T00:00:00.000","Greene","MO","Passenger","0","1","1","25","26","3.846153846153846153846153846"
"2020-04-30T00:00:00.000","St. Louis","MO","Passenger","1","0","1","95","96","1.041666666666666666666666667"
"2020-04-30T00:00:00.000","Harrison","MS","Passenger","1","0","1","59","60","1.666666666666666666666666667"
"2020-04-30T00:00:00.000","Cascade","MT","Passenger","0","1","1","56","57","1.754385964912280701754385965"
"2020-04-30T00:00:00.000","Flathead","MT","Passenger","1","0","1","59","60","1.666666666666666666666666667"
"2020-04-30T00:00:00.000","Glacier","MT","Passenger","0","1","1","5","6","16.66666666666666666666666667"
"2020-04-30T00:00:00.000","Cumberland","NC","Passenger","0","2","2","481","483","0.4140786749482401656314699793"
"2020-04-30T00:00:00.000","Guilford","NC","Passenger","1","0","1","30","31","3.225806451612903225806451613"
"2020-04-30T00:00:00.000","Mecklenburg","NC","Passenger","1","0","1","73","74","1.351351351351351351351351351"
"2020-04-30T00:00:00.000","Moore","NC","Passenger","0","1","1","167","168","0.5952380952380952380952380952"
"2020-04-30T00:00:00.000","Williams","ND","Passenger","0","1","1","13","14","7.142857142857142857142857143"
"2020-04-30T00:00:00.000","Douglas","NE","Passenger","0","1","1","58","59","1.694915254237288135593220339"
"2020-04-30T00:00:00.000","Carroll","NH","Passenger","0","1","1","2","3","33.33333333333333333333333333"
"2020-04-30T00:00:00.000","Camden","NJ","Passenger","0","2","2","20","22","9.090909090909090909090909091"
"2020-04-30T00:00:00.000","Hudson","NJ","Passenger","1","0","1","150","151","0.6622516556291390728476821192"
"2020-04-30T00:00:00.000","Chaves","NM","Passenger","1","0","1","8","9","11.11111111111111111111111111"
"2020-04-30T00:00:00.000","Valencia","NM","Passenger","1","0","1","4","5","20.0"
"2020-04-30T00:00:00.000","Carson City","NV","Passenger","1","0","1","11","12","8.333333333333333333333333333"
"2020-04-30T00:00:00.000","Clark","NV","Passenger","3","4","7","661","668","1.047904191616766467065868263"
"2020-04-30T00:00:00.000","Washoe","NV","Passenger","1","0","1","88","89","1.123595505617977528089887640"
"2020-04-30T00:00:00.000","Erie","NY","Passenger","1","0","1","39","40","2.500"
"2020-04-30T00:00:00.000","Jefferson","NY","Passenger","0","1","1","222","223","0.4484304932735426008968609865"
"2020-04-30T00:00:00.000","Nassau","NY","Passenger","2","0","2","31","33","6.060606060606060606060606061"
"2020-04-30T00:00:00.000","Queens","NY","Passenger","1","0","1","52","53","1.886792452830188679245283019"
"2020-04-30T00:00:00.000","Westchester","NY","Passenger","0","1","1","27","28","3.571428571428571428571428571"
"2020-04-30T00:00:00.000","Montgomery","OH","Passenger","0","1","1","44","45","2.222222222222222222222222222"
"2020-04-30T00:00:00.000","Shelby","OH","Passenger","0","1","1","1","2","50.0"
"2020-04-30T00:00:00.000","Oklahoma","OK","Passenger","0","2","2","116","118","1.694915254237288135593220339"
"2020-04-30T00:00:00.000","Rogers","OK","Passenger","1","0","1","6","7","14.28571428571428571428571429"
"2020-04-30T00:00:00.000","Tulsa","OK","Passenger","1","1","2","41","43","4.651162790697674418604651163"
"2020-04-30T00:00:00.000","Clackamas","OR","Passenger","2","0","2","186","188","1.063829787234042553191489362"
"2020-04-30T00:00:00.000","Deschutes","OR","Passenger","3","0","3","129","132","2.272727272727272727272727273"
"2020-04-30T00:00:00.000","Klamath","OR","Passenger","1","0","1","26","27","3.703703703703703703703703704"
"2020-04-30T00:00:00.000","Multnomah","OR","Passenger","4","6","10","681","691","1.447178002894356005788712012"
"2020-04-30T00:00:00.000","Washington","OR","Passenger","1","0","1","412","413","0.2421307506053268765133171913"
"2020-04-30T00:00:00.000","Allegheny","PA","Passenger","1","0","1","66","67","1.492537313432835820895522388"
"2020-04-30T00:00:00.000","Bucks","PA","Passenger","1","0","1","20","21","4.761904761904761904761904762"
"2020-04-30T00:00:00.000","Montgomery","PA","Passenger","1","0","1","25","26","3.846153846153846153846153846"
"2020-04-30T00:00:00.000","RÃ­o Grande","PR","Passenger","1","0","1","1","2","50.0"
"2020-04-30T00:00:00.000","Newport","RI","Passenger","1","0","1","85","86","1.162790697674418604651162791"
"2020-04-30T00:00:00.000","Richland","SC","Passenger","0","1","1","157","158","0.6329113924050632911392405063"
"2020-04-30T00:00:00.000","Spartanburg","SC","Passenger","0","1","1","40","41","2.439024390243902439024390244"
"2020-04-30T00:00:00.000","Davidson","TN","Passenger","1","0","1","62","63","1.587301587301587301587301587"
"2020-04-30T00:00:00.000","Putnam","TN","Passenger","0","1","1","2","3","33.33333333333333333333333333"
"2020-04-30T00:00:00.000","Shelby","TN","Passenger","0","1","1","90","91","1.098901098901098901098901099"
"2020-04-30T00:00:00.000","Tipton","TN","Passenger","1","0","1","14","15","6.666666666666666666666666667"
"2020-04-30T00:00:00.000","Bell","TX","Passenger","0","1","1","407","408","0.2450980392156862745098039216"
"2020-04-30T00:00:00.000","Bexar","TX","Passenger","4","5","9","582","591","1.522842639593908629441624365"
"2020-04-30T00:00:00.000","Dallas","TX","Passenger","1","0","1","193","194","0.5154639175257731958762886598"
"2020-04-30T00:00:00.000","Denton","TX","Passenger","1","0","1","76","77","1.298701298701298701298701299"
"2020-04-30T00:00:00.000","El Paso","TX","Passenger","2","0","2","429","431","0.4640371229698375870069605568"
"2020-04-30T00:00:00.000","Guadalupe","TX","Passenger","1","0","1","56","57","1.754385964912280701754385965"
"2020-04-30T00:00:00.000","Harris","TX","Passenger","1","0","1","229","230","0.4347826086956521739130434783"
"2020-04-30T00:00:00.000","Hidalgo","TX","Passenger","0","1","1","69","70","1.428571428571428571428571429"
"2020-04-30T00:00:00.000","Montgomery","TX","Passenger","1","0","1","43","44","2.272727272727272727272727273"
"2020-04-30T00:00:00.000","Nueces","TX","Passenger","1","0","1","79","80","1.2500"
"2020-04-30T00:00:00.000","Tarrant","TX","Passenger","1","0","1","162","163","0.6134969325153374233128834356"
"2020-04-30T00:00:00.000","Travis","TX","Passenger","2","2","4","169","173","2.312138728323699421965317919"
"2020-04-30T00:00:00.000","Albemarle","VA","Passenger","1","0","1","21","22","4.545454545454545454545454545"
"2020-04-30T00:00:00.000","Alexandria","VA","Passenger","3","0","3","141","144","2.083333333333333333333333333"
"2020-04-30T00:00:00.000","Arlington","VA","Passenger","0","2","2","142","144","1.388888888888888888888888889"
"2020-04-30T00:00:00.000","Chesapeake","VA","Passenger","0","2","2","423","425","0.4705882352941176470588235294"
"2020-04-30T00:00:00.000","Fairfax","VA","Passenger","4","4","8","732","740","1.081081081081081081081081081"
"2020-04-30T00:00:00.000","Goochland","VA","Passenger","2","1","3","226","229","1.310043668122270742358078603"
"2020-04-30T00:00:00.000","Loudoun","VA","Passenger","1","0","1","84","85","1.176470588235294117647058824"
"2020-04-30T00:00:00.000","Manassas","VA","Passenger","0","1","1","4","5","20.0"
"2020-04-30T00:00:00.000","Norfolk","VA","Passenger","1","1","2","348","350","0.5714285714285714285714285714"
"2020-04-30T00:00:00.000","Portsmouth","VA","Passenger","0","1","1","68","69","1.449275362318840579710144928"
"2020-04-30T00:00:00.000","Powhatan","VA","Passenger","1","0","1","0","1","100"
"2020-04-30T00:00:00.000","Prince William","VA","Passenger","2","3","5","217","222","2.252252252252252252252252252"
"2020-04-30T00:00:00.000","Stafford","VA","Passenger","1","1","2","90","92","2.173913043478260869565217391"
"2020-04-30T00:00:00.000","Suffolk","VA","Passenger","1","0","1","113","114","0.8771929824561403508771929825"
"2020-04-30T00:00:00.000","Virginia Beach","VA","Passenger","1","0","1","647","648","0.1543209876543209876543209877"
"2020-04-30T00:00:00.000","Adams","WA","Passenger","7","8","15","12757","12772","0.1174444096461008455997494519"
"2020-04-30T00:00:00.000","Adams","WA","Truck","0","0","0","5205","5205","0"
"2020-04-30T00:00:00.000","Asotin","WA","Passenger","17","13","30","12452","12482","0.2403460983816696042300913315"
"2020-04-30T00:00:00.000","Asotin","WA","Truck","0","0","0","6622","6622","0"
"2020-04-30T00:00:00.000","Benton","WA","Passenger","359","331","690","134588","135278","0.5100607637605523440618578039"
"2020-04-30T00:00:00.000","Benton","WA","Truck","0","0","0","42487","42487","0"
"2020-04-30T00:00:00.000","Chelan","WA","Passenger","227","80","307","54242","54549","0.5627967515444829419421070964"
"2020-04-30T00:00:00.000","Chelan","WA","Truck","0","0","0","22465","22465","0"
"2020-04-30T00:00:00.000","Clallam","WA","Truck","1","0","1","21701","21702","0.004607870242373974748871071791"
"2020-04-30T00:00:00.000","Clallam","WA","Passenger","231","170","401","50335","50736","0.7903658152002522863450015768"
"2020-04-30T00:00:00.000","Clark","WA","Passenger","2091","1099","3190","318693","321883","0.9910433294085117884448697197"
"2020-04-30T00:00:00.000","Clark","WA","Truck","0","0","0","81853","81853","0"
"2020-04-30T00:00:00.000","Columbia","WA","Passenger","3","3","6","2407","2413","0.2486531288852051388313302942"
"2020-04-30T00:00:00.000","Columbia","WA","Truck","0","0","0","1525","1525","0"
"2020-04-30T00:00:00.000","Cowlitz","WA","Passenger","146","128","274","72716","72990","0.3753938895739142348266885875"
"2020-04-30T00:00:00.000","Cowlitz","WA","Truck","0","0","0","28775","28775","0"
"2020-04-30T00:00:00.000","Douglas","WA","Passenger","70","41","111","28025","28136","0.3945123684958771680409439864"
"2020-04-30T00:00:00.000","Douglas","WA","Truck","0","0","0","12271","12271","0"
"2020-04-30T00:00:00.000","Ferry","WA","Truck","0","0","0","3540","3540","0"
"2020-04-30T00:00:00.000","Ferry","WA","Passenger","5","3","8","4333","4341","0.1842893342547800046072333564"
"2020-04-30T00:00:00.000","Franklin","WA","Passenger","64","81","145","60739","60884","0.2381578082911766638197227515"
"2020-04-30T00:00:00.000","Franklin","WA","Truck","0","0","0","19847","19847","0"
"2020-04-30T00:00:00.000","Garfield","WA","Passenger","0","1","1","1344","1345","0.07434944237918215613382899628"
"2020-04-30T00:00:00.000","Garfield","WA","Truck","0","0","0","968","968","0"
"2020-04-30T00:00:00.000","Grant","WA","Passenger","62","75","137","65276","65413","0.2094384908198676104138321129"
"2020-04-30T00:00:00.000","Grant","WA","Truck","0","0","0","27007","27007","0"
"2020-04-30T00:00:00.000","Grays Harbor","WA","Passenger","121","116","237","48062","48299","0.4906933890970827553365494110"
"2020-04-30T00:00:00.000","Grays Harbor","WA","Truck","0","0","0","20731","20731","0"
"2020-04-30T00:00:00.000","Island","WA","Passenger","420","289","709","62921","63630","1.114254282571114254282571114"
"2020-04-30T00:00:00.000","Island","WA","Truck","1","0","1","21169","21170","0.004723665564478034955125177137"
"2020-04-30T00:00:00.000","Jefferson","WA","Truck","0","0","0","9536","9536","0"
"2020-04-30T00:00:00.000","Jefferson","WA","Passenger","244","153","397","24905","25302","1.569045925223302505730772271"
"2020-04-30T00:00:00.000","King","WA","Passenger","24494","8019","32513","1386097","1418610","2.291891358442418987600538555"
"2020-04-30T00:00:00.000","King","WA","Truck","5","1","6","181595","181601","0.003303946564170902142609346865"
"2020-04-30T00:00:00.000","Kitsap","WA","Truck","1","0","1","53956","53957","0.001853327649795207294697629594"
"2020-04-30T00:00:00.000","Kitsap","WA","Passenger","1392","712","2104","180621","182725","1.151457107675468600355725817"
"2020-04-30T00:00:00.000","Kittitas","WA","Passenger","105","51","156","29863","30019","0.5196708751124287950964389220"
"2020-04-30T00:00:00.000","Kittitas","WA","Truck","0","0","0","14596","14596","0"
"2020-04-30T00:00:00.000","Klickitat","WA","Passenger","57","42","99","15427","15526","0.6376400875950019322426896818"
"2020-04-30T00:00:00.000","Klickitat","WA","Truck","0","0","0","8195","8195","0"
"2020-04-30T00:00:00.000","Lewis","WA","Truck","0","0","0","25985","25985","0"
"2020-04-30T00:00:00.000","Lewis","WA","Passenger","108","112","220","58632","58852","0.3738190715693604295520967852"
"2020-04-30T00:00:00.000","Lincoln","WA","Truck","0","0","0","4626","4626","0"
"2020-04-30T00:00:00.000","Lincoln","WA","Passenger","6","12","18","7680","7698","0.2338269680436477007014809041"
"2020-04-30T00:00:00.000","Mason","WA","Truck","0","0","0","20536","20536","0"
"2020-04-30T00:00:00.000","Mason","WA","Passenger","179","144","323","47197","47520","0.6797138047138047138047138047"
"2020-04-30T00:00:00.000","Okanogan","WA","Passenger","35","31","66","25898","25964","0.2541981204745031582190725620"
"2020-04-30T00:00:00.000","Okanogan","WA","Truck","0","0","0","16390","16390","0"
"2020-04-30T00:00:00.000","Pacific","WA","Truck","0","0","0","7666","7666","0"
"2020-04-30T00:00:00.000","Pacific","WA","Passenger","39","37","76","15825","15901","0.4779573611722533174014212943"
"2020-04-30T00:00:00.000","Pend Oreille","WA","Passenger","8","6","14","9259","9273","0.1509759516876954599374528200"
"2020-04-30T00:00:00.000","Pend Oreille","WA","Truck","0","0","0","5739","5739","0"
"2020-04-30T00:00:00.000","Pierce","WA","Passenger","2562","1795","4357","548986","553343","0.7873958828430105739116605794"
"2020-04-30T00:00:00.000","Pierce","WA","Truck","0","0","0","141218","141218","0"
"2020-04-30T00:00:00.000","San Juan","WA","Truck","0","0","0","5902","5902","0"
"2020-04-30T00:00:00.000","San Juan","WA","Passenger","297","90","387","14156","14543","2.661074056246991679845974008"
"2020-04-30T00:00:00.000","Skagit","WA","Passenger","424","237","661","91467","92128","0.7174800277874261896491837444"
"2020-04-30T00:00:00.000","Skagit","WA","Truck","1","0","1","32396","32397","0.003086705559156712041238386270"
"2020-04-30T00:00:00.000","Skamania","WA","Truck","0","0","0","4055","4055","0"
"2020-04-30T00:00:00.000","Skamania","WA","Passenger","32","17","49","8616","8665","0.5654933641084824004616272360"
"2020-04-30T00:00:00.000","Snohomish","WA","Truck","0","0","0","123357","123357","0"
"2020-04-30T00:00:00.000","Snohomish","WA","Passenger","4551","1850","6401","535197","541598","1.181872902041735752347682229"
"2020-04-30T00:00:00.000","Spokane","WA","Passenger","747","506","1253","316389","317642","0.3944692452509428853866931955"
"2020-04-30T00:00:00.000","Spokane","WA","Truck","1","0","1","97444","97445","0.001026219918928626404638514034"
"2020-04-30T00:00:00.000","Stevens","WA","Passenger","36","35","71","30965","31036","0.2287665936332001546591055548"
"2020-04-30T00:00:00.000","Stevens","WA","Truck","0","0","0","18613","18613","0"
"2020-04-30T00:00:00.000","Thurston","WA","Passenger","1227","782","2009","197567","199576","1.006634064216138213011584559"
"2020-04-30T00:00:00.000","Thurston","WA","Truck","0","0","0","55540","55540","0"
"2020-04-30T00:00:00.000","Wahkiakum","WA","Truck","0","0","0","1760","1760","0"
"2020-04-30T00:00:00.000","Wahkiakum","WA","Passenger","6","6","12","2974","2986","0.4018754186202277294038847957"
"2020-04-30T00:00:00.000","Walla Walla","WA","Truck","0","0","0","13626","13626","0"
"2020-04-30T00:00:00.000","Walla Walla","WA","Passenger","70","64","134","36018","36152","0.3706572250497897764992254924"
"2020-04-30T00:00:00.000","Whatcom","WA","Passenger","1112","510","1622","150137","151759","1.068799873483615469263766894"
"2020-04-30T00:00:00.000","Whatcom","WA","Truck","3","0","3","42847","42850","0.007001166861143523920653442240"
"2020-04-30T00:00:00.000","Whitman","WA","Truck","0","0","0","8535","8535","0"
"2020-04-30T00:00:00.000","Whitman","WA","Passenger","46","51","97","22335","22432","0.4324179743223965763195435093"
"2020-04-30T00:00:00.000","Yakima","WA","Passenger","144","124","268","165289","165557","0.1618777822743828409550789154"
"2020-04-30T00:00:00.000","Yakima","WA","Truck","0","0","0","59529","59529","0"
"2020-04-30T00:00:00.000","Ozaukee","WI","Passenger","0","1","1","3","4","25.00"
"2020-04-30T00:00:00.000",,,"Passenger","2","0","2","208","210","0.9523809523809523809523809524"
"2020-05-31T00:00:00.000","Fairbanks North Star","AK","Passenger","0","1","1","99","100","1.00"
"2020-05-31T00:00:00.000","Juneau","AK","Passenger","0","2","2","28","30","6.666666666666666666666666667"
"2020-05-31T00:00:00.000","Montgomery","AL","Passenger","0","1","1","37","38","2.631578947368421052631578947"
"2020-05-31T00:00:00.000","Maricopa","AZ","Passenger","6","7","13","1266","1279","1.016419077404222048475371384"
"2020-05-31T00:00:00.000","Pima","AZ","Passenger","3","1","4","319","323","1.238390092879256965944272446"
"2020-05-31T00:00:00.000","Pinal","AZ","Passenger","1","0","1","161","162","0.6172839506172839506172839506"
"2020-05-31T00:00:00.000","Alameda","CA","Passenger","2","1","3","258","261","1.149425287356321839080459770"
"2020-05-31T00:00:00.000","Contra Costa","CA","Passenger","3","2","5","358","363","1.377410468319559228650137741"
"2020-05-31T00:00:00.000","Fresno","CA","Passenger","1","0","1","180","181","0.5524861878453038674033149171"
"2020-05-31T00:00:00.000","Kern","CA","Passenger","1","1","2","224","226","0.8849557522123893805309734513"
"2020-05-31T00:00:00.000","Los Angeles","CA","Passenger","8","10","18","959","977","1.842374616171954964176049130"
"2020-05-31T00:00:00.000","Monterey","CA","Passenger","1","0","1","171","172","0.5813953488372093023255813953"
"2020-05-31T00:00:00.000","Orange","CA","Passenger","6","2","8","483","491","1.629327902240325865580448065"
"2020-05-31T00:00:00.000","Placer","CA","Passenger","1","0","1","79","80","1.2500"
"2020-05-31T00:00:00.000","Riverside","CA","Passenger","3","1","4","590","594","0.6734006734006734006734006734"
"2020-05-31T00:00:00.000","Sacramento","CA","Passenger","1","0","1","259","260","0.3846153846153846153846153846"
"2020-05-31T00:00:00.000","San Bernardino","CA","Passenger","0","1","1","423","424","0.2358490566037735849056603774"
"2020-05-31T00:00:00.000","San Diego","CA","Passenger","14","7","21","2792","2813","0.7465339495200853181656594383"
"2020-05-31T00:00:00.000","San Francisco","CA","Passenger","1","1","2","88","90","2.222222222222222222222222222"
"2020-05-31T00:00:00.000","San Mateo","CA","Passenger","0","1","1","110","111","0.9009009009009009009009009009"
"2020-05-31T00:00:00.000","Santa Barbara","CA","Passenger","2","0","2","86","88","2.272727272727272727272727273"
"2020-05-31T00:00:00.000","Santa Clara","CA","Passenger","6","2","8","288","296","2.702702702702702702702702703"
"2020-05-31T00:00:00.000","Santa Cruz","CA","Passenger","1","0","1","34","35","2.857142857142857142857142857"
"2020-05-31T00:00:00.000","Shasta","CA","Passenger","1","0","1","35","36","2.777777777777777777777777778"
"2020-05-31T00:00:00.000","Solano","CA","Passenger","1","0","1","212","213","0.4694835680751173708920187793"
"2020-05-31T00:00:00.000","Ventura","CA","Passenger","1","2","3","287","290","1.034482758620689655172413793"
"2020-05-31T00:00:00.000","Arapahoe","CO","Passenger","1","0","1","127","128","0.7812500"
"2020-05-31T00:00:00.000","Boulder","CO","Passenger","0","1","1","39","40","2.500"
"2020-05-31T00:00:00.000","Denver","CO","Passenger","1","0","1","113","114","0.8771929824561403508771929825"
"2020-05-31T00:00:00.000","El Paso","CO","Passenger","2","0","2","691","693","0.2886002886002886002886002886"
"2020-05-31T00:00:00.000","Jefferson","CO","Passenger","0","1","1","61","62","1.612903225806451612903225806"
"2020-05-31T00:00:00.000","Larimer","CO","Passenger","1","1","2","45","47","4.255319148936170212765957447"
"2020-05-31T00:00:00.000","New London","CT","Passenger","0","2","2","257","259","0.7722007722007722007722007722"
"2020-05-31T00:00:00.000","District of Columbia","DC","Passenger","2","3","5","200","205","2.439024390243902439024390244"
"2020-05-31T00:00:00.000","Kent","DE","Passenger","0","1","1","70","71","1.408450704225352112676056338"
"2020-05-31T00:00:00.000","New Castle","DE","Passenger","1","0","1","23","24","4.166666666666666666666666667"
"2020-05-31T00:00:00.000","Brevard","FL","Passenger","0","1","1","77","78","1.282051282051282051282051282"
"2020-05-31T00:00:00.000","Broward","FL","Passenger","2","1","3","108","111","2.702702702702702702702702703"
"2020-05-31T00:00:00.000","Clay","FL","Passenger","0","1","1","78","79","1.265822784810126582278481013"
"2020-05-31T00:00:00.000","Duval","FL","Passenger","0","1","1","342","343","0.2915451895043731778425655977"
"2020-05-31T00:00:00.000","Lake","FL","Passenger","1","0","1","17","18","5.555555555555555555555555556"
"2020-05-31T00:00:00.000","Osceola","FL","Passenger","1","0","1","37","38","2.631578947368421052631578947"
"2020-05-31T00:00:00.000","Palm Beach","FL","Passenger","0","1","1","68","69","1.449275362318840579710144928"
"2020-05-31T00:00:00.000","Pinellas","FL","Passenger","1","1","2","96","98","2.040816326530612244897959184"
"2020-05-31T00:00:00.000","Polk","FL","Passenger","1","0","1","65","66","1.515151515151515151515151515"
"2020-05-31T00:00:00.000","Sarasota","FL","Passenger","2","0","2","25","27","7.407407407407407407407407407"
"2020-05-31T00:00:00.000","Sumter","FL","Passenger","0","1","1","9","10","10.0"
"2020-05-31T00:00:00.000","Bartow","GA","Passenger","0","1","1","3","4","25.00"
"2020-05-31T00:00:00.000","Bryan","GA","Passenger","1","0","1","50","51","1.960784313725490196078431373"
"2020-05-31T00:00:00.000","Camden","GA","Passenger","0","1","1","150","151","0.6622516556291390728476821192"
"2020-05-31T00:00:00.000","Columbia","GA","Passenger","1","1","2","135","137","1.459854014598540145985401460"
"2020-05-31T00:00:00.000","DeKalb","GA","Passenger","1","0","1","74","75","1.333333333333333333333333333"
"2020-05-31T00:00:00.000","Fulton","GA","Passenger","1","2","3","98","101","2.970297029702970297029702970"
"2020-05-31T00:00:00.000","Houston","GA","Passenger","1","0","1","54","55","1.818181818181818181818181818"
"2020-05-31T00:00:00.000","Jones","GA","Passenger","1","0","1","1","2","50.0"
"2020-05-31T00:00:00.000","Liberty","GA","Passenger","1","0","1","117","118","0.8474576271186440677966101695"
"2020-05-31T00:00:00.000","Honolulu","HI","Passenger","4","1","5","430","435","1.149425287356321839080459770"
"2020-05-31T00:00:00.000","Maui","HI","Passenger","1","0","1","29","30","3.333333333333333333333333333"
"2020-05-31T00:00:00.000","Ada","ID","Passenger","0","1","1","252","253","0.3952569169960474308300395257"
"2020-05-31T00:00:00.000","Kootenai","ID","Passenger","1","0","1","203","204","0.4901960784313725490196078431"
"2020-05-31T00:00:00.000","Twin Falls","ID","Passenger","0","1","1","22","23","4.347826086956521739130434783"
"2020-05-31T00:00:00.000","DuPage","IL","Passenger","3","0","3","53","56","5.357142857142857142857142857"
"2020-05-31T00:00:00.000","Lake","IL","Passenger","1","0","1","172","173","0.5780346820809248554913294798"
"2020-05-31T00:00:00.000","Monroe","IL","Passenger","1","0","1","3","4","25.00"
"2020-05-31T00:00:00.000","St. Clair","IL","Passenger","1","0","1","138","139","0.7194244604316546762589928058"
"2020-05-31T00:00:00.000","DeKalb","IN","Passenger","1","0","1","1","2","50.0"
"2020-05-31T00:00:00.000","Hamilton","IN","Passenger","1","0","1","39","40","2.500"
"2020-05-31T00:00:00.000","Vigo","IN","Passenger","1","0","1","4","5","20.0"
"2020-05-31T00:00:00.000","Sedgwick","KS","Passenger","1","0","1","90","91","1.098901098901098901098901099"
"2020-05-31T00:00:00.000","Oldham","KY","Passenger","0","1","1","4","5","20.0"
"2020-05-31T00:00:00.000","Middlesex","MA","Passenger","1","1","2","97","99","2.020202020202020202020202020"
"2020-05-31T00:00:00.000","Suffolk","MA","Passenger","0","2","2","39","41","4.878048780487804878048780488"
"2020-05-31T00:00:00.000","Anne Arundel","MD","Passenger","0","1","1","409","410","0.2439024390243902439024390244"
"2020-05-31T00:00:00.000","Calvert","MD","Passenger","0","2","2","86","88","2.272727272727272727272727273"
"2020-05-31T00:00:00.000","Charles","MD","Passenger","1","1","2","68","70","2.857142857142857142857142857"
"2020-05-31T00:00:00.000","Frederick","MD","Passenger","2","1","3","79","82","3.658536585365853658536585366"
"2020-05-31T00:00:00.000","Howard","MD","Passenger","0","1","1","70","71","1.408450704225352112676056338"
"2020-05-31T00:00:00.000","Montgomery","MD","Passenger","0","2","2","245","247","0.8097165991902834008097165992"
"2020-05-31T00:00:00.000","St. Mary's","MD","Passenger","1","0","1","200","201","0.4975124378109452736318407960"
"2020-05-31T00:00:00.000","Penobscot","ME","Passenger","0","1","1","16","17","5.882352941176470588235294118"
"2020-05-31T00:00:00.000","Kent","MI","Passenger","0","1","1","22","23","4.347826086956521739130434783"
"2020-05-31T00:00:00.000","Saginaw","MI","Passenger","1","0","1","11","12","8.333333333333333333333333333"
"2020-05-31T00:00:00.000","Washtenaw","MI","Passenger","1","0","1","27","28","3.571428571428571428571428571"
"2020-05-31T00:00:00.000","Hennepin","MN","Passenger","2","0","2","80","82","2.439024390243902439024390244"
"2020-05-31T00:00:00.000","Kanabec","MN","Passenger","1","0","1","0","1","100"
"2020-05-31T00:00:00.000","Ramsey","MN","Passenger","1","0","1","37","38","2.631578947368421052631578947"
"2020-05-31T00:00:00.000","Boone","MO","Passenger","0","1","1","9","10","10.0"
"2020-05-31T00:00:00.000","Greene","MO","Passenger","0","1","1","24","25","4.00"
"2020-05-31T00:00:00.000","St. Louis","MO","Passenger","1","0","1","95","96","1.041666666666666666666666667"
"2020-05-31T00:00:00.000","Harrison","MS","Passenger","1","0","1","57","58","1.724137931034482758620689655"
"2020-05-31T00:00:00.000","Cascade","MT","Passenger","0","1","1","56","57","1.754385964912280701754385965"
"2020-05-31T00:00:00.000","Flathead","MT","Passenger","1","0","1","58","59","1.694915254237288135593220339"
"2020-05-31T00:00:00.000","Glacier","MT","Passenger","0","1","1","5","6","16.66666666666666666666666667"
"2020-05-31T00:00:00.000","Cumberland","NC","Passenger","0","3","3","478","481","0.6237006237006237006237006237"
"2020-05-31T00:00:00.000","Guilford","NC","Passenger","1","0","1","29","30","3.333333333333333333333333333"
"2020-05-31T00:00:00.000","Mecklenburg","NC","Passenger","1","0","1","69","70","1.428571428571428571428571429"
"2020-05-31T00:00:00.000","Moore","NC","Passenger","0","1","1","166","167","0.5988023952095808383233532934"
"2020-05-31T00:00:00.000","Williams","ND","Passenger","0","1","1","11","12","8.333333333333333333333333333"
"2020-05-31T00:00:00.000","Douglas","NE","Passenger","0","1","1","57","58","1.724137931034482758620689655"
"2020-05-31T00:00:00.000","Carroll","NH","Passenger","0","1","1","2","3","33.33333333333333333333333333"
"2020-05-31T00:00:00.000","Camden","NJ","Passenger","0","1","1","20","21","4.761904761904761904761904762"
"2020-05-31T00:00:00.000","Hudson","NJ","Passenger","1","0","1","148","149","0.6711409395973154362416107383"
"2020-05-31T00:00:00.000","Chaves","NM","Passenger","1","0","1","8","9","11.11111111111111111111111111"
"2020-05-31T00:00:00.000","Valencia","NM","Passenger","1","0","1","4","5","20.0"
"2020-05-31T00:00:00.000","Carson City","NV","Passenger","1","0","1","11","12","8.333333333333333333333333333"
"2020-05-31T00:00:00.000","Clark","NV","Passenger","3","4","7","657","664","1.054216867469879518072289157"
"2020-05-31T00:00:00.000","Washoe","NV","Passenger","1","0","1","87","88","1.136363636363636363636363636"
"2020-05-31T00:00:00.000","Erie","NY","Passenger","1","0","1","39","40","2.500"
"2020-05-31T00:00:00.000","Jefferson","NY","Passenger","0","1","1","219","220","0.4545454545454545454545454545"
"2020-05-31T00:00:00.000","Nassau","NY","Passenger","2","0","2","31","33","6.060606060606060606060606061"
"2020-05-31T00:00:00.000","Queens","NY","Passenger","1","0","1","50","51","1.960784313725490196078431373"
"2020-05-31T00:00:00.000","Westchester","NY","Passenger","0","1","1","26","27","3.703703703703703703703703704"
"2020-05-31T00:00:00.000","Montgomery","OH","Passenger","0","1","1","45","46","2.173913043478260869565217391"
"2020-05-31T00:00:00.000","Shelby","OH","Passenger","0","1","1","1","2","50.0"
"2020-05-31T00:00:00.000","Oklahoma","OK","Passenger","0","1","1","114","115","0.8695652173913043478260869565"
"2020-05-31T00:00:00.000","Rogers","OK","Passenger","1","0","1","6","7","14.28571428571428571428571429"
"2020-05-31T00:00:00.000","Tulsa","OK","Passenger","1","1","2","41","43","4.651162790697674418604651163"
"2020-05-31T00:00:00.000","Clackamas","OR","Passenger","2","0","2","182","184","1.086956521739130434782608696"
"2020-05-31T00:00:00.000","Deschutes","OR","Passenger","3","0","3","125","128","2.3437500"
"2020-05-31T00:00:00.000","Klamath","OR","Passenger","1","0","1","25","26","3.846153846153846153846153846"
"2020-05-31T00:00:00.000","Multnomah","OR","Passenger","4","6","10","678","688","1.453488372093023255813953488"
"2020-05-31T00:00:00.000","Washington","OR","Passenger","1","0","1","409","410","0.2439024390243902439024390244"
"2020-05-31T00:00:00.000","Allegheny","PA","Passenger","1","0","1","64","65","1.538461538461538461538461538"
"2020-05-31T00:00:00.000","Bucks","PA","Passenger","1","0","1","20","21","4.761904761904761904761904762"
"2020-05-31T00:00:00.000","Montgomery","PA","Passenger","1","0","1","24","25","4.00"
"2020-05-31T00:00:00.000","RÃ­o Grande","PR","Passenger","1","0","1","1","2","50.0"
"2020-05-31T00:00:00.000","Newport","RI","Passenger","1","0","1","85","86","1.162790697674418604651162791"
"2020-05-31T00:00:00.000","Richland","SC","Passenger","0","1","1","154","155","0.6451612903225806451612903226"
"2020-05-31T00:00:00.000","Spartanburg","SC","Passenger","0","1","1","38","39","2.564102564102564102564102564"
"2020-05-31T00:00:00.000","Davidson","TN","Passenger","1","0","1","62","63","1.587301587301587301587301587"
"2020-05-31T00:00:00.000","Putnam","TN","Passenger","0","1","1","2","3","33.33333333333333333333333333"
"2020-05-31T00:00:00.000","Shelby","TN","Passenger","0","1","1","87","88","1.136363636363636363636363636"
"2020-05-31T00:00:00.000","Tipton","TN","Passenger","1","0","1","14","15","6.666666666666666666666666667"
"2020-05-31T00:00:00.000","Bell","TX","Passenger","0","1","1","402","403","0.2481389578163771712158808933"
"2020-05-31T00:00:00.000","Bexar","TX","Passenger","4","5","9","575","584","1.541095890410958904109589041"
"2020-05-31T00:00:00.000","Dallas","TX","Passenger","1","0","1","188","189","0.5291005291005291005291005291"
"2020-05-31T00:00:00.000","Denton","TX","Passenger","1","0","1","75","76","1.315789473684210526315789474"
"2020-05-31T00:00:00.000","El Paso","TX","Passenger","2","0","2","423","425","0.4705882352941176470588235294"
"2020-05-31T00:00:00.000","Guadalupe","TX","Passenger","1","0","1","56","57","1.754385964912280701754385965"
"2020-05-31T00:00:00.000","Harris","TX","Passenger","1","0","1","226","227","0.4405286343612334801762114537"
"2020-05-31T00:00:00.000","Hidalgo","TX","Passenger","0","1","1","68","69","1.449275362318840579710144928"
"2020-05-31T00:00:00.000","Montgomery","TX","Passenger","1","0","1","43","44","2.272727272727272727272727273"
"2020-05-31T00:00:00.000","Nueces","TX","Passenger","1","0","1","78","79","1.265822784810126582278481013"
"2020-05-31T00:00:00.000","Travis","TX","Passenger","2","2","4","166","170","2.352941176470588235294117647"
"2020-05-31T00:00:00.000","Utah","UT","Passenger","0","1","1","123","124","0.8064516129032258064516129032"
"2020-05-31T00:00:00.000","Albemarle","VA","Passenger","1","0","1","20","21","4.761904761904761904761904762"
"2020-05-31T00:00:00.000","Alexandria","VA","Passenger","3","0","3","141","144","2.083333333333333333333333333"
"2020-05-31T00:00:00.000","Arlington","VA","Passenger","0","2","2","141","143","1.398601398601398601398601399"
"2020-05-31T00:00:00.000","Chesapeake","VA","Passenger","0","2","2","422","424","0.4716981132075471698113207547"
"2020-05-31T00:00:00.000","Fairfax","VA","Passenger","4","4","8","728","736","1.086956521739130434782608696"
"2020-05-31T00:00:00.000","Goochland","VA","Passenger","2","1","3","224","227","1.321585903083700440528634361"
"2020-05-31T00:00:00.000","Loudoun","VA","Passenger","1","0","1","83","84","1.190476190476190476190476190"
"2020-05-31T00:00:00.000","Manassas","VA","Passenger","0","1","1","4","5","20.0"
"2020-05-31T00:00:00.000","Norfolk","VA","Passenger","1","1","2","346","348","0.5747126436781609195402298851"
"2020-05-31T00:00:00.000","Portsmouth","VA","Passenger","0","1","1","66","67","1.492537313432835820895522388"
"2020-05-31T00:00:00.000","Powhatan","VA","Passenger","1","0","1","0","1","100"
"2020-05-31T00:00:00.000","Prince William","VA","Passenger","2","3","5","213","218","2.293577981651376146788990826"
"2020-05-31T00:00:00.000","Stafford","VA","Passenger","1","1","2","91","93","2.150537634408602150537634409"
"2020-05-31T00:00:00.000","Suffolk","VA","Passenger","1","0","1","109","110","0.9090909090909090909090909091"
"2020-05-31T00:00:00.000","Virginia Beach","VA","Passenger","1","0","1","641","642","0.1557632398753894080996884735"
"2020-05-31T00:00:00.000","Adams","WA","Passenger","8","8","16","12720","12736","0.1256281407035175879396984925"
"2020-05-31T00:00:00.000","Adams","WA","Truck","0","0","0","5216","5216","0"
"2020-05-31T00:00:00.000","Asotin","WA","Truck","0","0","0","6593","6593","0"
"2020-05-31T00:00:00.000","Asotin","WA","Passenger","17","13","30","12346","12376","0.2424046541693600517129928895"
"2020-05-31T00:00:00.000","Benton","WA","Passenger","365","331","696","134197","134893","0.5159645052004181091680072354"
"2020-05-31T00:00:00.000","Benton","WA","Truck","0","0","0","42475","42475","0"
"2020-05-31T00:00:00.000","Chelan","WA","Passenger","231","78","309","54123","54432","0.5676807760141093474426807760"
"2020-05-31T00:00:00.000","Chelan","WA","Truck","0","0","0","22440","22440","0"
"2020-05-31T00:00:00.000","Clallam","WA","Passenger","233","169","402","50111","50513","0.7958347356126145744659790549"
"2020-05-31T00:00:00.000","Clallam","WA","Truck","1","0","1","21676","21677","0.004613184481247405083729298335"
"2020-05-31T00:00:00.000","Clark","WA","Passenger","2102","1099","3201","317442","320643","0.9983065278206603605879436008"
"2020-05-31T00:00:00.000","Clark","WA","Truck","0","0","0","81908","81908","0"
"2020-05-31T00:00:00.000","Columbia","WA","Passenger","4","3","7","2405","2412","0.2902155887230514096185737977"
"2020-05-31T00:00:00.000","Columbia","WA","Truck","0","0","0","1524","1524","0"
"2020-05-31T00:00:00.000","Cowlitz","WA","Truck","0","0","0","28769","28769","0"
"2020-05-31T00:00:00.000","Cowlitz","WA","Passenger","146","128","274","72357","72631","0.3772493838719004281918189203"
"2020-05-31T00:00:00.000","Douglas","WA","Passenger","70","41","111","27971","28082","0.3952709920945801581083968378"
"2020-05-31T00:00:00.000","Douglas","WA","Truck","0","0","0","12281","12281","0"
"2020-05-31T00:00:00.000","Ferry","WA","Truck","0","0","0","3537","3537","0"
"2020-05-31T00:00:00.000","Ferry","WA","Passenger","5","3","8","4333","4341","0.1842893342547800046072333564"
"2020-05-31T00:00:00.000","Franklin","WA","Passenger","64","80","144","60579","60723","0.2371424336742255817400326071"
"2020-05-31T00:00:00.000","Franklin","WA","Truck","0","0","0","19873","19873","0"
"2020-05-31T00:00:00.000","Garfield","WA","Passenger","0","1","1","1350","1351","0.07401924500370096225018504811"
"2020-05-31T00:00:00.000","Garfield","WA","Truck","0","0","0","967","967","0"
"2020-05-31T00:00:00.000","Grant","WA","Passenger","62","74","136","65214","65350","0.2081101759755164498852333588"
"2020-05-31T00:00:00.000","Grant","WA","Truck","0","0","0","26993","26993","0"
"2020-05-31T00:00:00.000","Grays Harbor","WA","Passenger","121","117","238","48007","48245","0.4933153694683386879469375065"
"2020-05-31T00:00:00.000","Grays Harbor","WA","Truck","0","0","0","20774","20774","0"
"2020-05-31T00:00:00.000","Island","WA","Passenger","424","289","713","62870","63583","1.121368919365239136247110077"
"2020-05-31T00:00:00.000","Island","WA","Truck","1","0","1","21158","21159","0.004726121272271846495581076610"
"2020-05-31T00:00:00.000","Jefferson","WA","Truck","0","0","0","9515","9515","0"
"2020-05-31T00:00:00.000","Jefferson","WA","Passenger","243","152","395","24819","25214","1.566589989688268422305068613"
"2020-05-31T00:00:00.000","King","WA","Passenger","24409","8013","32422","1375047","1407469","2.303567609659608843960328789"
"2020-05-31T00:00:00.000","King","WA","Truck","5","1","6","181489","181495","0.003305876194936499628088928070"
"2020-05-31T00:00:00.000","Kitsap","WA","Passenger","1393","714","2107","179719","181826","1.158800171592621517274757185"
"2020-05-31T00:00:00.000","Kitsap","WA","Truck","0","0","0","53914","53914","0"
"2020-05-31T00:00:00.000","Kittitas","WA","Passenger","106","50","156","29784","29940","0.5210420841683366733466933868"
"2020-05-31T00:00:00.000","Kittitas","WA","Truck","0","0","0","14556","14556","0"
"2020-05-31T00:00:00.000","Klickitat","WA","Passenger","56","41","97","15276","15373","0.6309763871723150978989136798"
"2020-05-31T00:00:00.000","Klickitat","WA","Truck","0","0","0","8122","8122","0"
"2020-05-31T00:00:00.000","Lewis","WA","Passenger","108","115","223","58219","58442","0.3815748947674617569556141131"
"2020-05-31T00:00:00.000","Lewis","WA","Truck","0","0","0","26008","26008","0"
"2020-05-31T00:00:00.000","Lincoln","WA","Truck","0","0","0","4617","4617","0"
"2020-05-31T00:00:00.000","Lincoln","WA","Passenger","6","12","18","7644","7662","0.2349256068911511354737666406"
"2020-05-31T00:00:00.000","Mason","WA","Passenger","181","146","327","47164","47491","0.6885515150238992651239182161"
"2020-05-31T00:00:00.000","Mason","WA","Truck","0","0","0","20513","20513","0"
"2020-05-31T00:00:00.000","Okanogan","WA","Passenger","35","33","68","25886","25954","0.2620020035447329891346227942"
"2020-05-31T00:00:00.000","Okanogan","WA","Truck","0","0","0","16398","16398","0"
"2020-05-31T00:00:00.000","Pacific","WA","Truck","0","0","0","7628","7628","0"
"2020-05-31T00:00:00.000","Pacific","WA","Passenger","40","36","76","15691","15767","0.4820194076235174732035263525"
"2020-05-31T00:00:00.000","Pend Oreille","WA","Truck","0","0","0","5741","5741","0"
"2020-05-31T00:00:00.000","Pend Oreille","WA","Passenger","7","6","13","9219","9232","0.1408145580589254766031195841"
"2020-05-31T00:00:00.000","Pierce","WA","Passenger","2566","1787","4353","547721","552074","0.7884812543246014121295333597"
"2020-05-31T00:00:00.000","Pierce","WA","Truck","0","0","0","141396","141396","0"
"2020-05-31T00:00:00.000","San Juan","WA","Passenger","300","93","393","14061","14454","2.718970527189705271897052719"
"2020-05-31T00:00:00.000","San Juan","WA","Truck","0","0","0","5864","5864","0"
"2020-05-31T00:00:00.000","Skagit","WA","Passenger","427","237","664","91158","91822","0.7231382457363159155757879375"
"2020-05-31T00:00:00.000","Skagit","WA","Truck","1","0","1","32399","32400","0.003086419753086419753086419753"
"2020-05-31T00:00:00.000","Skamania","WA","Truck","0","0","0","4030","4030","0"
"2020-05-31T00:00:00.000","Skamania","WA","Passenger","34","17","51","8524","8575","0.5947521865889212827988338192"
"2020-05-31T00:00:00.000","Snohomish","WA","Passenger","4548","1847","6395","533889","540284","1.183636754003450037387744223"
"2020-05-31T00:00:00.000","Snohomish","WA","Truck","0","0","0","123406","123406","0"
"2020-05-31T00:00:00.000","Spokane","WA","Passenger","757","513","1270","315112","316382","0.4014134811714952178063227364"
"2020-05-31T00:00:00.000","Spokane","WA","Truck","1","0","1","97740","97741","0.001023112102393059207497365486"
"2020-05-31T00:00:00.000","Stevens","WA","Passenger","37","35","72","30732","30804","0.2337358784573432021815348656"
"2020-05-31T00:00:00.000","Stevens","WA","Truck","0","0","0","18600","18600","0"
"2020-05-31T00:00:00.000","Thurston","WA","Passenger","1221","785","2006","196904","198910","1.008496304861495148559650093"
"2020-05-31T00:00:00.000","Thurston","WA","Truck","0","0","0","55542","55542","0"
"2020-05-31T00:00:00.000","Wahkiakum","WA","Truck","0","0","0","1759","1759","0"
"2020-05-31T00:00:00.000","Wahkiakum","WA","Passenger","6","7","13","2966","2979","0.4363880496811010406176569319"
"2020-05-31T00:00:00.000","Walla Walla","WA","Passenger","71","63","134","35838","35972","0.3725119537417991771377738241"
"2020-05-31T00:00:00.000","Walla Walla","WA","Truck","0","0","0","13675","13675","0"
"2020-05-31T00:00:00.000","Whatcom","WA","Truck","3","0","3","42860","42863","0.006999043464059911812052352845"
"2020-05-31T00:00:00.000","Whatcom","WA","Passenger","1113","516","1629","149298","150927","1.079329742193245741318650738"
"2020-05-31T00:00:00.000","Whitman","WA","Passenger","47","51","98","22197","22295","0.4395604395604395604395604396"
"2020-05-31T00:00:00.000","Whitman","WA","Truck","0","0","0","8517","8517","0"
"2020-05-31T00:00:00.000","Yakima","WA","Truck","0","0","0","59584","59584","0"
"2020-05-31T00:00:00.000","Yakima","WA","Passenger","146","126","272","165049","165321","0.1645284023203343797823627972"
"2020-05-31T00:00:00.000","Ozaukee","WI","Passenger","0","1","1","3","4","25.00"
"2020-05-31T00:00:00.000",,,"Passenger","2","0","2","206","208","0.9615384615384615384615384615"
"2020-06-30T00:00:00.000","Fairbanks North Star","AK","Passenger","0","1","1","96","97","1.030927835051546391752577320"
"2020-06-30T00:00:00.000","Juneau","AK","Passenger","0","2","2","27","29","6.896551724137931034482758621"
"2020-06-30T00:00:00.000","Montgomery","AL","Passenger","0","1","1","37","38","2.631578947368421052631578947"
"2020-06-30T00:00:00.000","Maricopa","AZ","Passenger","6","7","13","1254","1267","1.026045777426992896606156275"
"2020-06-30T00:00:00.000","Pima","AZ","Passenger","3","1","4","316","320","1.2500"
"2020-06-30T00:00:00.000","Pinal","AZ","Passenger","1","0","1","157","158","0.6329113924050632911392405063"
"2020-06-30T00:00:00.000","Alameda","CA","Passenger","2","0","2","255","257","0.7782101167315175097276264591"
"2020-06-30T00:00:00.000","Contra Costa","CA","Passenger","3","3","6","353","359","1.671309192200557103064066852"
"2020-06-30T00:00:00.000","Fresno","CA","Passenger","1","0","1","178","179","0.5586592178770949720670391061"
"2020-06-30T00:00:00.000","Kern","CA","Passenger","1","1","2","223","225","0.8888888888888888888888888889"
"2020-06-30T00:00:00.000","Los Angeles","CA","Passenger","8","10","18","948","966","1.863354037267080745341614907"
"2020-06-30T00:00:00.000","Monterey","CA","Passenger","1","1","2","163","165","1.212121212121212121212121212"
"2020-06-30T00:00:00.000","Orange","CA","Passenger","6","2","8","484","492","1.626016260162601626016260163"
"2020-06-30T00:00:00.000","Placer","CA","Passenger","1","0","1","80","81","1.234567901234567901234567901"
"2020-06-30T00:00:00.000","Riverside","CA","Passenger","3","1","4","582","586","0.6825938566552901023890784983"
"2020-06-30T00:00:00.000","Sacramento","CA","Passenger","1","0","1","257","258","0.3875968992248062015503875969"
"2020-06-30T00:00:00.000","San Bernardino","CA","Passenger","0","1","1","421","422","0.2369668246445497630331753555"
"2020-06-30T00:00:00.000","San Diego","CA","Passenger","14","7","21","2809","2830","0.7420494699646643109540636042"
"2020-06-30T00:00:00.000","San Francisco","CA","Passenger","1","1","2","85","87","2.298850574712643678160919540"
"2020-06-30T00:00:00.000","San Mateo","CA","Passenger","0","1","1","107","108","0.9259259259259259259259259259"
"2020-06-30T00:00:00.000","Santa Barbara","CA","Passenger","2","0","2","84","86","2.325581395348837209302325581"
"2020-06-30T00:00:00.000","Santa Clara","CA","Passenger","6","2","8","283","291","2.749140893470790378006872852"
"2020-06-30T00:00:00.000","Santa Cruz","CA","Passenger","1","0","1","32","33","3.030303030303030303030303030"
"2020-06-30T00:00:00.000","Shasta","CA","Passenger","1","0","1","35","36","2.777777777777777777777777778"
"2020-06-30T00:00:00.000","Solano","CA","Passenger","1","0","1","216","217","0.4608294930875576036866359447"
"2020-06-30T00:00:00.000","Ventura","CA","Passenger","1","2","3","281","284","1.056338028169014084507042254"
"2020-06-30T00:00:00.000","Arapahoe","CO","Passenger","1","0","1","126","127","0.7874015748031496062992125984"
"2020-06-30T00:00:00.000","Boulder","CO","Passenger","0","1","1","37","38","2.631578947368421052631578947"
"2020-06-30T00:00:00.000","Denver","CO","Passenger","1","0","1","110","111","0.9009009009009009009009009009"
"2020-06-30T00:00:00.000","El Paso","CO","Passenger","2","0","2","687","689","0.2902757619738751814223512337"
"2020-06-30T00:00:00.000","Jefferson","CO","Passenger","0","1","1","61","62","1.612903225806451612903225806"
"2020-06-30T00:00:00.000","Larimer","CO","Passenger","1","1","2","44","46","4.347826086956521739130434783"
"2020-06-30T00:00:00.000","New London","CT","Passenger","0","2","2","256","258","0.7751937984496124031007751938"
"2020-06-30T00:00:00.000","District of Columbia","DC","Passenger","2","3","5","202","207","2.415458937198067632850241546"
"2020-06-30T00:00:00.000","Kent","DE","Passenger","0","1","1","68","69","1.449275362318840579710144928"
"2020-06-30T00:00:00.000","New Castle","DE","Passenger","1","0","1","25","26","3.846153846153846153846153846"
"2020-06-30T00:00:00.000","Brevard","FL","Passenger","0","1","1","75","76","1.315789473684210526315789474"
"2020-06-30T00:00:00.000","Broward","FL","Passenger","2","1","3","104","107","2.803738317757009345794392523"
"2020-06-30T00:00:00.000","Clay","FL","Passenger","0","1","1","79","80","1.2500"
"2020-06-30T00:00:00.000","Duval","FL","Passenger","0","1","1","342","343","0.2915451895043731778425655977"
"2020-06-30T00:00:00.000","Lake","FL","Passenger","1","0","1","19","20","5.00"
"2020-06-30T00:00:00.000","Nassau","FL","Passenger","1","0","1","29","30","3.333333333333333333333333333"
"2020-06-30T00:00:00.000","Okaloosa","FL","Passenger","0","1","1","132","133","0.7518796992481203007518796992"
"2020-06-30T00:00:00.000","Osceola","FL","Passenger","1","0","1","36","37","2.702702702702702702702702703"
"2020-06-30T00:00:00.000","Palm Beach","FL","Passenger","0","1","1","68","69","1.449275362318840579710144928"
"2020-06-30T00:00:00.000","Pinellas","FL","Passenger","1","1","2","97","99","2.020202020202020202020202020"
"2020-06-30T00:00:00.000","Polk","FL","Passenger","1","0","1","64","65","1.538461538461538461538461538"
"2020-06-30T00:00:00.000","Sarasota","FL","Passenger","2","0","2","27","29","6.896551724137931034482758621"
"2020-06-30T00:00:00.000","Sumter","FL","Passenger","0","1","1","9","10","10.0"
"2020-06-30T00:00:00.000","Bartow","GA","Passenger","0","1","1","3","4","25.00"
"2020-06-30T00:00:00.000","Bryan","GA","Passenger","1","0","1","49","50","2.00"
"2020-06-30T00:00:00.000","Camden","GA","Passenger","0","1","1","148","149","0.6711409395973154362416107383"
"2020-06-30T00:00:00.000","Columbia","GA","Passenger","1","1","2","131","133","1.503759398496240601503759398"
"2020-06-30T00:00:00.000","DeKalb","GA","Passenger","1","0","1","75","76","1.315789473684210526315789474"
"2020-06-30T00:00:00.000","Fulton","GA","Passenger","1","2","3","95","98","3.061224489795918367346938776"
"2020-06-30T00:00:00.000","Houston","GA","Passenger","1","0","1","55","56","1.785714285714285714285714286"
"2020-06-30T00:00:00.000","Jones","GA","Passenger","1","0","1","1","2","50.0"
"2020-06-30T00:00:00.000","Liberty","GA","Passenger","1","0","1","115","116","0.8620689655172413793103448276"
"2020-06-30T00:00:00.000","Honolulu","HI","Passenger","4","1","5","423","428","1.168224299065420560747663551"
"2020-06-30T00:00:00.000","Maui","HI","Passenger","1","0","1","28","29","3.448275862068965517241379310"
"2020-06-30T00:00:00.000","Ada","ID","Passenger","0","1","1","249","250","0.400"
"2020-06-30T00:00:00.000","Kootenai","ID","Passenger","1","0","1","199","200","0.500"
"2020-06-30T00:00:00.000","Twin Falls","ID","Passenger","0","1","1","20","21","4.761904761904761904761904762"
"2020-06-30T00:00:00.000","DuPage","IL","Passenger","3","0","3","53","56","5.357142857142857142857142857"
"2020-06-30T00:00:00.000","Lake","IL","Passenger","1","0","1","171","172","0.5813953488372093023255813953"
"2020-06-30T00:00:00.000","Monroe","IL","Passenger","1","0","1","3","4","25.00"
"2020-06-30T00:00:00.000","St. Clair","IL","Passenger","1","0","1","138","139","0.7194244604316546762589928058"
"2020-06-30T00:00:00.000","DeKalb","IN","Passenger","1","0","1","1","2","50.0"
"2020-06-30T00:00:00.000","Hamilton","IN","Passenger","1","0","1","39","40","2.500"
"2020-06-30T00:00:00.000","Vigo","IN","Passenger","1","0","1","4","5","20.0"
"2020-06-30T00:00:00.000","Sedgwick","KS","Passenger","1","0","1","90","91","1.098901098901098901098901099"
"2020-06-30T00:00:00.000","Oldham","KY","Passenger","0","1","1","4","5","20.0"
"2020-06-30T00:00:00.000","Middlesex","MA","Passenger","1","1","2","95","97","2.061855670103092783505154639"
"2020-06-30T00:00:00.000","Suffolk","MA","Passenger","0","2","2","39","41","4.878048780487804878048780488"
"2020-06-30T00:00:00.000","Anne Arundel","MD","Passenger","0","1","1","413","414","0.2415458937198067632850241546"
"2020-06-30T00:00:00.000","Calvert","MD","Passenger","0","2","2","88","90","2.222222222222222222222222222"
"2020-06-30T00:00:00.000","Charles","MD","Passenger","1","1","2","69","71","2.816901408450704225352112676"
"2020-06-30T00:00:00.000","Frederick","MD","Passenger","2","1","3","79","82","3.658536585365853658536585366"
"2020-06-30T00:00:00.000","Howard","MD","Passenger","0","1","1","71","72","1.388888888888888888888888889"
"2020-06-30T00:00:00.000","Montgomery","MD","Passenger","0","2","2","237","239","0.8368200836820083682008368201"
"2020-06-30T00:00:00.000","St. Mary's","MD","Passenger","1","0","1","202","203","0.4926108374384236453201970443"
"2020-06-30T00:00:00.000","Penobscot","ME","Passenger","0","1","1","14","15","6.666666666666666666666666667"
"2020-06-30T00:00:00.000","Kent","MI","Passenger","0","1","1","22","23","4.347826086956521739130434783"
"2020-06-30T00:00:00.000","Saginaw","MI","Passenger","1","0","1","11","12","8.333333333333333333333333333"
"2020-06-30T00:00:00.000","Washtenaw","MI","Passenger","1","0","1","29","30","3.333333333333333333333333333"
"2020-06-30T00:00:00.000","Hennepin","MN","Passenger","2","0","2","77","79","2.531645569620253164556962025"
"2020-06-30T00:00:00.000","Kanabec","MN","Passenger","1","0","1","0","1","100"
"2020-06-30T00:00:00.000","Ramsey","MN","Passenger","1","0","1","37","38","2.631578947368421052631578947"
"2020-06-30T00:00:00.000","Boone","MO","Passenger","0","1","1","9","10","10.0"
"2020-06-30T00:00:00.000","Greene","MO","Passenger","0","1","1","25","26","3.846153846153846153846153846"
"2020-06-30T00:00:00.000","St. Louis","MO","Passenger","1","0","1","93","94","1.063829787234042553191489362"
"2020-06-30T00:00:00.000","Harrison","MS","Passenger","1","0","1","55","56","1.785714285714285714285714286"
"2020-06-30T00:00:00.000","Cascade","MT","Passenger","0","1","1","54","55","1.818181818181818181818181818"
"2020-06-30T00:00:00.000","Flathead","MT","Passenger","1","0","1","55","56","1.785714285714285714285714286"
"2020-06-30T00:00:00.000","Glacier","MT","Passenger","0","1","1","4","5","20.0"
"2020-06-30T00:00:00.000","Cumberland","NC","Passenger","0","3","3","468","471","0.6369426751592356687898089172"
"2020-06-30T00:00:00.000","Guilford","NC","Passenger","1","0","1","28","29","3.448275862068965517241379310"
"2020-06-30T00:00:00.000","Mecklenburg","NC","Passenger","1","0","1","67","68","1.470588235294117647058823529"
"2020-06-30T00:00:00.000","Moore","NC","Passenger","0","2","2","166","168","1.190476190476190476190476190"
"2020-06-30T00:00:00.000","Williams","ND","Passenger","0","1","1","11","12","8.333333333333333333333333333"
"2020-06-30T00:00:00.000","Douglas","NE","Passenger","0","1","1","55","56","1.785714285714285714285714286"
"2020-06-30T00:00:00.000","Carroll","NH","Passenger","0","1","1","2","3","33.33333333333333333333333333"
"2020-06-30T00:00:00.000","Camden","NJ","Passenger","0","1","1","19","20","5.00"
"2020-06-30T00:00:00.000","Hudson","NJ","Passenger","1","0","1","148","149","0.6711409395973154362416107383"
"2020-06-30T00:00:00.000","Chaves","NM","Passenger","1","0","1","8","9","11.11111111111111111111111111"
"2020-06-30T00:00:00.000","Valencia","NM","Passenger","1","0","1","4","5","20.0"
"2020-06-30T00:00:00.000","Carson City","NV","Passenger","1","0","1","11","12","8.333333333333333333333333333"
"2020-06-30T00:00:00.000","Clark","NV","Passenger","2","4","6","659","665","0.9022556390977443609022556391"
"2020-06-30T00:00:00.000","Washoe","NV","Passenger","1","0","1","85","86","1.162790697674418604651162791"
"2020-06-30T00:00:00.000","Erie","NY","Passenger","1","0","1","38","39","2.564102564102564102564102564"
"2020-06-30T00:00:00.000","Jefferson","NY","Passenger","0","1","1","217","218","0.4587155963302752293577981651"
"2020-06-30T00:00:00.000","Nassau","NY","Passenger","2","0","2","27","29","6.896551724137931034482758621"
"2020-06-30T00:00:00.000","Queens","NY","Passenger","1","0","1","49","50","2.00"
"2020-06-30T00:00:00.000","Westchester","NY","Passenger","0","1","1","24","25","4.00"
"2020-06-30T00:00:00.000","Montgomery","OH","Passenger","0","1","1","45","46","2.173913043478260869565217391"
"2020-06-30T00:00:00.000","Shelby","OH","Passenger","0","1","1","1","2","50.0"
"2020-06-30T00:00:00.000","Oklahoma","OK","Passenger","0","1","1","112","113","0.8849557522123893805309734513"
"2020-06-30T00:00:00.000","Rogers","OK","Passenger","1","0","1","6","7","14.28571428571428571428571429"
"2020-06-30T00:00:00.000","Tulsa","OK","Passenger","1","1","2","40","42","4.761904761904761904761904762"
"2020-06-30T00:00:00.000","Clackamas","OR","Passenger","2","0","2","181","183","1.092896174863387978142076503"
"2020-06-30T00:00:00.000","Deschutes","OR","Passenger","3","0","3","124","127","2.362204724409448818897637795"
"2020-06-30T00:00:00.000","Klamath","OR","Passenger","1","0","1","25","26","3.846153846153846153846153846"
"2020-06-30T00:00:00.000","Multnomah","OR","Passenger","4","6","10","665","675","1.481481481481481481481481481"
"2020-06-30T00:00:00.000","Washington","OR","Passenger","1","0","1","402","403","0.2481389578163771712158808933"
"2020-06-30T00:00:00.000","Allegheny","PA","Passenger","1","0","1","63","64","1.562500"
"2020-06-30T00:00:00.000","Bucks","PA","Passenger","1","0","1","20","21","4.761904761904761904761904762"
"2020-06-30T00:00:00.000","Montgomery","PA","Passenger","1","0","1","24","25","4.00"
"2020-06-30T00:00:00.000","RÃ­o Grande","PR","Passenger","1","0","1","1","2","50.0"
"2020-06-30T00:00:00.000","Newport","RI","Passenger","1","0","1","84","85","1.176470588235294117647058824"
"2020-06-30T00:00:00.000","Richland","SC","Passenger","0","1","1","154","155","0.6451612903225806451612903226"
"2020-06-30T00:00:00.000","Spartanburg","SC","Passenger","0","1","1","37","38","2.631578947368421052631578947"
"2020-06-30T00:00:00.000","Davidson","TN","Passenger","1","0","1","62","63","1.587301587301587301587301587"
"2020-06-30T00:00:00.000","Putnam","TN","Passenger","0","1","1","2","3","33.33333333333333333333333333"
"2020-06-30T00:00:00.000","Shelby","TN","Passenger","0","1","1","88","89","1.123595505617977528089887640"
"2020-06-30T00:00:00.000","Tipton","TN","Passenger","1","0","1","14","15","6.666666666666666666666666667"
"2020-06-30T00:00:00.000","Bell","TX","Passenger","0","1","1","400","401","0.2493765586034912718204488778"
"2020-06-30T00:00:00.000","Bexar","TX","Passenger","5","5","10","568","578","1.730103806228373702422145329"
"2020-06-30T00:00:00.000","Dallas","TX","Passenger","1","0","1","184","185","0.5405405405405405405405405405"
"2020-06-30T00:00:00.000","Denton","TX","Passenger","1","0","1","73","74","1.351351351351351351351351351"
"2020-06-30T00:00:00.000","El Paso","TX","Passenger","2","0","2","413","415","0.4819277108433734939759036145"
"2020-06-30T00:00:00.000","Guadalupe","TX","Passenger","1","0","1","55","56","1.785714285714285714285714286"
"2020-06-30T00:00:00.000","Harris","TX","Passenger","1","0","1","223","224","0.4464285714285714285714285714"
"2020-06-30T00:00:00.000","Hidalgo","TX","Passenger","0","1","1","66","67","1.492537313432835820895522388"
"2020-06-30T00:00:00.000","Montgomery","TX","Passenger","1","0","1","41","42","2.380952380952380952380952381"
"2020-06-30T00:00:00.000","Nueces","TX","Passenger","1","0","1","79","80","1.2500"
"2020-06-30T00:00:00.000","Travis","TX","Passenger","2","2","4","163","167","2.395209580838323353293413174"
"2020-06-30T00:00:00.000","Salt Lake","UT","Passenger","0","1","1","180","181","0.5524861878453038674033149171"
"2020-06-30T00:00:00.000","Utah","UT","Passenger","0","1","1","121","122","0.8196721311475409836065573770"
"2020-06-30T00:00:00.000","Albemarle","VA","Passenger","1","0","1","21","22","4.545454545454545454545454545"
"2020-06-30T00:00:00.000","Alexandria","VA","Passenger","3","0","3","141","144","2.083333333333333333333333333"
"2020-06-30T00:00:00.000","Arlington","VA","Passenger","0","2","2","142","144","1.388888888888888888888888889"
"2020-06-30T00:00:00.000","Chesapeake","VA","Passenger","0","2","2","420","422","0.4739336492890995260663507109"
"2020-06-30T00:00:00.000","Fairfax","VA","Passenger","4","4","8","717","725","1.103448275862068965517241379"
"2020-06-30T00:00:00.000","Goochland","VA","Passenger","2","1","3","222","225","1.333333333333333333333333333"
"2020-06-30T00:00:00.000","Loudoun","VA","Passenger","1","0","1","80","81","1.234567901234567901234567901"
"2020-06-30T00:00:00.000","Manassas","VA","Passenger","0","1","1","3","4","25.00"
"2020-06-30T00:00:00.000","Norfolk","VA","Passenger","1","1","2","344","346","0.5780346820809248554913294798"
"2020-06-30T00:00:00.000","Portsmouth","VA","Passenger","0","1","1","67","68","1.470588235294117647058823529"
"2020-06-30T00:00:00.000","Powhatan","VA","Passenger","1","0","1","0","1","100"
"2020-06-30T00:00:00.000","Prince William","VA","Passenger","2","3","5","214","219","2.283105022831050228310502283"
"2020-06-30T00:00:00.000","Stafford","VA","Passenger","1","1","2","91","93","2.150537634408602150537634409"
"2020-06-30T00:00:00.000","Suffolk","VA","Passenger","1","0","1","114","115","0.8695652173913043478260869565"
"2020-06-30T00:00:00.000","Virginia Beach","VA","Passenger","1","0","1","637","638","0.1567398119122257053291536050"
"2020-06-30T00:00:00.000","Adams","WA","Truck","0","0","0","5263","5263","0"
"2020-06-30T00:00:00.000","Adams","WA","Passenger","9","8","17","12787","12804","0.1327710090596688534832864730"
"2020-06-30T00:00:00.000","Asotin","WA","Passenger","17","13","30","12330","12360","0.2427184466019417475728155340"
"2020-06-30T00:00:00.000","Asotin","WA","Truck","0","0","0","6645","6645","0"
"2020-06-30T00:00:00.000","Benton","WA","Truck","0","0","0","42704","42704","0"
"2020-06-30T00:00:00.000","Benton","WA","Passenger","370","330","700","134263","134963","0.5186606699613968272785874647"
"2020-06-30T00:00:00.000","Chelan","WA","Truck","0","0","0","22527","22527","0"
"2020-06-30T00:00:00.000","Chelan","WA","Passenger","234","78","312","54199","54511","0.5723615417071783676689108620"
"2020-06-30T00:00:00.000","Clallam","WA","Truck","1","0","1","21766","21767","0.004594110350530619745486286581"
"2020-06-30T00:00:00.000","Clallam","WA","Passenger","239","172","411","50088","50499","0.8138775025248024713360660607"
"2020-06-30T00:00:00.000","Clark","WA","Truck","0","0","0","82242","82242","0"
"2020-06-30T00:00:00.000","Clark","WA","Passenger","2115","1101","3216","317641","320857","1.002315673337343427134206204"
"2020-06-30T00:00:00.000","Columbia","WA","Truck","0","0","0","1533","1533","0"
"2020-06-30T00:00:00.000","Columbia","WA","Passenger","4","3","7","2415","2422","0.2890173410404624277456647399"
"2020-06-30T00:00:00.000","Cowlitz","WA","Passenger","148","127","275","72318","72593","0.3788244045569132009973413415"
"2020-06-30T00:00:00.000","Cowlitz","WA","Truck","0","0","0","28877","28877","0"
"2020-06-30T00:00:00.000","Douglas","WA","Truck","0","0","0","12310","12310","0"
"2020-06-30T00:00:00.000","Douglas","WA","Passenger","72","41","113","28010","28123","0.4018063506738256942715926466"
"2020-06-30T00:00:00.000","Ferry","WA","Passenger","5","3","8","4332","4340","0.1843317972350230414746543779"
"2020-06-30T00:00:00.000","Ferry","WA","Truck","0","0","0","3552","3552","0"
"2020-06-30T00:00:00.000","Franklin","WA","Truck","0","0","0","19976","19976","0"
"2020-06-30T00:00:00.000","Franklin","WA","Passenger","66","81","147","60650","60797","0.2417882461305656529105054526"
"2020-06-30T00:00:00.000","Garfield","WA","Truck","0","0","0","974","974","0"
"2020-06-30T00:00:00.000","Garfield","WA","Passenger","0","1","1","1354","1355","0.07380073800738007380073800738"
"2020-06-30T00:00:00.000","Grant","WA","Passenger","62","75","137","65247","65384","0.2095313838247889391900159060"
"2020-06-30T00:00:00.000","Grant","WA","Truck","0","0","0","27095","27095","0"
"2020-06-30T00:00:00.000","Grays Harbor","WA","Truck","0","0","0","20913","20913","0"
"2020-06-30T00:00:00.000","Grays Harbor","WA","Passenger","121","117","238","48136","48374","0.4919998346219043287716541944"
"2020-06-30T00:00:00.000","Island","WA","Passenger","434","286","720","62887","63607","1.131950885908783624443850520"
"2020-06-30T00:00:00.000","Island","WA","Truck","1","0","1","21234","21235","0.004709206498704968212856133741"
"2020-06-30T00:00:00.000","Jefferson","WA","Truck","0","0","0","9538","9538","0"
"2020-06-30T00:00:00.000","Jefferson","WA","Passenger","246","150","396","24791","25187","1.572239647437169968634613094"
"2020-06-30T00:00:00.000","King","WA","Truck","5","1","6","182250","182256","0.003292072688964972346589412694"
"2020-06-30T00:00:00.000","King","WA","Passenger","24498","8041","32539","1371138","1403677","2.318125893635074165922787080"
"2020-06-30T00:00:00.000","Kitsap","WA","Truck","0","0","0","54115","54115","0"
"2020-06-30T00:00:00.000","Kitsap","WA","Passenger","1407","721","2128","179895","182023","1.169083027968992929464957725"
"2020-06-30T00:00:00.000","Kittitas","WA","Truck","0","0","0","14593","14593","0"
"2020-06-30T00:00:00.000","Kittitas","WA","Passenger","103","49","152","29809","29961","0.5073261907145956409999666233"
"2020-06-30T00:00:00.000","Klickitat","WA","Truck","0","0","0","8103","8103","0"
"2020-06-30T00:00:00.000","Klickitat","WA","Passenger","55","42","97","15177","15274","0.6350661254419274584260835407"
"2020-06-30T00:00:00.000","Lewis","WA","Passenger","112","119","231","58150","58381","0.3956766756307702848529487333"
"2020-06-30T00:00:00.000","Lewis","WA","Truck","0","0","0","26214","26214","0"
"2020-06-30T00:00:00.000","Lincoln","WA","Passenger","6","12","18","7629","7647","0.2353864260494311494703805414"
"2020-06-30T00:00:00.000","Lincoln","WA","Truck","0","0","0","4623","4623","0"
"2020-06-30T00:00:00.000","Mason","WA","Passenger","184","144","328","47260","47588","0.6892493906026729427586786585"
"2020-06-30T00:00:00.000","Mason","WA","Truck","0","0","0","20609","20609","0"
"2020-06-30T00:00:00.000","Okanogan","WA","Passenger","37","33","70","25855","25925","0.2700096432015429122468659595"
"2020-06-30T00:00:00.000","Okanogan","WA","Truck","0","0","0","16450","16450","0"
"2020-06-30T00:00:00.000","Pacific","WA","Passenger","43","37","80","15741","15821","0.5056570381138992478351558056"
"2020-06-30T00:00:00.000","Pacific","WA","Truck","0","0","0","7702","7702","0"
"2020-06-30T00:00:00.000","Pend Oreille","WA","Passenger","7","6","13","9243","9256","0.1404494382022471910112359551"
"2020-06-30T00:00:00.000","Pend Oreille","WA","Truck","0","0","0","5760","5760","0"
"2020-06-30T00:00:00.000","Pierce","WA","Passenger","2594","1805","4399","549806","554205","0.7937496052904611109607455725"
"2020-06-30T00:00:00.000","Pierce","WA","Truck","0","0","0","142254","142254","0"
"2020-06-30T00:00:00.000","San Juan","WA","Truck","0","0","0","5854","5854","0"
"2020-06-30T00:00:00.000","San Juan","WA","Passenger","304","95","399","13967","14366","2.777391062230265905610469163"
"2020-06-30T00:00:00.000","Skagit","WA","Passenger","434","242","676","91145","91821","0.7362150270635257729713246425"
"2020-06-30T00:00:00.000","Skagit","WA","Truck","1","0","1","32481","32482","0.003078628163290437780924819900"
"2020-06-30T00:00:00.000","Skamania","WA","Truck","0","0","0","4013","4013","0"
"2020-06-30T00:00:00.000","Skamania","WA","Passenger","35","18","53","8479","8532","0.6211908110642287857477730895"
"2020-06-30T00:00:00.000","Snohomish","WA","Passenger","4580","1863","6443","534557","541000","1.190942698706099815157116451"
"2020-06-30T00:00:00.000","Snohomish","WA","Truck","0","0","0","123983","123983","0"
"2020-06-30T00:00:00.000","Spokane","WA","Passenger","765","521","1286","315554","316840","0.4058830955687413205403358162"
"2020-06-30T00:00:00.000","Spokane","WA","Truck","1","0","1","98384","98385","0.001016415103928444376683437516"
"2020-06-30T00:00:00.000","Stevens","WA","Truck","0","0","0","18645","18645","0"
"2020-06-30T00:00:00.000","Stevens","WA","Passenger","39","35","74","30651","30725","0.2408462164361269324654190399"
"2020-06-30T00:00:00.000","Thurston","WA","Truck","0","0","0","55788","55788","0"
"2020-06-30T00:00:00.000","Thurston","WA","Passenger","1226","788","2014","196995","199009","1.012014532006090176826173691"
"2020-06-30T00:00:00.000","Wahkiakum","WA","Truck","0","0","0","1737","1737","0"
"2020-06-30T00:00:00.000","Wahkiakum","WA","Passenger","6","7","13","2992","3005","0.4326123128119800332778702163"
"2020-06-30T00:00:00.000","Walla Walla","WA","Truck","0","0","0","13750","13750","0"
"2020-06-30T00:00:00.000","Walla Walla","WA","Passenger","74","63","137","35851","35988","0.3806824497054573746804490386"
"2020-06-30T00:00:00.000","Whatcom","WA","Passenger","1120","521","1641","149248","150889","1.087554427426783927257785524"
"2020-06-30T00:00:00.000","Whatcom","WA","Truck","3","0","3","43021","43024","0.006972852361472666418743027148"
"2020-06-30T00:00:00.000","Whitman","WA","Truck","0","0","0","8512","8512","0"
"2020-06-30T00:00:00.000","Whitman","WA","Passenger","46","51","97","22163","22260","0.4357592093441150044923629829"
"2020-06-30T00:00:00.000","Yakima","WA","Passenger","147","128","275","165382","165657","0.1660056623022268905026651455"
"2020-06-30T00:00:00.000","Yakima","WA","Truck","0","0","0","59909","59909","0"
"2020-06-30T00:00:00.000","Ozaukee","WI","Passenger","0","1","1","3","4","25.00"
"2020-06-30T00:00:00.000",,,"Passenger","2","0","2","201","203","0.9852216748768472906403940887"
"2020-07-31T00:00:00.000","Fairbanks North Star","AK","Passenger","0","1","1","95","96","1.041666666666666666666666667"
"2020-07-31T00:00:00.000","Juneau","AK","Passenger","0","1","1","28","29","3.448275862068965517241379310"
"2020-07-31T00:00:00.000","Montgomery","AL","Passenger","0","1","1","37","38","2.631578947368421052631578947"
"2020-07-31T00:00:00.000","Maricopa","AZ","Passenger","6","7","13","1241","1254","1.036682615629984051036682616"
"2020-07-31T00:00:00.000","Pima","AZ","Passenger","3","1","4","310","314","1.273885350318471337579617834"
"2020-07-31T00:00:00.000","Pinal","AZ","Passenger","1","0","1","153","154","0.6493506493506493506493506494"
"2020-07-31T00:00:00.000","Alameda","CA","Passenger","2","0","2","251","253","0.7905138339920948616600790514"
"2020-07-31T00:00:00.000","Contra Costa","CA","Passenger","3","3","6","345","351","1.709401709401709401709401709"
"2020-07-31T00:00:00.000","Fresno","CA","Passenger","1","0","1","174","175","0.5714285714285714285714285714"
"2020-07-31T00:00:00.000","Kern","CA","Passenger","1","1","2","221","223","0.8968609865470852017937219731"
"2020-07-31T00:00:00.000","Los Angeles","CA","Passenger","8","10","18","940","958","1.878914405010438413361169102"
"2020-07-31T00:00:00.000","Monterey","CA","Passenger","1","1","2","161","163","1.226993865030674846625766871"
"2020-07-31T00:00:00.000","Orange","CA","Passenger","6","2","8","474","482","1.659751037344398340248962656"
"2020-07-31T00:00:00.000","Placer","CA","Passenger","1","0","1","76","77","1.298701298701298701298701299"
"2020-07-31T00:00:00.000","Riverside","CA","Passenger","3","1","4","574","578","0.6920415224913494809688581315"
"2020-07-31T00:00:00.000","Sacramento","CA","Passenger","1","0","1","255","256","0.39062500"
"2020-07-31T00:00:00.000","San Bernardino","CA","Passenger","0","1","1","414","415","0.2409638554216867469879518072"
"2020-07-31T00:00:00.000","San Diego","CA","Passenger","14","6","20","2813","2833","0.7059654076950229438757500882"
"2020-07-31T00:00:00.000","San Francisco","CA","Passenger","2","1","3","83","86","3.488372093023255813953488372"
"2020-07-31T00:00:00.000","San Mateo","CA","Passenger","0","1","1","106","107","0.9345794392523364485981308411"
"2020-07-31T00:00:00.000","Santa Barbara","CA","Passenger","2","0","2","81","83","2.409638554216867469879518072"
"2020-07-31T00:00:00.000","Santa Clara","CA","Passenger","7","2","9","268","277","3.249097472924187725631768953"
"2020-07-31T00:00:00.000","Santa Cruz","CA","Passenger","1","0","1","31","32","3.12500"
"2020-07-31T00:00:00.000","Shasta","CA","Passenger","1","0","1","37","38","2.631578947368421052631578947"
"2020-07-31T00:00:00.000","Solano","CA","Passenger","1","0","1","213","214","0.4672897196261682242990654206"
"2020-07-31T00:00:00.000","Ventura","CA","Passenger","1","2","3","281","284","1.056338028169014084507042254"
"2020-07-31T00:00:00.000","Arapahoe","CO","Passenger","1","0","1","125","126","0.7936507936507936507936507937"
"2020-07-31T00:00:00.000","Boulder","CO","Passenger","0","1","1","37","38","2.631578947368421052631578947"
"2020-07-31T00:00:00.000","Denver","CO","Passenger","1","0","1","110","111","0.9009009009009009009009009009"
"2020-07-31T00:00:00.000","El Paso","CO","Passenger","2","0","2","686","688","0.2906976744186046511627906977"
"2020-07-31T00:00:00.000","Jefferson","CO","Passenger","0","1","1","58","59","1.694915254237288135593220339"
"2020-07-31T00:00:00.000","Larimer","CO","Passenger","1","1","2","43","45","4.444444444444444444444444444"
"2020-07-31T00:00:00.000","New London","CT","Passenger","0","2","2","251","253","0.7905138339920948616600790514"
"2020-07-31T00:00:00.000","District of Columbia","DC","Passenger","2","3","5","200","205","2.439024390243902439024390244"
"2020-07-31T00:00:00.000","Kent","DE","Passenger","0","1","1","68","69","1.449275362318840579710144928"
"2020-07-31T00:00:00.000","New Castle","DE","Passenger","1","0","1","25","26","3.846153846153846153846153846"
"2020-07-31T00:00:00.000","Brevard","FL","Passenger","0","1","1","77","78","1.282051282051282051282051282"
"2020-07-31T00:00:00.000","Broward","FL","Passenger","2","1","3","102","105","2.857142857142857142857142857"
"2020-07-31T00:00:00.000","Clay","FL","Passenger","0","1","1","80","81","1.234567901234567901234567901"
"2020-07-31T00:00:00.000","Duval","FL","Passenger","0","1","1","343","344","0.2906976744186046511627906977"
"2020-07-31T00:00:00.000","Lake","FL","Passenger","1","0","1","19","20","5.00"
"2020-07-31T00:00:00.000","Nassau","FL","Passenger","1","0","1","28","29","3.448275862068965517241379310"
"2020-07-31T00:00:00.000","Okaloosa","FL","Passenger","0","1","1","133","134","0.7462686567164179104477611940"
"2020-07-31T00:00:00.000","Palm Beach","FL","Passenger","0","1","1","69","70","1.428571428571428571428571429"
"2020-07-31T00:00:00.000","Pinellas","FL","Passenger","1","1","2","96","98","2.040816326530612244897959184"
"2020-07-31T00:00:00.000","Polk","FL","Passenger","1","0","1","64","65","1.538461538461538461538461538"
"2020-07-31T00:00:00.000","Sarasota","FL","Passenger","2","0","2","26","28","7.142857142857142857142857143"
"2020-07-31T00:00:00.000","Sumter","FL","Passenger","0","1","1","9","10","10.0"
"2020-07-31T00:00:00.000","Bartow","GA","Passenger","0","1","1","3","4","25.00"
"2020-07-31T00:00:00.000","Bryan","GA","Passenger","1","0","1","49","50","2.00"
"2020-07-31T00:00:00.000","Camden","GA","Passenger","0","1","1","146","147","0.6802721088435374149659863946"
"2020-07-31T00:00:00.000","Columbia","GA","Passenger","1","1","2","132","134","1.492537313432835820895522388"
"2020-07-31T00:00:00.000","DeKalb","GA","Passenger","1","0","1","71","72","1.388888888888888888888888889"
"2020-07-31T00:00:00.000","Fulton","GA","Passenger","1","2","3","95","98","3.061224489795918367346938776"
"2020-07-31T00:00:00.000","Houston","GA","Passenger","1","0","1","54","55","1.818181818181818181818181818"
"2020-07-31T00:00:00.000","Jones","GA","Passenger","1","0","1","1","2","50.0"
"2020-07-31T00:00:00.000","Liberty","GA","Passenger","1","0","1","116","117","0.8547008547008547008547008547"
"2020-07-31T00:00:00.000","Honolulu","HI","Passenger","4","1","5","420","425","1.176470588235294117647058824"
"2020-07-31T00:00:00.000","Maui","HI","Passenger","1","0","1","29","30","3.333333333333333333333333333"
"2020-07-31T00:00:00.000","Ada","ID","Passenger","0","1","1","241","242","0.4132231404958677685950413223"
"2020-07-31T00:00:00.000","Kootenai","ID","Passenger","1","0","1","197","198","0.5050505050505050505050505051"
"2020-07-31T00:00:00.000","Twin Falls","ID","Passenger","0","1","1","18","19","5.263157894736842105263157895"
"2020-07-31T00:00:00.000","DuPage","IL","Passenger","3","0","3","53","56","5.357142857142857142857142857"
"2020-07-31T00:00:00.000","Lake","IL","Passenger","2","0","2","170","172","1.162790697674418604651162791"
"2020-07-31T00:00:00.000","Monroe","IL","Passenger","1","0","1","3","4","25.00"
"2020-07-31T00:00:00.000","St. Clair","IL","Passenger","1","0","1","137","138","0.7246376811594202898550724638"
"2020-07-31T00:00:00.000","DeKalb","IN","Passenger","1","0","1","1","2","50.0"
"2020-07-31T00:00:00.000","Hamilton","IN","Passenger","1","0","1","39","40","2.500"
"2020-07-31T00:00:00.000","Vigo","IN","Passenger","1","0","1","4","5","20.0"
"2020-07-31T00:00:00.000","Sedgwick","KS","Passenger","1","0","1","94","95","1.052631578947368421052631579"
"2020-07-31T00:00:00.000","Oldham","KY","Passenger","0","1","1","4","5","20.0"
"2020-07-31T00:00:00.000","Middlesex","MA","Passenger","1","1","2","92","94","2.127659574468085106382978723"
"2020-07-31T00:00:00.000","Suffolk","MA","Passenger","0","2","2","40","42","4.761904761904761904761904762"
"2020-07-31T00:00:00.000","Anne Arundel","MD","Passenger","0","1","1","406","407","0.2457002457002457002457002457"
"2020-07-31T00:00:00.000","Calvert","MD","Passenger","0","2","2","87","89","2.247191011235955056179775281"
"2020-07-31T00:00:00.000","Charles","MD","Passenger","1","1","2","70","72","2.777777777777777777777777778"
"2020-07-31T00:00:00.000","Frederick","MD","Passenger","2","1","3","78","81","3.703703703703703703703703704"
"2020-07-31T00:00:00.000","Howard","MD","Passenger","0","1","1","68","69","1.449275362318840579710144928"
"2020-07-31T00:00:00.000","Montgomery","MD","Passenger","0","2","2","233","235","0.8510638297872340425531914894"
"2020-07-31T00:00:00.000","St. Mary's","MD","Passenger","1","0","1","200","201","0.4975124378109452736318407960"
"2020-07-31T00:00:00.000","Penobscot","ME","Passenger","0","1","1","15","16","6.2500"
"2020-07-31T00:00:00.000","Kent","MI","Passenger","0","1","1","22","23","4.347826086956521739130434783"
"2020-07-31T00:00:00.000","Saginaw","MI","Passenger","1","0","1","11","12","8.333333333333333333333333333"
"2020-07-31T00:00:00.000","Washtenaw","MI","Passenger","1","0","1","29","30","3.333333333333333333333333333"
"2020-07-31T00:00:00.000","Hennepin","MN","Passenger","2","0","2","80","82","2.439024390243902439024390244"
"2020-07-31T00:00:00.000","Kanabec","MN","Passenger","1","0","1","0","1","100"
"2020-07-31T00:00:00.000","Ramsey","MN","Passenger","1","0","1","36","37","2.702702702702702702702702703"
"2020-07-31T00:00:00.000","Boone","MO","Passenger","0","1","1","9","10","10.0"
"2020-07-31T00:00:00.000","Greene","MO","Passenger","0","1","1","26","27","3.703703703703703703703703704"
"2020-07-31T00:00:00.000","St. Louis","MO","Passenger","1","0","1","94","95","1.052631578947368421052631579"
"2020-07-31T00:00:00.000","Harrison","MS","Passenger","1","0","1","53","54","1.851851851851851851851851852"
"2020-07-31T00:00:00.000","Cascade","MT","Passenger","0","1","1","54","55","1.818181818181818181818181818"
"2020-07-31T00:00:00.000","Flathead","MT","Passenger","1","0","1","51","52","1.923076923076923076923076923"
"2020-07-31T00:00:00.000","Glacier","MT","Passenger","0","1","1","3","4","25.00"
"2020-07-31T00:00:00.000","Cumberland","NC","Passenger","0","3","3","468","471","0.6369426751592356687898089172"
"2020-07-31T00:00:00.000","Guilford","NC","Passenger","1","0","1","27","28","3.571428571428571428571428571"
"2020-07-31T00:00:00.000","Mecklenburg","NC","Passenger","1","0","1","67","68","1.470588235294117647058823529"
"2020-07-31T00:00:00.000","Moore","NC","Passenger","0","2","2","161","163","1.226993865030674846625766871"
"2020-07-31T00:00:00.000","Williams","ND","Passenger","0","1","1","11","12","8.333333333333333333333333333"
"2020-07-31T00:00:00.000","Douglas","NE","Passenger","0","1","1","53","54","1.851851851851851851851851852"
"2020-07-31T00:00:00.000","Carroll","NH","Passenger","0","1","1","2","3","33.33333333333333333333333333"
"2020-07-31T00:00:00.000","Camden","NJ","Passenger","0","1","1","20","21","4.761904761904761904761904762"
"2020-07-31T00:00:00.000","Hudson","NJ","Passenger","1","0","1","143","144","0.6944444444444444444444444444"
"2020-07-31T00:00:00.000","Morris","NJ","Passenger","1","0","1","18","19","5.263157894736842105263157895"
"2020-07-31T00:00:00.000","Chaves","NM","Passenger","1","0","1","9","10","10.0"
"2020-07-31T00:00:00.000","Valencia","NM","Passenger","1","0","1","5","6","16.66666666666666666666666667"
"2020-07-31T00:00:00.000","Carson City","NV","Passenger","1","0","1","11","12","8.333333333333333333333333333"
"2020-07-31T00:00:00.000","Clark","NV","Passenger","2","4","6","652","658","0.9118541033434650455927051672"
"2020-07-31T00:00:00.000","Washoe","NV","Passenger","1","0","1","82","83","1.204819277108433734939759036"
"2020-07-31T00:00:00.000","Erie","NY","Passenger","1","0","1","39","40","2.500"
"2020-07-31T00:00:00.000","Jefferson","NY","Passenger","0","1","1","216","217","0.4608294930875576036866359447"
"2020-07-31T00:00:00.000","Kings","NY","Passenger","1","0","1","58","59","1.694915254237288135593220339"
"2020-07-31T00:00:00.000","Nassau","NY","Passenger","2","0","2","27","29","6.896551724137931034482758621"
"2020-07-31T00:00:00.000","New York","NY","Passenger","1","0","1","62","63","1.587301587301587301587301587"
"2020-07-31T00:00:00.000","Queens","NY","Passenger","1","0","1","48","49","2.040816326530612244897959184"
"2020-07-31T00:00:00.000","Westchester","NY","Passenger","0","1","1","23","24","4.166666666666666666666666667"
"2020-07-31T00:00:00.000","Montgomery","OH","Passenger","0","1","1","45","46","2.173913043478260869565217391"
"2020-07-31T00:00:00.000","Shelby","OH","Passenger","0","1","1","1","2","50.0"
"2020-07-31T00:00:00.000","Oklahoma","OK","Passenger","0","1","1","111","112","0.8928571428571428571428571429"
"2020-07-31T00:00:00.000","Rogers","OK","Passenger","1","0","1","5","6","16.66666666666666666666666667"
"2020-07-31T00:00:00.000","Tulsa","OK","Passenger","1","1","2","39","41","4.878048780487804878048780488"
"2020-07-31T00:00:00.000","Clackamas","OR","Passenger","2","0","2","176","178","1.123595505617977528089887640"
"2020-07-31T00:00:00.000","Deschutes","OR","Passenger","2","0","2","121","123","1.626016260162601626016260163"
"2020-07-31T00:00:00.000","Klamath","OR","Passenger","1","0","1","25","26","3.846153846153846153846153846"
"2020-07-31T00:00:00.000","Multnomah","OR","Passenger","4","6","10","662","672","1.488095238095238095238095238"
"2020-07-31T00:00:00.000","Washington","OR","Passenger","1","0","1","397","398","0.2512562814070351758793969849"
"2020-07-31T00:00:00.000","Allegheny","PA","Passenger","1","0","1","63","64","1.562500"
"2020-07-31T00:00:00.000","Bucks","PA","Passenger","1","0","1","21","22","4.545454545454545454545454545"
"2020-07-31T00:00:00.000","Montgomery","PA","Passenger","1","0","1","23","24","4.166666666666666666666666667"
"2020-07-31T00:00:00.000","RÃ­o Grande","PR","Passenger","1","0","1","1","2","50.0"
"2020-07-31T00:00:00.000","Newport","RI","Passenger","1","0","1","81","82","1.219512195121951219512195122"
"2020-07-31T00:00:00.000","Charleston","SC","Passenger","1","0","1","96","97","1.030927835051546391752577320"
"2020-07-31T00:00:00.000","Richland","SC","Passenger","0","1","1","150","151","0.6622516556291390728476821192"
"2020-07-31T00:00:00.000","Spartanburg","SC","Passenger","0","1","1","37","38","2.631578947368421052631578947"
"2020-07-31T00:00:00.000","Bradley","TN","Passenger","1","0","1","3","4","25.00"
"2020-07-31T00:00:00.000","Davidson","TN","Passenger","1","0","1","56","57","1.754385964912280701754385965"
"2020-07-31T00:00:00.000","Putnam","TN","Passenger","0","1","1","2","3","33.33333333333333333333333333"
"2020-07-31T00:00:00.000","Shelby","TN","Passenger","0","1","1","86","87","1.149425287356321839080459770"
"2020-07-31T00:00:00.000","Tipton","TN","Passenger","1","0","1","14","15","6.666666666666666666666666667"
"2020-07-31T00:00:00.000","Bell","TX","Passenger","0","1","1","398","399","0.2506265664160401002506265664"
"2020-07-31T00:00:00.000","Bexar","TX","Passenger","6","5","11","563","574","1.916376306620209059233449477"
"2020-07-31T00:00:00.000","Dallas","TX","Passenger","1","0","1","178","179","0.5586592178770949720670391061"
"2020-07-31T00:00:00.000","Denton","TX","Passenger","1","0","1","73","74","1.351351351351351351351351351"
"2020-07-31T00:00:00.000","El Paso","TX","Passenger","2","0","2","408","410","0.4878048780487804878048780488"
"2020-07-31T00:00:00.000","Guadalupe","TX","Passenger","1","0","1","52","53","1.886792452830188679245283019"
"2020-07-31T00:00:00.000","Harris","TX","Passenger","1","0","1","216","217","0.4608294930875576036866359447"
"2020-07-31T00:00:00.000","Hidalgo","TX","Passenger","0","1","1","63","64","1.562500"
"2020-07-31T00:00:00.000","Montgomery","TX","Passenger","1","0","1","41","42","2.380952380952380952380952381"
"2020-07-31T00:00:00.000","Nueces","TX","Passenger","1","0","1","80","81","1.234567901234567901234567901"
"2020-07-31T00:00:00.000","Travis","TX","Passenger","2","2","4","157","161","2.484472049689440993788819876"
"2020-07-31T00:00:00.000","Salt Lake","UT","Passenger","0","1","1","168","169","0.5917159763313609467455621302"
"2020-07-31T00:00:00.000","Utah","UT","Passenger","0","1","1","123","124","0.8064516129032258064516129032"
"2020-07-31T00:00:00.000","Albemarle","VA","Passenger","1","0","1","20","21","4.761904761904761904761904762"
"2020-07-31T00:00:00.000","Alexandria","VA","Passenger","4","0","4","139","143","2.797202797202797202797202797"
"2020-07-31T00:00:00.000","Arlington","VA","Passenger","0","2","2","141","143","1.398601398601398601398601399"
"2020-07-31T00:00:00.000","Chesapeake","VA","Passenger","0","2","2","417","419","0.4773269689737470167064439141"
"2020-07-31T00:00:00.000","Fairfax","VA","Passenger","4","4","8","723","731","1.094391244870041039671682627"
"2020-07-31T00:00:00.000","Goochland","VA","Passenger","3","1","4","221","225","1.777777777777777777777777778"
"2020-07-31T00:00:00.000","Loudoun","VA","Passenger","1","0","1","78","79","1.265822784810126582278481013"
"2020-07-31T00:00:00.000","Manassas","VA","Passenger","0","1","1","4","5","20.0"
"2020-07-31T00:00:00.000","Norfolk","VA","Passenger","1","1","2","346","348","0.5747126436781609195402298851"
"2020-07-31T00:00:00.000","Portsmouth","VA","Passenger","0","1","1","65","66","1.515151515151515151515151515"
"2020-07-31T00:00:00.000","Powhatan","VA","Passenger","1","0","1","0","1","100"
"2020-07-31T00:00:00.000","Prince William","VA","Passenger","2","3","5","218","223","2.242152466367713004484304933"
"2020-07-31T00:00:00.000","Stafford","VA","Passenger","1","1","2","90","92","2.173913043478260869565217391"
"2020-07-31T00:00:00.000","Suffolk","VA","Passenger","1","0","1","113","114","0.8771929824561403508771929825"
"2020-07-31T00:00:00.000","Virginia Beach","VA","Passenger","1","0","1","634","635","0.1574803149606299212598425197"
"2020-07-31T00:00:00.000","Adams","WA","Passenger","9","8","17","12868","12885","0.1319363601086534730306558013"
"2020-07-31T00:00:00.000","Adams","WA","Truck","0","0","0","5283","5283","0"
"2020-07-31T00:00:00.000","Asotin","WA","Truck","0","0","0","6660","6660","0"
"2020-07-31T00:00:00.000","Asotin","WA","Passenger","17","13","30","12387","12417","0.2416042522348393331722638318"
"2020-07-31T00:00:00.000","Benton","WA","Passenger","384","330","714","134343","135057","0.5286656744929918478864479442"
"2020-07-31T00:00:00.000","Benton","WA","Truck","0","0","0","42882","42882","0"
"2020-07-31T00:00:00.000","Chelan","WA","Truck","0","0","0","22633","22633","0"
"2020-07-31T00:00:00.000","Chelan","WA","Passenger","243","82","325","54244","54569","0.5955762429218054206600817314"
"2020-07-31T00:00:00.000","Clallam","WA","Truck","1","0","1","21702","21703","0.004607657927475464221536193153"
"2020-07-31T00:00:00.000","Clallam","WA","Passenger","248","173","421","50051","50472","0.8341258519575210017435409732"
"2020-07-31T00:00:00.000","Clark","WA","Passenger","2197","1108","3305","317924","321229","1.028861030604335225026383048"
"2020-07-31T00:00:00.000","Clark","WA","Truck","0","0","0","82447","82447","0"
"2020-07-31T00:00:00.000","Columbia","WA","Passenger","4","3","7","2418","2425","0.2886597938144329896907216495"
"2020-07-31T00:00:00.000","Columbia","WA","Truck","0","0","0","1542","1542","0"
"2020-07-31T00:00:00.000","Cowlitz","WA","Passenger","157","130","287","72228","72515","0.3957801834103288974694890712"
"2020-07-31T00:00:00.000","Cowlitz","WA","Truck","0","0","0","28888","28888","0"
"2020-07-31T00:00:00.000","Douglas","WA","Passenger","76","42","118","28058","28176","0.4187961385576377058489494605"
"2020-07-31T00:00:00.000","Douglas","WA","Truck","0","0","0","12354","12354","0"
"2020-07-31T00:00:00.000","Ferry","WA","Truck","0","0","0","3566","3566","0"
"2020-07-31T00:00:00.000","Ferry","WA","Passenger","7","3","10","4332","4342","0.2303086135421464762782128052"
"2020-07-31T00:00:00.000","Franklin","WA","Passenger","72","84","156","60783","60939","0.2559936986166494363215674691"
"2020-07-31T00:00:00.000","Franklin","WA","Truck","0","0","0","20099","20099","0"
"2020-07-31T00:00:00.000","Garfield","WA","Truck","0","0","0","988","988","0"
"2020-07-31T00:00:00.000","Garfield","WA","Passenger","0","1","1","1353","1354","0.07385524372230428360413589365"
"2020-07-31T00:00:00.000","Grant","WA","Passenger","64","79","143","65292","65435","0.2185374799419271032322151754"
"2020-07-31T00:00:00.000","Grant","WA","Truck","0","0","0","27187","27187","0"
"2020-07-31T00:00:00.000","Grays Harbor","WA","Passenger","124","119","243","48277","48520","0.5008244023083264633140972795"
"2020-07-31T00:00:00.000","Grays Harbor","WA","Truck","0","0","0","20983","20983","0"
"2020-07-31T00:00:00.000","Island","WA","Passenger","444","290","734","62957","63691","1.152439120126862508046662794"
"2020-07-31T00:00:00.000","Island","WA","Truck","1","0","1","21258","21259","0.004703890117126863916458911520"
"2020-07-31T00:00:00.000","Jefferson","WA","Truck","0","0","0","9547","9547","0"
"2020-07-31T00:00:00.000","Jefferson","WA","Passenger","260","153","413","24730","25143","1.642604303384639860000795450"
"2020-07-31T00:00:00.000","King","WA","Passenger","25294","8084","33378","1371295","1404673","2.376211402938619878078385503"
"2020-07-31T00:00:00.000","King","WA","Truck","7","1","8","183033","183041","0.004370605492758453024185838146"
"2020-07-31T00:00:00.000","Kitsap","WA","Passenger","1450","731","2181","179972","182153","1.197345089018572299111186750"
"2020-07-31T00:00:00.000","Kitsap","WA","Truck","0","0","0","54196","54196","0"
"2020-07-31T00:00:00.000","Kittitas","WA","Passenger","108","49","157","29766","29923","0.5246800120308792567590148047"
"2020-07-31T00:00:00.000","Kittitas","WA","Truck","0","0","0","14566","14566","0"
"2020-07-31T00:00:00.000","Klickitat","WA","Passenger","58","44","102","15119","15221","0.6701267985020695092306681558"
"2020-07-31T00:00:00.000","Klickitat","WA","Truck","0","0","0","8119","8119","0"
"2020-07-31T00:00:00.000","Lewis","WA","Truck","0","0","0","26290","26290","0"
"2020-07-31T00:00:00.000","Lewis","WA","Passenger","117","122","239","58112","58351","0.4095902383849462734143373721"
"2020-07-31T00:00:00.000","Lincoln","WA","Passenger","6","11","17","7653","7670","0.2216427640156453715775749674"
"2020-07-31T00:00:00.000","Lincoln","WA","Truck","0","0","0","4660","4660","0"
"2020-07-31T00:00:00.000","Mason","WA","Passenger","184","143","327","47360","47687","0.6857214754545263908402709334"
"2020-07-31T00:00:00.000","Mason","WA","Truck","0","0","0","20720","20720","0"
"2020-07-31T00:00:00.000","Okanogan","WA","Passenger","38","34","72","25930","26002","0.2769017767864010460733789708"
"2020-07-31T00:00:00.000","Okanogan","WA","Truck","0","0","0","16497","16497","0"
"2020-07-31T00:00:00.000","Pacific","WA","Truck","0","0","0","7717","7717","0"
"2020-07-31T00:00:00.000","Pacific","WA","Passenger","43","37","80","15753","15833","0.5052737952377944798837870271"
"2020-07-31T00:00:00.000","Pend Oreille","WA","Truck","0","0","0","5762","5762","0"
"2020-07-31T00:00:00.000","Pend Oreille","WA","Passenger","7","5","12","9246","9258","0.1296176279974076474400518471"
"2020-07-31T00:00:00.000","Pierce","WA","Passenger","2681","1809","4490","551630","556120","0.8073797022225418974322088758"
"2020-07-31T00:00:00.000","Pierce","WA","Truck","0","0","0","143027","143027","0"
"2020-07-31T00:00:00.000","San Juan","WA","Passenger","313","96","409","13957","14366","2.846999860782402895726019769"
"2020-07-31T00:00:00.000","San Juan","WA","Truck","0","0","0","5844","5844","0"
"2020-07-31T00:00:00.000","Skagit","WA","Passenger","450","244","694","91303","91997","0.7543724251877778623215974434"
"2020-07-31T00:00:00.000","Skagit","WA","Truck","1","0","1","32601","32602","0.003067296484878228329550334335"
"2020-07-31T00:00:00.000","Skamania","WA","Truck","0","0","0","4034","4034","0"
"2020-07-31T00:00:00.000","Skamania","WA","Passenger","35","20","55","8427","8482","0.6484319735911341664701721292"
"2020-07-31T00:00:00.000","Snohomish","WA","Truck","0","0","0","124382","124382","0"
"2020-07-31T00:00:00.000","Snohomish","WA","Passenger","4726","1873","6599","535633","542232","1.217006742501364729488484634"
"2020-07-31T00:00:00.000","Spokane","WA","Truck","1","0","1","99041","99042","0.001009672664122291553078491953"
"2020-07-31T00:00:00.000","Spokane","WA","Passenger","790","525","1315","316544","317859","0.4137054480131127323750467975"
"2020-07-31T00:00:00.000","Stevens","WA","Passenger","40","37","77","30627","30704","0.2507816571130797290255341324"
"2020-07-31T00:00:00.000","Stevens","WA","Truck","0","0","0","18673","18673","0"
"2020-07-31T00:00:00.000","Thurston","WA","Passenger","1257","796","2053","197265","199318","1.030012342086515016205259936"
"2020-07-31T00:00:00.000","Thurston","WA","Truck","0","0","0","55939","55939","0"
"2020-07-31T00:00:00.000","Wahkiakum","WA","Truck","0","0","0","1742","1742","0"
"2020-07-31T00:00:00.000","Wahkiakum","WA","Passenger","6","7","13","3002","3015","0.4311774461028192371475953566"
"2020-07-31T00:00:00.000","Walla Walla","WA","Truck","0","0","0","13761","13761","0"
"2020-07-31T00:00:00.000","Walla Walla","WA","Passenger","78","66","144","35924","36068","0.3992458689142730398136852612"
"2020-07-31T00:00:00.000","Whatcom","WA","Passenger","1147","523","1670","149330","151000","1.105960264900662251655629139"
"2020-07-31T00:00:00.000","Whatcom","WA","Truck","3","0","3","43170","43173","0.006948787436592314641095128900"
"2020-07-31T00:00:00.000","Whitman","WA","Passenger","47","52","99","22146","22245","0.4450438300741739716790289953"
"2020-07-31T00:00:00.000","Whitman","WA","Truck","0","0","0","8511","8511","0"
"2020-07-31T00:00:00.000","Yakima","WA","Passenger","154","128","282","165805","166087","0.1697905314684472595687802176"
"2020-07-31T00:00:00.000","Yakima","WA","Truck","0","0","0","60215","60215","0"
"2020-07-31T00:00:00.000","Ozaukee","WI","Passenger","0","1","1","3","4","25.00"
"2020-07-31T00:00:00.000",,,"Passenger","2","0","2","194","196","1.020408163265306122448979592"
"2020-08-31T00:00:00.000","Fairbanks North Star","AK","Passenger","0","1","1","94","95","1.052631578947368421052631579"
"2020-08-31T00:00:00.000","Juneau","AK","Passenger","0","1","1","26","27","3.703703703703703703703703704"
"2020-08-31T00:00:00.000","Montgomery","AL","Passenger","0","1","1","36","37","2.702702702702702702702702703"
"2020-08-31T00:00:00.000","Maricopa","AZ","Passenger","6","7","13","1202","1215","1.069958847736625514403292181"
"2020-08-31T00:00:00.000","Pima","AZ","Passenger","3","1","4","305","309","1.294498381877022653721682848"
"2020-08-31T00:00:00.000","Pinal","AZ","Passenger","1","0","1","154","155","0.6451612903225806451612903226"
"2020-08-31T00:00:00.000","Alameda","CA","Passenger","2","0","2","254","256","0.7812500"
"2020-08-31T00:00:00.000","Contra Costa","CA","Passenger","3","3","6","339","345","1.739130434782608695652173913"
"2020-08-31T00:00:00.000","Fresno","CA","Passenger","1","0","1","172","173","0.5780346820809248554913294798"
"2020-08-31T00:00:00.000","Kern","CA","Passenger","1","1","2","219","221","0.9049773755656108597285067873"
"2020-08-31T00:00:00.000","Los Angeles","CA","Passenger","9","10","19","937","956","1.987447698744769874476987448"
"2020-08-31T00:00:00.000","Monterey","CA","Passenger","1","1","2","157","159","1.257861635220125786163522013"
"2020-08-31T00:00:00.000","Orange","CA","Passenger","5","2","7","467","474","1.476793248945147679324894515"
"2020-08-31T00:00:00.000","Placer","CA","Passenger","1","0","1","75","76","1.315789473684210526315789474"
"2020-08-31T00:00:00.000","Riverside","CA","Passenger","3","0","3","572","575","0.5217391304347826086956521739"
"2020-08-31T00:00:00.000","Sacramento","CA","Passenger","1","0","1","249","250","0.400"
"2020-08-31T00:00:00.000","San Bernardino","CA","Passenger","0","1","1","418","419","0.2386634844868735083532219570"
"2020-08-31T00:00:00.000","San Diego","CA","Passenger","15","6","21","2802","2823","0.7438894792773645058448459086"
"2020-08-31T00:00:00.000","San Francisco","CA","Passenger","2","1","3","81","84","3.571428571428571428571428571"
"2020-08-31T00:00:00.000","San Mateo","CA","Passenger","0","1","1","103","104","0.9615384615384615384615384615"
"2020-08-31T00:00:00.000","Santa Barbara","CA","Passenger","2","0","2","77","79","2.531645569620253164556962025"
"2020-08-31T00:00:00.000","Santa Clara","CA","Passenger","7","2","9","258","267","3.370786516853932584269662921"
"2020-08-31T00:00:00.000","Santa Cruz","CA","Passenger","1","0","1","32","33","3.030303030303030303030303030"
"2020-08-31T00:00:00.000","Shasta","CA","Passenger","1","0","1","35","36","2.777777777777777777777777778"
"2020-08-31T00:00:00.000","Solano","CA","Passenger","1","0","1","211","212","0.4716981132075471698113207547"
"2020-08-31T00:00:00.000","Ventura","CA","Passenger","1","2","3","280","283","1.060070671378091872791519435"
"2020-08-31T00:00:00.000","Arapahoe","CO","Passenger","1","0","1","125","126","0.7936507936507936507936507937"
"2020-08-31T00:00:00.000","Boulder","CO","Passenger","0","1","1","34","35","2.857142857142857142857142857"
"2020-08-31T00:00:00.000","Denver","CO","Passenger","1","0","1","106","107","0.9345794392523364485981308411"
"2020-08-31T00:00:00.000","El Paso","CO","Passenger","2","0","2","676","678","0.2949852507374631268436578171"
"2020-08-31T00:00:00.000","Jefferson","CO","Passenger","0","1","1","57","58","1.724137931034482758620689655"
"2020-08-31T00:00:00.000","Larimer","CO","Passenger","1","1","2","42","44","4.545454545454545454545454545"
"2020-08-31T00:00:00.000","New London","CT","Passenger","0","2","2","250","252","0.7936507936507936507936507937"
"2020-08-31T00:00:00.000","District of Columbia","DC","Passenger","2","3","5","198","203","2.463054187192118226600985222"
"2020-08-31T00:00:00.000","Kent","DE","Passenger","0","1","1","67","68","1.470588235294117647058823529"
"2020-08-31T00:00:00.000","New Castle","DE","Passenger","1","0","1","25","26","3.846153846153846153846153846"
"2020-08-31T00:00:00.000","Brevard","FL","Passenger","0","1","1","74","75","1.333333333333333333333333333"
"2020-08-31T00:00:00.000","Broward","FL","Passenger","2","1","3","103","106","2.830188679245283018867924528"
"2020-08-31T00:00:00.000","Clay","FL","Passenger","0","1","1","79","80","1.2500"
"2020-08-31T00:00:00.000","Duval","FL","Passenger","0","1","1","337","338","0.2958579881656804733727810651"
"2020-08-31T00:00:00.000","Lake","FL","Passenger","1","0","1","19","20","5.00"
"2020-08-31T00:00:00.000","Nassau","FL","Passenger","1","0","1","29","30","3.333333333333333333333333333"
"2020-08-31T00:00:00.000","Okaloosa","FL","Passenger","0","1","1","133","134","0.7462686567164179104477611940"
"2020-08-31T00:00:00.000","Palm Beach","FL","Passenger","0","1","1","68","69","1.449275362318840579710144928"
"2020-08-31T00:00:00.000","Pinellas","FL","Passenger","1","1","2","91","93","2.150537634408602150537634409"
"2020-08-31T00:00:00.000","Polk","FL","Passenger","1","0","1","62","63","1.587301587301587301587301587"
"2020-08-31T00:00:00.000","Sarasota","FL","Passenger","2","0","2","24","26","7.692307692307692307692307692"
"2020-08-31T00:00:00.000","St. Johns","FL","Passenger","0","1","1","47","48","2.083333333333333333333333333"
"2020-08-31T00:00:00.000","Sumter","FL","Passenger","0","1","1","10","11","9.090909090909090909090909091"
"2020-08-31T00:00:00.000","Bartow","GA","Passenger","0","1","1","3","4","25.00"
"2020-08-31T00:00:00.000","Bryan","GA","Passenger","1","0","1","50","51","1.960784313725490196078431373"
"2020-08-31T00:00:00.000","Camden","GA","Passenger","0","1","1","141","142","0.7042253521126760563380281690"
"2020-08-31T00:00:00.000","Columbia","GA","Passenger","1","1","2","132","134","1.492537313432835820895522388"
"2020-08-31T00:00:00.000","DeKalb","GA","Passenger","1","0","1","71","72","1.388888888888888888888888889"
"2020-08-31T00:00:00.000","Fulton","GA","Passenger","1","2","3","94","97","3.092783505154639175257731959"
"2020-08-31T00:00:00.000","Houston","GA","Passenger","1","0","1","52","53","1.886792452830188679245283019"
"2020-08-31T00:00:00.000","Jones","GA","Passenger","1","0","1","1","2","50.0"
"2020-08-31T00:00:00.000","Liberty","GA","Passenger","1","0","1","116","117","0.8547008547008547008547008547"
"2020-08-31T00:00:00.000","Honolulu","HI","Passenger","4","1","5","412","417","1.199040767386091127098321343"
"2020-08-31T00:00:00.000","Maui","HI","Passenger","1","0","1","27","28","3.571428571428571428571428571"
"2020-08-31T00:00:00.000","Ada","ID","Passenger","0","1","1","236","237","0.4219409282700421940928270042"
"2020-08-31T00:00:00.000","Kootenai","ID","Passenger","1","0","1","196","197","0.5076142131979695431472081218"
"2020-08-31T00:00:00.000","Twin Falls","ID","Passenger","0","1","1","18","19","5.263157894736842105263157895"
"2020-08-31T00:00:00.000","DuPage","IL","Passenger","3","0","3","52","55","5.454545454545454545454545455"
"2020-08-31T00:00:00.000","Lake","IL","Passenger","2","0","2","168","170","1.176470588235294117647058824"
"2020-08-31T00:00:00.000","Monroe","IL","Passenger","1","0","1","3","4","25.00"
"2020-08-31T00:00:00.000","St. Clair","IL","Passenger","1","0","1","141","142","0.7042253521126760563380281690"
"2020-08-31T00:00:00.000","DeKalb","IN","Passenger","1","0","1","1","2","50.0"
"2020-08-31T00:00:00.000","Hamilton","IN","Passenger","1","0","1","38","39","2.564102564102564102564102564"
"2020-08-31T00:00:00.000","Howard","IN","Passenger","0","1","1","3","4","25.00"
"2020-08-31T00:00:00.000","Vigo","IN","Passenger","1","0","1","4","5","20.0"
"2020-08-31T00:00:00.000","Sedgwick","KS","Passenger","1","0","1","87","88","1.136363636363636363636363636"
"2020-08-31T00:00:00.000","Oldham","KY","Passenger","0","1","1","4","5","20.0"
"2020-08-31T00:00:00.000","Middlesex","MA","Passenger","1","1","2","91","93","2.150537634408602150537634409"
"2020-08-31T00:00:00.000","Suffolk","MA","Passenger","0","2","2","39","41","4.878048780487804878048780488"
"2020-08-31T00:00:00.000","Anne Arundel","MD","Passenger","0","1","1","395","396","0.2525252525252525252525252525"
"2020-08-31T00:00:00.000","Calvert","MD","Passenger","0","2","2","85","87","2.298850574712643678160919540"
"2020-08-31T00:00:00.000","Carroll","MD","Passenger","0","1","1","16","17","5.882352941176470588235294118"
"2020-08-31T00:00:00.000","Charles","MD","Passenger","1","1","2","70","72","2.777777777777777777777777778"
"2020-08-31T00:00:00.000","Frederick","MD","Passenger","2","1","3","78","81","3.703703703703703703703703704"
"2020-08-31T00:00:00.000","Howard","MD","Passenger","0","1","1","68","69","1.449275362318840579710144928"
"2020-08-31T00:00:00.000","Montgomery","MD","Passenger","0","2","2","227","229","0.8733624454148471615720524017"
"2020-08-31T00:00:00.000","Prince George's","MD","Passenger","1","0","1","149","150","0.6666666666666666666666666667"
"2020-08-31T00:00:00.000","St. Mary's","MD","Passenger","1","0","1","198","199","0.5025125628140703517587939698"
"2020-08-31T00:00:00.000","Penobscot","ME","Passenger","0","1","1","15","16","6.2500"
"2020-08-31T00:00:00.000","Kent","MI","Passenger","0","1","1","22","23","4.347826086956521739130434783"
"2020-08-31T00:00:00.000","Saginaw","MI","Passenger","1","0","1","10","11","9.090909090909090909090909091"
"2020-08-31T00:00:00.000","Washtenaw","MI","Passenger","1","0","1","29","30","3.333333333333333333333333333"
"2020-08-31T00:00:00.000","Hennepin","MN","Passenger","2","0","2","79","81","2.469135802469135802469135802"
"2020-08-31T00:00:00.000","Kanabec","MN","Passenger","1","0","1","0","1","100"
"2020-08-31T00:00:00.000","Ramsey","MN","Passenger","1","0","1","35","36","2.777777777777777777777777778"
"2020-08-31T00:00:00.000","Boone","MO","Passenger","0","1","1","9","10","10.0"
"2020-08-31T00:00:00.000","Greene","MO","Passenger","0","1","1","26","27","3.703703703703703703703703704"
"2020-08-31T00:00:00.000","St. Louis","MO","Passenger","1","0","1","93","94","1.063829787234042553191489362"
"2020-08-31T00:00:00.000","Harrison","MS","Passenger","1","0","1","52","53","1.886792452830188679245283019"
"2020-08-31T00:00:00.000","Cascade","MT","Passenger","0","1","1","55","56","1.785714285714285714285714286"
"2020-08-31T00:00:00.000","Flathead","MT","Passenger","1","0","1","51","52","1.923076923076923076923076923"
"2020-08-31T00:00:00.000","Glacier","MT","Passenger","0","1","1","3","4","25.00"
"2020-08-31T00:00:00.000","Cumberland","NC","Passenger","0","3","3","463","466","0.6437768240343347639484978541"
"2020-08-31T00:00:00.000","Guilford","NC","Passenger","1","0","1","28","29","3.448275862068965517241379310"
"2020-08-31T00:00:00.000","Mecklenburg","NC","Passenger","1","0","1","70","71","1.408450704225352112676056338"
"2020-08-31T00:00:00.000","Moore","NC","Passenger","0","2","2","158","160","1.2500"
"2020-08-31T00:00:00.000","Williams","ND","Passenger","0","1","1","11","12","8.333333333333333333333333333"
"2020-08-31T00:00:00.000","Douglas","NE","Passenger","0","1","1","52","53","1.886792452830188679245283019"
"2020-08-31T00:00:00.000","Carroll","NH","Passenger","0","1","1","3","4","25.00"
"2020-08-31T00:00:00.000","Camden","NJ","Passenger","0","1","1","20","21","4.761904761904761904761904762"
"2020-08-31T00:00:00.000","Hudson","NJ","Passenger","1","0","1","138","139","0.7194244604316546762589928058"
"2020-08-31T00:00:00.000","Morris","NJ","Passenger","1","0","1","19","20","5.00"
"2020-08-31T00:00:00.000","Chaves","NM","Passenger","1","0","1","9","10","10.0"
"2020-08-31T00:00:00.000","Valencia","NM","Passenger","1","0","1","5","6","16.66666666666666666666666667"
"2020-08-31T00:00:00.000","Carson City","NV","Passenger","1","0","1","11","12","8.333333333333333333333333333"
"2020-08-31T00:00:00.000","Clark","NV","Passenger","2","4","6","646","652","0.9202453987730061349693251534"
"2020-08-31T00:00:00.000","Washoe","NV","Passenger","1","0","1","81","82","1.219512195121951219512195122"
"2020-08-31T00:00:00.000","Erie","NY","Passenger","1","0","1","39","40","2.500"
"2020-08-31T00:00:00.000","Jefferson","NY","Passenger","0","1","1","215","216","0.4629629629629629629629629630"
"2020-08-31T00:00:00.000","Kings","NY","Passenger","1","0","1","55","56","1.785714285714285714285714286"
"2020-08-31T00:00:00.000","Nassau","NY","Passenger","2","0","2","27","29","6.896551724137931034482758621"
"2020-08-31T00:00:00.000","New York","NY","Passenger","1","0","1","61","62","1.612903225806451612903225806"
"2020-08-31T00:00:00.000","Queens","NY","Passenger","1","0","1","48","49","2.040816326530612244897959184"
"2020-08-31T00:00:00.000","Westchester","NY","Passenger","0","1","1","22","23","4.347826086956521739130434783"
"2020-08-31T00:00:00.000","Montgomery","OH","Passenger","0","1","1","44","45","2.222222222222222222222222222"
"2020-08-31T00:00:00.000","Shelby","OH","Passenger","0","1","1","1","2","50.0"
"2020-08-31T00:00:00.000","Rogers","OK","Passenger","1","0","1","5","6","16.66666666666666666666666667"
"2020-08-31T00:00:00.000","Tulsa","OK","Passenger","1","1","2","39","41","4.878048780487804878048780488"
"2020-08-31T00:00:00.000","Clackamas","OR","Passenger","2","0","2","168","170","1.176470588235294117647058824"
"2020-08-31T00:00:00.000","Deschutes","OR","Passenger","1","0","1","119","120","0.8333333333333333333333333333"
"2020-08-31T00:00:00.000","Klamath","OR","Passenger","1","0","1","24","25","4.00"
"2020-08-31T00:00:00.000","Multnomah","OR","Passenger","4","5","9","659","668","1.347305389221556886227544910"
"2020-08-31T00:00:00.000","Washington","OR","Passenger","1","0","1","395","396","0.2525252525252525252525252525"
"2020-08-31T00:00:00.000","Allegheny","PA","Passenger","1","0","1","63","64","1.562500"
"2020-08-31T00:00:00.000","Bucks","PA","Passenger","1","0","1","21","22","4.545454545454545454545454545"
"2020-08-31T00:00:00.000","Montgomery","PA","Passenger","1","0","1","21","22","4.545454545454545454545454545"
"2020-08-31T00:00:00.000","RÃ­o Grande","PR","Passenger","1","0","1","1","2","50.0"
"2020-08-31T00:00:00.000","Newport","RI","Passenger","1","0","1","82","83","1.204819277108433734939759036"
"2020-08-31T00:00:00.000","Charleston","SC","Passenger","1","0","1","95","96","1.041666666666666666666666667"
"2020-08-31T00:00:00.000","Richland","SC","Passenger","0","1","1","147","148","0.6756756756756756756756756757"
"2020-08-31T00:00:00.000","Spartanburg","SC","Passenger","0","1","1","38","39","2.564102564102564102564102564"
"2020-08-31T00:00:00.000","Bradley","TN","Passenger","1","0","1","1","2","50.0"
"2020-08-31T00:00:00.000","Davidson","TN","Passenger","1","0","1","56","57","1.754385964912280701754385965"
"2020-08-31T00:00:00.000","Putnam","TN","Passenger","0","1","1","2","3","33.33333333333333333333333333"
"2020-08-31T00:00:00.000","Shelby","TN","Passenger","0","1","1","85","86","1.162790697674418604651162791"
"2020-08-31T00:00:00.000","Tipton","TN","Passenger","1","0","1","14","15","6.666666666666666666666666667"
"2020-08-31T00:00:00.000","Bell","TX","Passenger","0","1","1","393","394","0.2538071065989847715736040609"
"2020-08-31T00:00:00.000","Bexar","TX","Passenger","6","5","11","553","564","1.950354609929078014184397163"
"2020-08-31T00:00:00.000","Dallas","TX","Passenger","1","0","1","176","177","0.5649717514124293785310734463"
"2020-08-31T00:00:00.000","Denton","TX","Passenger","1","0","1","74","75","1.333333333333333333333333333"
"2020-08-31T00:00:00.000","El Paso","TX","Passenger","2","0","2","405","407","0.4914004914004914004914004914"
"2020-08-31T00:00:00.000","Guadalupe","TX","Passenger","1","0","1","53","54","1.851851851851851851851851852"
"2020-08-31T00:00:00.000","Harris","TX","Passenger","1","0","1","212","213","0.4694835680751173708920187793"
"2020-08-31T00:00:00.000","Hidalgo","TX","Passenger","0","1","1","60","61","1.639344262295081967213114754"
"2020-08-31T00:00:00.000","Montgomery","TX","Passenger","1","0","1","40","41","2.439024390243902439024390244"
"2020-08-31T00:00:00.000","Nueces","TX","Passenger","1","0","1","80","81","1.234567901234567901234567901"
"2020-08-31T00:00:00.000","Travis","TX","Passenger","2","2","4","158","162","2.469135802469135802469135802"
"2020-08-31T00:00:00.000","Salt Lake","UT","Passenger","0","2","2","168","170","1.176470588235294117647058824"
"2020-08-31T00:00:00.000","Utah","UT","Passenger","0","1","1","120","121","0.8264462809917355371900826446"
"2020-08-31T00:00:00.000","Albemarle","VA","Passenger","1","0","1","20","21","4.761904761904761904761904762"
"2020-08-31T00:00:00.000","Alexandria","VA","Passenger","4","0","4","136","140","2.857142857142857142857142857"
"2020-08-31T00:00:00.000","Arlington","VA","Passenger","0","2","2","141","143","1.398601398601398601398601399"
"2020-08-31T00:00:00.000","Chesapeake","VA","Passenger","0","2","2","418","420","0.4761904761904761904761904762"
"2020-08-31T00:00:00.000","Fairfax","VA","Passenger","4","4","8","730","738","1.084010840108401084010840108"
"2020-08-31T00:00:00.000","Goochland","VA","Passenger","3","1","4","216","220","1.818181818181818181818181818"
"2020-08-31T00:00:00.000","Loudoun","VA","Passenger","1","0","1","77","78","1.282051282051282051282051282"
"2020-08-31T00:00:00.000","Manassas","VA","Passenger","0","1","1","4","5","20.0"
"2020-08-31T00:00:00.000","Norfolk","VA","Passenger","1","1","2","344","346","0.5780346820809248554913294798"
"2020-08-31T00:00:00.000","Portsmouth","VA","Passenger","0","1","1","64","65","1.538461538461538461538461538"
"2020-08-31T00:00:00.000","Powhatan","VA","Passenger","1","0","1","0","1","100"
"2020-08-31T00:00:00.000","Prince William","VA","Passenger","2","2","4","217","221","1.809954751131221719457013575"
"2020-08-31T00:00:00.000","Stafford","VA","Passenger","1","1","2","90","92","2.173913043478260869565217391"
"2020-08-31T00:00:00.000","Suffolk","VA","Passenger","1","0","1","111","112","0.8928571428571428571428571429"
"2020-08-31T00:00:00.000","Virginia Beach","VA","Passenger","1","0","1","629","630","0.1587301587301587301587301587"
"2020-08-31T00:00:00.000","Adams","WA","Passenger","9","8","17","12870","12887","0.1319158842244121983394118104"
"2020-08-31T00:00:00.000","Adams","WA","Truck","0","0","0","5303","5303","0"
"2020-08-31T00:00:00.000","Asotin","WA","Truck","0","0","0","6674","6674","0"
"2020-08-31T00:00:00.000","Asotin","WA","Passenger","18","15","33","12365","12398","0.2661719632198741732537506049"
"2020-08-31T00:00:00.000","Benton","WA","Passenger","391","332","723","134357","135080","0.5352383772579212318625999408"
"2020-08-31T00:00:00.000","Benton","WA","Truck","0","0","0","43026","43026","0"
"2020-08-31T00:00:00.000","Chelan","WA","Passenger","251","80","331","54189","54520","0.6071166544387380777696258254"
"2020-08-31T00:00:00.000","Chelan","WA","Truck","0","0","0","22683","22683","0"
"2020-08-31T00:00:00.000","Clallam","WA","Truck","1","0","1","21710","21711","0.004605960112385426742204412510"
"2020-08-31T00:00:00.000","Clallam","WA","Passenger","250","175","425","49944","50369","0.8437729555877623141217812543"
"2020-08-31T00:00:00.000","Clark","WA","Passenger","2235","1118","3353","318217","321570","1.042696768977205585098112386"
"2020-08-31T00:00:00.000","Clark","WA","Truck","0","0","0","82734","82734","0"
"2020-08-31T00:00:00.000","Columbia","WA","Truck","0","0","0","1527","1527","0"
"2020-08-31T00:00:00.000","Columbia","WA","Passenger","3","3","6","2423","2429","0.2470152326060107039934129271"
"2020-08-31T00:00:00.000","Cowlitz","WA","Truck","0","0","0","28922","28922","0"
"2020-08-31T00:00:00.000","Cowlitz","WA","Passenger","162","133","295","72126","72421","0.4073404123113461565015672250"
"2020-08-31T00:00:00.000","Douglas","WA","Passenger","78","42","120","28020","28140","0.4264392324093816631130063966"
"2020-08-31T00:00:00.000","Douglas","WA","Truck","0","0","0","12341","12341","0"
"2020-08-31T00:00:00.000","Ferry","WA","Passenger","7","3","10","4311","4321","0.2314279102059708400833140477"
"2020-08-31T00:00:00.000","Ferry","WA","Truck","0","0","0","3579","3579","0"
"2020-08-31T00:00:00.000","Franklin","WA","Truck","0","0","0","20190","20190","0"
"2020-08-31T00:00:00.000","Franklin","WA","Passenger","72","82","154","60800","60954","0.2526495389966204022705646881"
"2020-08-31T00:00:00.000","Garfield","WA","Passenger","0","1","1","1353","1354","0.07385524372230428360413589365"
"2020-08-31T00:00:00.000","Garfield","WA","Truck","0","0","0","994","994","0"
"2020-08-31T00:00:00.000","Grant","WA","Passenger","69","79","148","65413","65561","0.2257439636369182898369457452"
"2020-08-31T00:00:00.000","Grant","WA","Truck","0","0","0","27246","27246","0"
"2020-08-31T00:00:00.000","Grays Harbor","WA","Truck","0","0","0","21033","21033","0"
"2020-08-31T00:00:00.000","Grays Harbor","WA","Passenger","128","123","251","48346","48597","0.5164927876206350186225487170"
"2020-08-31T00:00:00.000","Island","WA","Passenger","448","291","739","62899","63638","1.161255853420912033690562243"
"2020-08-31T00:00:00.000","Island","WA","Truck","1","0","1","21253","21254","0.004704996706502305448386186130"
"2020-08-31T00:00:00.000","Jefferson","WA","Truck","0","0","0","9544","9544","0"
"2020-08-31T00:00:00.000","Jefferson","WA","Passenger","259","155","414","24644","25058","1.652166972623513448798786815"
"2020-08-31T00:00:00.000","King","WA","Passenger","25569","8144","33713","1371037","1404750","2.399928812956042000355935220"
"2020-08-31T00:00:00.000","King","WA","Truck","5","1","6","183395","183401","0.003271519784515896859886260162"
"2020-08-31T00:00:00.000","Kitsap","WA","Passenger","1473","734","2207","179740","181947","1.212990596162618784591117193"
"2020-08-31T00:00:00.000","Kitsap","WA","Truck","0","0","0","54229","54229","0"
"2020-08-31T00:00:00.000","Kittitas","WA","Truck","0","0","0","14562","14562","0"
"2020-08-31T00:00:00.000","Kittitas","WA","Passenger","114","49","163","29771","29934","0.5445313021981693058061067682"
"2020-08-31T00:00:00.000","Klickitat","WA","Truck","0","0","0","8107","8107","0"
"2020-08-31T00:00:00.000","Klickitat","WA","Passenger","59","43","102","15048","15150","0.6732673267326732673267326733"
"2020-08-31T00:00:00.000","Lewis","WA","Passenger","122","124","246","58180","58426","0.4210454249820285489336939034"
"2020-08-31T00:00:00.000","Lewis","WA","Truck","0","0","0","26368","26368","0"
"2020-08-31T00:00:00.000","Lincoln","WA","Truck","0","0","0","4651","4651","0"
"2020-08-31T00:00:00.000","Lincoln","WA","Passenger","6","11","17","7630","7647","0.2223094023800183078331371780"
"2020-08-31T00:00:00.000","Mason","WA","Passenger","185","142","327","47396","47723","0.6852041992330741990235316305"
"2020-08-31T00:00:00.000","Mason","WA","Truck","0","0","0","20784","20784","0"
"2020-08-31T00:00:00.000","Okanogan","WA","Truck","0","0","0","16550","16550","0"
"2020-08-31T00:00:00.000","Okanogan","WA","Passenger","41","35","76","25982","26058","0.2916570726840125873052421521"
"2020-08-31T00:00:00.000","Pacific","WA","Truck","0","0","0","7727","7727","0"
"2020-08-31T00:00:00.000","Pacific","WA","Passenger","42","37","79","15696","15775","0.5007923930269413629160063391"
"2020-08-31T00:00:00.000","Pend Oreille","WA","Truck","0","0","0","5746","5746","0"
"2020-08-31T00:00:00.000","Pend Oreille","WA","Passenger","8","5","13","9230","9243","0.1406469760900140646976090014"
"2020-08-31T00:00:00.000","Pierce","WA","Passenger","2734","1815","4549","552682","557231","0.8163580274607837683115260996"
"2020-08-31T00:00:00.000","Pierce","WA","Truck","0","0","0","143498","143498","0"
"2020-08-31T00:00:00.000","San Juan","WA","Truck","0","0","0","5838","5838","0"
"2020-08-31T00:00:00.000","San Juan","WA","Passenger","322","101","423","13928","14351","2.947529788864887464288202913"
"2020-08-31T00:00:00.000","Skagit","WA","Passenger","459","244","703","91248","91951","0.7645376341747234940348663962"
"2020-08-31T00:00:00.000","Skagit","WA","Truck","1","0","1","32647","32648","0.003062974761087968635138446459"
"2020-08-31T00:00:00.000","Skamania","WA","Truck","0","0","0","4025","4025","0"
"2020-08-31T00:00:00.000","Skamania","WA","Passenger","35","22","57","8374","8431","0.6760763847704898588542284427"
"2020-08-31T00:00:00.000","Snohomish","WA","Passenger","4792","1882","6674","536113","542787","1.229579927301132856903352512"
"2020-08-31T00:00:00.000","Snohomish","WA","Truck","0","0","0","124635","124635","0"
"2020-08-31T00:00:00.000","Spokane","WA","Passenger","818","539","1357","317602","318959","0.4254465307453309045990236990"
"2020-08-31T00:00:00.000","Spokane","WA","Truck","1","0","1","99504","99505","0.001004974624390734133963117431"
"2020-08-31T00:00:00.000","Stevens","WA","Passenger","38","38","76","30492","30568","0.2486260141324260664747448312"
"2020-08-31T00:00:00.000","Stevens","WA","Truck","0","0","0","18654","18654","0"
"2020-08-31T00:00:00.000","Thurston","WA","Truck","0","0","0","56022","56022","0"
"2020-08-31T00:00:00.000","Thurston","WA","Passenger","1277","804","2081","197216","199297","1.044170258458481562692865422"
"2020-08-31T00:00:00.000","Wahkiakum","WA","Passenger","6","7","13","3029","3042","0.4273504273504273504273504274"
"2020-08-31T00:00:00.000","Wahkiakum","WA","Truck","0","0","0","1745","1745","0"
"2020-08-31T00:00:00.000","Walla Walla","WA","Passenger","82","67","149","35909","36058","0.4132231404958677685950413223"
"2020-08-31T00:00:00.000","Walla Walla","WA","Truck","0","0","0","13758","13758","0"
"2020-08-31T00:00:00.000","Whatcom","WA","Truck","3","0","3","43289","43292","0.006929686778157627275247158828"
"2020-08-31T00:00:00.000","Whatcom","WA","Passenger","1167","535","1702","149202","150904","1.127869373906589619890791497"
"2020-08-31T00:00:00.000","Whitman","WA","Passenger","48","51","99","22046","22145","0.4470535109505531722736509370"
"2020-08-31T00:00:00.000","Whitman","WA","Truck","0","0","0","8484","8484","0"
"2020-08-31T00:00:00.000","Yakima","WA","Passenger","161","131","292","166161","166453","0.1754248947150246616161919581"
"2020-08-31T00:00:00.000","Yakima","WA","Truck","0","0","0","60436","60436","0"
"2020-08-31T00:00:00.000","Ozaukee","WI","Passenger","0","1","1","3","4","25.00"
"2020-08-31T00:00:00.000",,,"Passenger","2","0","2","194","196","1.020408163265306122448979592"
"2020-09-30T00:00:00.000","Fairbanks North Star","AK","Passenger","0","1","1","93","94","1.063829787234042553191489362"
"2020-09-30T00:00:00.000","Juneau","AK","Passenger","0","1","1","27","28","3.571428571428571428571428571"
"2020-09-30T00:00:00.000","Montgomery","AL","Passenger","0","1","1","36","37","2.702702702702702702702702703"
"2020-09-30T00:00:00.000","Maricopa","AZ","Passenger","6","7","13","1187","1200","1.083333333333333333333333333"
"2020-09-30T00:00:00.000","Pima","AZ","Passenger","3","1","4","303","307","1.302931596091205211726384365"
"2020-09-30T00:00:00.000","Alameda","CA","Passenger","2","0","2","250","252","0.7936507936507936507936507937"
"2020-09-30T00:00:00.000","Contra Costa","CA","Passenger","3","3","6","334","340","1.764705882352941176470588235"
"2020-09-30T00:00:00.000","El Dorado","CA","Passenger","1","0","1","32","33","3.030303030303030303030303030"
"2020-09-30T00:00:00.000","Fresno","CA","Passenger","1","0","1","173","174","0.5747126436781609195402298851"
"2020-09-30T00:00:00.000","Kern","CA","Passenger","1","1","2","221","223","0.8968609865470852017937219731"
"2020-09-30T00:00:00.000","Los Angeles","CA","Passenger","10","10","20","931","951","2.103049421661409043112513144"
"2020-09-30T00:00:00.000","Monterey","CA","Passenger","1","1","2","153","155","1.290322580645161290322580645"
"2020-09-30T00:00:00.000","Orange","CA","Passenger","4","3","7","455","462","1.515151515151515151515151515"
"2020-09-30T00:00:00.000","Placer","CA","Passenger","1","0","1","76","77","1.298701298701298701298701299"
"2020-09-30T00:00:00.000","Riverside","CA","Passenger","3","0","3","569","572","0.5244755244755244755244755245"
"2020-09-30T00:00:00.000","Sacramento","CA","Passenger","1","0","1","244","245","0.4081632653061224489795918367"
"2020-09-30T00:00:00.000","San Bernardino","CA","Passenger","0","1","1","415","416","0.2403846153846153846153846154"
"2020-09-30T00:00:00.000","San Diego","CA","Passenger","15","6","21","2783","2804","0.7489300998573466476462196862"
"2020-09-30T00:00:00.000","San Francisco","CA","Passenger","2","1","3","80","83","3.614457831325301204819277108"
"2020-09-30T00:00:00.000","San Mateo","CA","Passenger","0","1","1","103","104","0.9615384615384615384615384615"
"2020-09-30T00:00:00.000","Santa Barbara","CA","Passenger","2","0","2","78","80","2.500"
"2020-09-30T00:00:00.000","Santa Clara","CA","Passenger","6","2","8","258","266","3.007518796992481203007518797"
"2020-09-30T00:00:00.000","Santa Cruz","CA","Passenger","1","0","1","31","32","3.12500"
"2020-09-30T00:00:00.000","Solano","CA","Passenger","1","0","1","209","210","0.4761904761904761904761904762"
"2020-09-30T00:00:00.000","Ventura","CA","Passenger","1","2","3","274","277","1.083032490974729241877256318"
"2020-09-30T00:00:00.000","Arapahoe","CO","Passenger","1","0","1","125","126","0.7936507936507936507936507937"
"2020-09-30T00:00:00.000","Boulder","CO","Passenger","0","1","1","35","36","2.777777777777777777777777778"
"2020-09-30T00:00:00.000","Denver","CO","Passenger","1","0","1","105","106","0.9433962264150943396226415094"
"2020-09-30T00:00:00.000","El Paso","CO","Passenger","2","0","2","677","679","0.2945508100147275405007363770"
"2020-09-30T00:00:00.000","Jefferson","CO","Passenger","0","1","1","56","57","1.754385964912280701754385965"
"2020-09-30T00:00:00.000","Larimer","CO","Passenger","1","1","2","44","46","4.347826086956521739130434783"
"2020-09-30T00:00:00.000","New London","CT","Passenger","0","2","2","248","250","0.800"
"2020-09-30T00:00:00.000","District of Columbia","DC","Passenger","2","3","5","199","204","2.450980392156862745098039216"
"2020-09-30T00:00:00.000","Kent","DE","Passenger","0","1","1","67","68","1.470588235294117647058823529"
"2020-09-30T00:00:00.000","New Castle","DE","Passenger","1","0","1","25","26","3.846153846153846153846153846"
"2020-09-30T00:00:00.000","Brevard","FL","Passenger","0","1","1","74","75","1.333333333333333333333333333"
"2020-09-30T00:00:00.000","Broward","FL","Passenger","1","1","2","103","105","1.904761904761904761904761905"
"2020-09-30T00:00:00.000","Duval","FL","Passenger","0","1","1","338","339","0.2949852507374631268436578171"
"2020-09-30T00:00:00.000","Lake","FL","Passenger","1","0","1","20","21","4.761904761904761904761904762"
"2020-09-30T00:00:00.000","Nassau","FL","Passenger","1","0","1","29","30","3.333333333333333333333333333"
"2020-09-30T00:00:00.000","Okaloosa","FL","Passenger","0","1","1","134","135","0.7407407407407407407407407407"
"2020-09-30T00:00:00.000","Palm Beach","FL","Passenger","0","1","1","67","68","1.470588235294117647058823529"
"2020-09-30T00:00:00.000","Pinellas","FL","Passenger","1","1","2","90","92","2.173913043478260869565217391"
"2020-09-30T00:00:00.000","Polk","FL","Passenger","1","0","1","61","62","1.612903225806451612903225806"
"2020-09-30T00:00:00.000","Sarasota","FL","Passenger","2","0","2","25","27","7.407407407407407407407407407"
"2020-09-30T00:00:00.000","St. Johns","FL","Passenger","0","1","1","48","49","2.040816326530612244897959184"
"2020-09-30T00:00:00.000","Sumter","FL","Passenger","0","1","1","11","12","8.333333333333333333333333333"
"2020-09-30T00:00:00.000","Bartow","GA","Passenger","0","1","1","3","4","25.00"
"2020-09-30T00:00:00.000","Bryan","GA","Passenger","1","0","1","51","52","1.923076923076923076923076923"
"2020-09-30T00:00:00.000","Camden","GA","Passenger","0","1","1","139","140","0.7142857142857142857142857143"
"2020-09-30T00:00:00.000","Columbia","GA","Passenger","1","1","2","130","132","1.515151515151515151515151515"
"2020-09-30T00:00:00.000","DeKalb","GA","Passenger","1","0","1","71","72","1.388888888888888888888888889"
"2020-09-30T00:00:00.000","Fulton","GA","Passenger","1","2","3","88","91","3.296703296703296703296703297"
"2020-09-30T00:00:00.000","Houston","GA","Passenger","1","0","1","52","53","1.886792452830188679245283019"
"2020-09-30T00:00:00.000","Jones","GA","Passenger","1","0","1","1","2","50.0"
"2020-09-30T00:00:00.000","Liberty","GA","Passenger","1","0","1","113","114","0.8771929824561403508771929825"
"2020-09-30T00:00:00.000","Honolulu","HI","Passenger","5","1","6","406","412","1.456310679611650485436893204"
"2020-09-30T00:00:00.000","Maui","HI","Passenger","1","0","1","26","27","3.703703703703703703703703704"
"2020-09-30T00:00:00.000","Ada","ID","Passenger","0","1","1","230","231","0.4329004329004329004329004329"
"2020-09-30T00:00:00.000","Kootenai","ID","Passenger","1","0","1","201","202","0.4950495049504950495049504950"
"2020-09-30T00:00:00.000","Twin Falls","ID","Passenger","0","1","1","18","19","5.263157894736842105263157895"
"2020-09-30T00:00:00.000","DuPage","IL","Passenger","3","0","3","50","53","5.660377358490566037735849057"
"2020-09-30T00:00:00.000","Lake","IL","Passenger","2","0","2","170","172","1.162790697674418604651162791"
"2020-09-30T00:00:00.000","Monroe","IL","Passenger","1","0","1","2","3","33.33333333333333333333333333"
"2020-09-30T00:00:00.000","St. Clair","IL","Passenger","1","0","1","137","138","0.7246376811594202898550724638"
"2020-09-30T00:00:00.000","DeKalb","IN","Passenger","1","0","1","1","2","50.0"
"2020-09-30T00:00:00.000","Hamilton","IN","Passenger","1","0","1","36","37","2.702702702702702702702702703"
"2020-09-30T00:00:00.000","Howard","IN","Passenger","0","1","1","3","4","25.00"
"2020-09-30T00:00:00.000","Vigo","IN","Passenger","1","0","1","5","6","16.66666666666666666666666667"
"2020-09-30T00:00:00.000","Leavenworth","KS","Passenger","0","1","1","121","122","0.8196721311475409836065573770"
"2020-09-30T00:00:00.000","Sedgwick","KS","Passenger","1","0","1","89","90","1.111111111111111111111111111"
"2020-09-30T00:00:00.000","Oldham","KY","Passenger","0","1","1","4","5","20.0"
"2020-09-30T00:00:00.000","Plaquemines","LA","Passenger","0","1","1","14","15","6.666666666666666666666666667"
"2020-09-30T00:00:00.000","Middlesex","MA","Passenger","1","1","2","90","92","2.173913043478260869565217391"
"2020-09-30T00:00:00.000","Suffolk","MA","Passenger","0","2","2","38","40","5.00"
"2020-09-30T00:00:00.000","Anne Arundel","MD","Passenger","1","1","2","395","397","0.5037783375314861460957178841"
"2020-09-30T00:00:00.000","Calvert","MD","Passenger","0","2","2","83","85","2.352941176470588235294117647"
"2020-09-30T00:00:00.000","Carroll","MD","Passenger","0","1","1","17","18","5.555555555555555555555555556"
"2020-09-30T00:00:00.000","Charles","MD","Passenger","1","1","2","70","72","2.777777777777777777777777778"
"2020-09-30T00:00:00.000","Frederick","MD","Passenger","2","1","3","76","79","3.797468354430379746835443038"
"2020-09-30T00:00:00.000","Howard","MD","Passenger","0","1","1","62","63","1.587301587301587301587301587"
"2020-09-30T00:00:00.000","Montgomery","MD","Passenger","0","2","2","227","229","0.8733624454148471615720524017"
"2020-09-30T00:00:00.000","Prince George's","MD","Passenger","1","0","1","144","145","0.6896551724137931034482758621"
"2020-09-30T00:00:00.000","St. Mary's","MD","Passenger","1","0","1","198","199","0.5025125628140703517587939698"
"2020-09-30T00:00:00.000","Penobscot","ME","Passenger","0","1","1","13","14","7.142857142857142857142857143"
"2020-09-30T00:00:00.000","Kent","MI","Passenger","0","1","1","21","22","4.545454545454545454545454545"
"2020-09-30T00:00:00.000","Saginaw","MI","Passenger","1","0","1","10","11","9.090909090909090909090909091"
"2020-09-30T00:00:00.000","Washtenaw","MI","Passenger","1","0","1","28","29","3.448275862068965517241379310"
"2020-09-30T00:00:00.000","Hennepin","MN","Passenger","1","0","1","75","76","1.315789473684210526315789474"
"2020-09-30T00:00:00.000","Kanabec","MN","Passenger","1","0","1","0","1","100"
"2020-09-30T00:00:00.000","Ramsey","MN","Passenger","1","0","1","33","34","2.941176470588235294117647059"
"2020-09-30T00:00:00.000","Boone","MO","Passenger","0","1","1","9","10","10.0"
"2020-09-30T00:00:00.000","Greene","MO","Passenger","0","1","1","25","26","3.846153846153846153846153846"
"2020-09-30T00:00:00.000","St. Louis","MO","Passenger","1","0","1","93","94","1.063829787234042553191489362"
"2020-09-30T00:00:00.000","Harrison","MS","Passenger","1","0","1","51","52","1.923076923076923076923076923"
"2020-09-30T00:00:00.000","Cascade","MT","Passenger","0","1","1","55","56","1.785714285714285714285714286"
"2020-09-30T00:00:00.000","Flathead","MT","Passenger","1","0","1","52","53","1.886792452830188679245283019"
"2020-09-30T00:00:00.000","Glacier","MT","Passenger","0","1","1","3","4","25.00"
"2020-09-30T00:00:00.000","Cumberland","NC","Passenger","0","3","3","463","466","0.6437768240343347639484978541"
"2020-09-30T00:00:00.000","Guilford","NC","Passenger","1","0","1","28","29","3.448275862068965517241379310"
"2020-09-30T00:00:00.000","Mecklenburg","NC","Passenger","1","0","1","71","72","1.388888888888888888888888889"
"2020-09-30T00:00:00.000","Moore","NC","Passenger","0","1","1","160","161","0.6211180124223602484472049689"
"2020-09-30T00:00:00.000","Williams","ND","Passenger","0","1","1","11","12","8.333333333333333333333333333"
"2020-09-30T00:00:00.000","Douglas","NE","Passenger","0","1","1","51","52","1.923076923076923076923076923"
"2020-09-30T00:00:00.000","Carroll","NH","Passenger","0","1","1","3","4","25.00"
"2020-09-30T00:00:00.000","Camden","NJ","Passenger","0","1","1","20","21","4.761904761904761904761904762"
"2020-09-30T00:00:00.000","Hudson","NJ","Passenger","1","0","1","138","139","0.7194244604316546762589928058"
"2020-09-30T00:00:00.000","Morris","NJ","Passenger","1","0","1","19","20","5.00"
"2020-09-30T00:00:00.000","Chaves","NM","Passenger","1","0","1","9","10","10.0"
"2020-09-30T00:00:00.000","Carson City","NV","Passenger","1","0","1","11","12","8.333333333333333333333333333"
"2020-09-30T00:00:00.000","Clark","NV","Passenger","2","4","6","643","649","0.9244992295839753466872110940"
"2020-09-30T00:00:00.000","Washoe","NV","Passenger","1","0","1","80","81","1.234567901234567901234567901"
"2020-09-30T00:00:00.000","Erie","NY","Passenger","1","0","1","40","41","2.439024390243902439024390244"
"2020-09-30T00:00:00.000","Jefferson","NY","Passenger","0","1","1","214","215","0.4651162790697674418604651163"
"2020-09-30T00:00:00.000","Kings","NY","Passenger","1","0","1","57","58","1.724137931034482758620689655"
"2020-09-30T00:00:00.000","Nassau","NY","Passenger","2","0","2","26","28","7.142857142857142857142857143"
"2020-09-30T00:00:00.000","New York","NY","Passenger","1","0","1","60","61","1.639344262295081967213114754"
"2020-09-30T00:00:00.000","Queens","NY","Passenger","1","0","1","51","52","1.923076923076923076923076923"
"2020-09-30T00:00:00.000","Westchester","NY","Passenger","0","1","1","22","23","4.347826086956521739130434783"
"2020-09-30T00:00:00.000","Montgomery","OH","Passenger","0","1","1","43","44","2.272727272727272727272727273"
"2020-09-30T00:00:00.000","Shelby","OH","Passenger","0","1","1","1","2","50.0"
"2020-09-30T00:00:00.000","Rogers","OK","Passenger","1","0","1","5","6","16.66666666666666666666666667"
"2020-09-30T00:00:00.000","Tulsa","OK","Passenger","1","1","2","37","39","5.128205128205128205128205128"
"2020-09-30T00:00:00.000","Clackamas","OR","Passenger","2","0","2","167","169","1.183431952662721893491124260"
"2020-09-30T00:00:00.000","Deschutes","OR","Passenger","1","0","1","116","117","0.8547008547008547008547008547"
"2020-09-30T00:00:00.000","Klamath","OR","Passenger","1","0","1","24","25","4.00"
"2020-09-30T00:00:00.000","Multnomah","OR","Passenger","4","5","9","652","661","1.361573373676248108925869894"
"2020-09-30T00:00:00.000","Washington","OR","Passenger","1","0","1","387","388","0.2577319587628865979381443299"
"2020-09-30T00:00:00.000","Allegheny","PA","Passenger","1","0","1","60","61","1.639344262295081967213114754"
"2020-09-30T00:00:00.000","Bucks","PA","Passenger","1","0","1","20","21","4.761904761904761904761904762"
"2020-09-30T00:00:00.000","Montgomery","PA","Passenger","1","0","1","21","22","4.545454545454545454545454545"
"2020-09-30T00:00:00.000","RÃ­o Grande","PR","Passenger","1","0","1","1","2","50.0"
"2020-09-30T00:00:00.000","Newport","RI","Passenger","1","0","1","83","84","1.190476190476190476190476190"
"2020-09-30T00:00:00.000","Charleston","SC","Passenger","1","0","1","91","92","1.086956521739130434782608696"
"2020-09-30T00:00:00.000","Richland","SC","Passenger","0","1","1","144","145","0.6896551724137931034482758621"
"2020-09-30T00:00:00.000","Spartanburg","SC","Passenger","0","1","1","38","39","2.564102564102564102564102564"
"2020-09-30T00:00:00.000","Bradley","TN","Passenger","1","0","1","1","2","50.0"
"2020-09-30T00:00:00.000","Davidson","TN","Passenger","1","0","1","52","53","1.886792452830188679245283019"
"2020-09-30T00:00:00.000","Putnam","TN","Passenger","0","1","1","1","2","50.0"
"2020-09-30T00:00:00.000","Shelby","TN","Passenger","0","1","1","80","81","1.234567901234567901234567901"
"2020-09-30T00:00:00.000","Tipton","TN","Passenger","1","0","1","14","15","6.666666666666666666666666667"
"2020-09-30T00:00:00.000","Bell","TX","Passenger","0","1","1","383","384","0.2604166666666666666666666667"
"2020-09-30T00:00:00.000","Bexar","TX","Passenger","6","5","11","545","556","1.978417266187050359712230216"
"2020-09-30T00:00:00.000","Dallas","TX","Passenger","1","0","1","170","171","0.5847953216374269005847953216"
"2020-09-30T00:00:00.000","Denton","TX","Passenger","1","0","1","71","72","1.388888888888888888888888889"
"2020-09-30T00:00:00.000","El Paso","TX","Passenger","2","0","2","406","408","0.4901960784313725490196078431"
"2020-09-30T00:00:00.000","Harris","TX","Passenger","1","0","1","217","218","0.4587155963302752293577981651"
"2020-09-30T00:00:00.000","Hidalgo","TX","Passenger","0","1","1","62","63","1.587301587301587301587301587"
"2020-09-30T00:00:00.000","Montgomery","TX","Passenger","1","0","1","38","39","2.564102564102564102564102564"
"2020-09-30T00:00:00.000","Nueces","TX","Passenger","1","0","1","81","82","1.219512195121951219512195122"
"2020-09-30T00:00:00.000","Travis","TX","Passenger","2","2","4","156","160","2.500"
"2020-09-30T00:00:00.000","Salt Lake","UT","Passenger","0","2","2","160","162","1.234567901234567901234567901"
"2020-09-30T00:00:00.000","Utah","UT","Passenger","0","1","1","121","122","0.8196721311475409836065573770"
"2020-09-30T00:00:00.000","Albemarle","VA","Passenger","1","0","1","19","20","5.00"
"2020-09-30T00:00:00.000","Alexandria","VA","Passenger","4","0","4","137","141","2.836879432624113475177304965"
"2020-09-30T00:00:00.000","Arlington","VA","Passenger","0","2","2","139","141","1.418439716312056737588652482"
"2020-09-30T00:00:00.000","Chesapeake","VA","Passenger","0","3","3","416","419","0.7159904534606205250596658711"
"2020-09-30T00:00:00.000","Fairfax","VA","Passenger","4","4","8","719","727","1.100412654745529573590096286"
"2020-09-30T00:00:00.000","Goochland","VA","Passenger","3","1","4","212","216","1.851851851851851851851851852"
"2020-09-30T00:00:00.000","Loudoun","VA","Passenger","1","0","1","77","78","1.282051282051282051282051282"
"2020-09-30T00:00:00.000","Manassas","VA","Passenger","0","1","1","4","5","20.0"
"2020-09-30T00:00:00.000","Norfolk","VA","Passenger","1","1","2","344","346","0.5780346820809248554913294798"
"2020-09-30T00:00:00.000","Portsmouth","VA","Passenger","0","1","1","63","64","1.562500"
"2020-09-30T00:00:00.000","Powhatan","VA","Passenger","1","0","1","0","1","100"
"2020-09-30T00:00:00.000","Prince William","VA","Passenger","2","2","4","214","218","1.834862385321100917431192661"
"2020-09-30T00:00:00.000","Stafford","VA","Passenger","1","1","2","92","94","2.127659574468085106382978723"
"2020-09-30T00:00:00.000","Suffolk","VA","Passenger","1","0","1","111","112","0.8928571428571428571428571429"
"2020-09-30T00:00:00.000","Virginia Beach","VA","Passenger","1","0","1","627","628","0.1592356687898089171974522293"
"2020-09-30T00:00:00.000","Adams","WA","Passenger","8","8","16","12921","12937","0.1236762773440519440364845018"
"2020-09-30T00:00:00.000","Adams","WA","Truck","0","0","0","5310","5310","0"
"2020-09-30T00:00:00.000","Asotin","WA","Passenger","18","15","33","12406","12439","0.2652946378326232012219631803"
"2020-09-30T00:00:00.000","Asotin","WA","Truck","0","0","0","6699","6699","0"
"2020-09-30T00:00:00.000","Benton","WA","Passenger","405","338","743","134421","135164","0.5497025835281583853688852061"
"2020-09-30T00:00:00.000","Benton","WA","Truck","0","0","0","43093","43093","0"
"2020-09-30T00:00:00.000","Chelan","WA","Passenger","264","80","344","54317","54661","0.6293335284755127055853350652"
"2020-09-30T00:00:00.000","Chelan","WA","Truck","0","0","0","22735","22735","0"
"2020-09-30T00:00:00.000","Clallam","WA","Passenger","256","177","433","49883","50316","0.8605612528817871054932824549"
"2020-09-30T00:00:00.000","Clallam","WA","Truck","1","0","1","21778","21779","0.004591579044033243032278800680"
"2020-09-30T00:00:00.000","Clark","WA","Passenger","2275","1140","3415","318396","321811","1.061181873832777624133419927"
"2020-09-30T00:00:00.000","Clark","WA","Truck","0","0","0","82887","82887","0"
"2020-09-30T00:00:00.000","Columbia","WA","Truck","0","0","0","1533","1533","0"
"2020-09-30T00:00:00.000","Columbia","WA","Passenger","4","3","7","2421","2428","0.2883031301482701812191103789"
"2020-09-30T00:00:00.000","Cowlitz","WA","Truck","0","0","0","28949","28949","0"
"2020-09-30T00:00:00.000","Cowlitz","WA","Passenger","165","133","298","72160","72458","0.4112727373098898672334317812"
"2020-09-30T00:00:00.000","Douglas","WA","Passenger","80","46","126","28051","28177","0.4471732263903183447492635838"
"2020-09-30T00:00:00.000","Douglas","WA","Truck","0","0","0","12381","12381","0"
"2020-09-30T00:00:00.000","Ferry","WA","Passenger","8","3","11","4306","4317","0.2548065786425758628677322215"
"2020-09-30T00:00:00.000","Ferry","WA","Truck","0","0","0","3579","3579","0"
"2020-09-30T00:00:00.000","Franklin","WA","Truck","0","0","0","20292","20292","0"
"2020-09-30T00:00:00.000","Franklin","WA","Passenger","74","80","154","60935","61089","0.2520912111836828234215652572"
"2020-09-30T00:00:00.000","Garfield","WA","Passenger","0","1","1","1351","1352","0.07396449704142011834319526627"
"2020-09-30T00:00:00.000","Garfield","WA","Truck","0","0","0","987","987","0"
"2020-09-30T00:00:00.000","Grant","WA","Truck","0","0","0","27312","27312","0"
"2020-09-30T00:00:00.000","Grant","WA","Passenger","70","84","154","65591","65745","0.2342383451213020001521028215"
"2020-09-30T00:00:00.000","Grays Harbor","WA","Truck","0","0","0","21093","21093","0"
"2020-09-30T00:00:00.000","Grays Harbor","WA","Passenger","132","122","254","48473","48727","0.5212715742811993350709052476"
"2020-09-30T00:00:00.000","Island","WA","Truck","1","0","1","21287","21288","0.004697482149567831642239759489"
"2020-09-30T00:00:00.000","Island","WA","Passenger","458","298","756","62982","63738","1.186105619881389438011861056"
"2020-09-30T00:00:00.000","Jefferson","WA","Passenger","266","159","425","24727","25152","1.689726463104325699745547074"
"2020-09-30T00:00:00.000","Jefferson","WA","Truck","0","0","0","9546","9546","0"
"2020-09-30T00:00:00.000","King","WA","Passenger","25790","8223","34013","1371765","1405778","2.419514318761568327289230590"
"2020-09-30T00:00:00.000","King","WA","Truck","5","1","6","183754","183760","0.003265128428384849804092294297"
"2020-09-30T00:00:00.000","Kitsap","WA","Passenger","1496","748","2244","179770","182014","1.232872196644214181326711132"
"2020-09-30T00:00:00.000","Kitsap","WA","Truck","0","0","0","54248","54248","0"
"2020-09-30T00:00:00.000","Kittitas","WA","Truck","0","0","0","14605","14605","0"
"2020-09-30T00:00:00.000","Kittitas","WA","Passenger","117","51","168","29711","29879","0.5622678135145085176880083001"
"2020-09-30T00:00:00.000","Klickitat","WA","Truck","0","0","0","8107","8107","0"
"2020-09-30T00:00:00.000","Klickitat","WA","Passenger","60","43","103","15027","15130","0.6807666886979510905485789822"
"2020-09-30T00:00:00.000","Lewis","WA","Passenger","121","123","244","58286","58530","0.4168802323594737741329232872"
"2020-09-30T00:00:00.000","Lewis","WA","Truck","0","0","0","26453","26453","0"
"2020-09-30T00:00:00.000","Lincoln","WA","Truck","0","0","0","4639","4639","0"
"2020-09-30T00:00:00.000","Lincoln","WA","Passenger","6","10","16","7600","7616","0.2100840336134453781512605042"
"2020-09-30T00:00:00.000","Mason","WA","Truck","0","0","0","20808","20808","0"
"2020-09-30T00:00:00.000","Mason","WA","Passenger","184","140","324","47450","47774","0.6781931594591200234437141541"
"2020-09-30T00:00:00.000","Okanogan","WA","Truck","0","0","0","16553","16553","0"
"2020-09-30T00:00:00.000","Okanogan","WA","Passenger","46","37","83","25968","26051","0.3186058116770949291773828260"
"2020-09-30T00:00:00.000","Pacific","WA","Truck","0","0","0","7746","7746","0"
"2020-09-30T00:00:00.000","Pacific","WA","Passenger","42","38","80","15703","15783","0.5068744852056009630615218906"
"2020-09-30T00:00:00.000","Pend Oreille","WA","Passenger","8","4","12","9190","9202","0.1304064333840469463160182569"
"2020-09-30T00:00:00.000","Pend Oreille","WA","Truck","0","0","0","5727","5727","0"
"2020-09-30T00:00:00.000","Pierce","WA","Truck","0","0","0","144097","144097","0"
"2020-09-30T00:00:00.000","Pierce","WA","Passenger","2784","1820","4604","554110","558714","0.8240351951087676342457858582"
"2020-09-30T00:00:00.000","San Juan","WA","Truck","0","0","0","5848","5848","0"
"2020-09-30T00:00:00.000","San Juan","WA","Passenger","333","101","434","13908","14342","3.026077255612885232185190350"
"2020-09-30T00:00:00.000","Skagit","WA","Truck","1","0","1","32657","32658","0.003062036866923877763488272399"
"2020-09-30T00:00:00.000","Skagit","WA","Passenger","474","250","724","91502","92226","0.7850280831869537874352134973"
"2020-09-30T00:00:00.000","Skamania","WA","Passenger","36","22","58","8371","8429","0.6881006050539803060861312137"
"2020-09-30T00:00:00.000","Skamania","WA","Truck","0","0","0","4008","4008","0"
"2020-09-30T00:00:00.000","Snohomish","WA","Passenger","4841","1907","6748","537259","544007","1.240425215116717248123645468"
"2020-09-30T00:00:00.000","Snohomish","WA","Truck","0","0","0","124974","124974","0"
"2020-09-30T00:00:00.000","Spokane","WA","Passenger","833","549","1382","318903","320285","0.4314907035921132741152411134"
"2020-09-30T00:00:00.000","Spokane","WA","Truck","1","0","1","99923","99924","0.001000760578039309875505384092"
"2020-09-30T00:00:00.000","Stevens","WA","Passenger","38","40","78","30416","30494","0.2557880238735488948645635207"
"2020-09-30T00:00:00.000","Stevens","WA","Truck","0","0","0","18705","18705","0"
"2020-09-30T00:00:00.000","Thurston","WA","Truck","0","0","0","56180","56180","0"
"2020-09-30T00:00:00.000","Thurston","WA","Passenger","1294","803","2097","197347","199444","1.051422955817171737430055554"
"2020-09-30T00:00:00.000","Wahkiakum","WA","Passenger","6","7","13","3017","3030","0.4290429042904290429042904290"
"2020-09-30T00:00:00.000","Wahkiakum","WA","Truck","0","0","0","1759","1759","0"
"2020-09-30T00:00:00.000","Walla Walla","WA","Passenger","87","65","152","35961","36113","0.4209010605599091739816686512"
"2020-09-30T00:00:00.000","Walla Walla","WA","Truck","0","0","0","13798","13798","0"
"2020-09-30T00:00:00.000","Whatcom","WA","Truck","3","0","3","43399","43402","0.006912123865259665453204921432"
"2020-09-30T00:00:00.000","Whatcom","WA","Passenger","1194","547","1741","149403","151144","1.151881649288096120256179537"
"2020-09-30T00:00:00.000","Whitman","WA","Passenger","49","50","99","22023","22122","0.4475183075671277461350691619"
"2020-09-30T00:00:00.000","Whitman","WA","Truck","0","0","0","8500","8500","0"
"2020-09-30T00:00:00.000","Yakima","WA","Truck","0","0","0","60589","60589","0"
"2020-09-30T00:00:00.000","Yakima","WA","Passenger","169","133","302","166525","166827","0.1810258531292896233823062214"
"2020-09-30T00:00:00.000","Ozaukee","WI","Passenger","0","1","1","3","4","25.00"
"2020-09-30T00:00:00.000",,,"Passenger","2","0","2","185","187","1.069518716577540106951871658"
"2020-10-31T00:00:00.000","Fairbanks North Star","AK","Passenger","0","1","1","94","95","1.052631578947368421052631579"
"2020-10-31T00:00:00.000","Juneau","AK","Passenger","0","1","1","26","27","3.703703703703703703703703704"
"2020-10-31T00:00:00.000","Montgomery","AL","Passenger","0","1","1","37","38","2.631578947368421052631578947"
"2020-10-31T00:00:00.000","Maricopa","AZ","Passenger","6","6","12","1165","1177","1.019541206457094307561597281"
"2020-10-31T00:00:00.000","Pima","AZ","Passenger","3","1","4","301","305","1.311475409836065573770491803"
"2020-10-31T00:00:00.000","Alameda","CA","Passenger","2","0","2","241","243","0.8230452674897119341563786008"
"2020-10-31T00:00:00.000","Contra Costa","CA","Passenger","3","3","6","324","330","1.818181818181818181818181818"
"2020-10-31T00:00:00.000","El Dorado","CA","Passenger","1","0","1","31","32","3.12500"
"2020-10-31T00:00:00.000","Fresno","CA","Passenger","1","0","1","173","174","0.5747126436781609195402298851"
"2020-10-31T00:00:00.000","Kern","CA","Passenger","1","1","2","215","217","0.9216589861751152073732718894"
"2020-10-31T00:00:00.000","Los Angeles","CA","Passenger","9","9","18","922","940","1.914893617021276595744680851"
"2020-10-31T00:00:00.000","Monterey","CA","Passenger","1","1","2","151","153","1.307189542483660130718954248"
"2020-10-31T00:00:00.000","Orange","CA","Passenger","4","3","7","451","458","1.528384279475982532751091703"
"2020-10-31T00:00:00.000","Placer","CA","Passenger","1","0","1","76","77","1.298701298701298701298701299"
"2020-10-31T00:00:00.000","Riverside","CA","Passenger","4","1","5","562","567","0.8818342151675485008818342152"
"2020-10-31T00:00:00.000","Sacramento","CA","Passenger","1","0","1","237","238","0.4201680672268907563025210084"
"2020-10-31T00:00:00.000","San Bernardino","CA","Passenger","0","1","1","405","406","0.2463054187192118226600985222"
"2020-10-31T00:00:00.000","San Diego","CA","Passenger","14","5","19","2770","2789","0.6812477590534241663678737899"
"2020-10-31T00:00:00.000","San Francisco","CA","Passenger","1","1","2","81","83","2.409638554216867469879518072"
"2020-10-31T00:00:00.000","San Mateo","CA","Passenger","0","1","1","102","103","0.9708737864077669902912621359"
"2020-10-31T00:00:00.000","Santa Barbara","CA","Passenger","2","0","2","76","78","2.564102564102564102564102564"
"2020-10-31T00:00:00.000","Santa Clara","CA","Passenger","5","2","7","252","259","2.702702702702702702702702703"
"2020-10-31T00:00:00.000","Santa Cruz","CA","Passenger","1","0","1","30","31","3.225806451612903225806451613"
"2020-10-31T00:00:00.000","Solano","CA","Passenger","1","0","1","209","210","0.4761904761904761904761904762"
"2020-10-31T00:00:00.000","Ventura","CA","Passenger","1","1","2","272","274","0.7299270072992700729927007299"
"2020-10-31T00:00:00.000","Arapahoe","CO","Passenger","1","0","1","119","120","0.8333333333333333333333333333"
"2020-10-31T00:00:00.000","Boulder","CO","Passenger","0","1","1","34","35","2.857142857142857142857142857"
"2020-10-31T00:00:00.000","Denver","CO","Passenger","1","0","1","105","106","0.9433962264150943396226415094"
"2020-10-31T00:00:00.000","El Paso","CO","Passenger","2","0","2","668","670","0.2985074626865671641791044776"
"2020-10-31T00:00:00.000","Larimer","CO","Passenger","1","1","2","43","45","4.444444444444444444444444444"
"2020-10-31T00:00:00.000","New London","CT","Passenger","0","2","2","248","250","0.800"
"2020-10-31T00:00:00.000","District of Columbia","DC","Passenger","2","3","5","198","203","2.463054187192118226600985222"
"2020-10-31T00:00:00.000","Kent","DE","Passenger","0","1","1","68","69","1.449275362318840579710144928"
"2020-10-31T00:00:00.000","New Castle","DE","Passenger","1","0","1","25","26","3.846153846153846153846153846"
"2020-10-31T00:00:00.000","Broward","FL","Passenger","1","1","2","105","107","1.869158878504672897196261682"
"2020-10-31T00:00:00.000","Duval","FL","Passenger","0","1","1","338","339","0.2949852507374631268436578171"
"2020-10-31T00:00:00.000","Lake","FL","Passenger","1","0","1","19","20","5.00"
"2020-10-31T00:00:00.000","Nassau","FL","Passenger","1","0","1","29","30","3.333333333333333333333333333"
"2020-10-31T00:00:00.000","Okaloosa","FL","Passenger","0","1","1","131","132","0.7575757575757575757575757576"
"2020-10-31T00:00:00.000","Palm Beach","FL","Passenger","0","1","1","64","65","1.538461538461538461538461538"
"2020-10-31T00:00:00.000","Pinellas","FL","Passenger","1","1","2","86","88","2.272727272727272727272727273"
"2020-10-31T00:00:00.000","Polk","FL","Passenger","1","0","1","60","61","1.639344262295081967213114754"
"2020-10-31T00:00:00.000","Sarasota","FL","Passenger","2","0","2","26","28","7.142857142857142857142857143"
"2020-10-31T00:00:00.000","St. Johns","FL","Passenger","0","1","1","47","48","2.083333333333333333333333333"
"2020-10-31T00:00:00.000","Sumter","FL","Passenger","0","1","1","10","11","9.090909090909090909090909091"
"2020-10-31T00:00:00.000","Bartow","GA","Passenger","0","1","1","3","4","25.00"
"2020-10-31T00:00:00.000","Bryan","GA","Passenger","1","0","1","50","51","1.960784313725490196078431373"
"2020-10-31T00:00:00.000","Camden","GA","Passenger","0","1","1","138","139","0.7194244604316546762589928058"
"2020-10-31T00:00:00.000","Columbia","GA","Passenger","1","1","2","131","133","1.503759398496240601503759398"
"2020-10-31T00:00:00.000","DeKalb","GA","Passenger","1","0","1","68","69","1.449275362318840579710144928"
"2020-10-31T00:00:00.000","Fulton","GA","Passenger","1","2","3","83","86","3.488372093023255813953488372"
"2020-10-31T00:00:00.000","Houston","GA","Passenger","1","0","1","51","52","1.923076923076923076923076923"
"2020-10-31T00:00:00.000","Jones","GA","Passenger","1","0","1","1","2","50.0"
"2020-10-31T00:00:00.000","Liberty","GA","Passenger","1","0","1","113","114","0.8771929824561403508771929825"
"2020-10-31T00:00:00.000","Honolulu","HI","Passenger","5","1","6","404","410","1.463414634146341463414634146"
"2020-10-31T00:00:00.000","Maui","HI","Passenger","1","0","1","26","27","3.703703703703703703703703704"
"2020-10-31T00:00:00.000","Ada","ID","Passenger","0","1","1","230","231","0.4329004329004329004329004329"
"2020-10-31T00:00:00.000","Twin Falls","ID","Passenger","0","1","1","17","18","5.555555555555555555555555556"
"2020-10-31T00:00:00.000","DuPage","IL","Passenger","3","0","3","49","52","5.769230769230769230769230769"
"2020-10-31T00:00:00.000","Lake","IL","Passenger","3","0","3","167","170","1.764705882352941176470588235"
"2020-10-31T00:00:00.000","Monroe","IL","Passenger","1","0","1","2","3","33.33333333333333333333333333"
"2020-10-31T00:00:00.000","St. Clair","IL","Passenger","1","0","1","136","137","0.7299270072992700729927007299"
"2020-10-31T00:00:00.000","DeKalb","IN","Passenger","1","0","1","1","2","50.0"
"2020-10-31T00:00:00.000","Hamilton","IN","Passenger","2","0","2","36","38","5.263157894736842105263157895"
"2020-10-31T00:00:00.000","Howard","IN","Passenger","0","1","1","3","4","25.00"
"2020-10-31T00:00:00.000","Vigo","IN","Passenger","1","0","1","5","6","16.66666666666666666666666667"
"2020-10-31T00:00:00.000","Leavenworth","KS","Passenger","0","1","1","123","124","0.8064516129032258064516129032"
"2020-10-31T00:00:00.000","Sedgwick","KS","Passenger","1","0","1","89","90","1.111111111111111111111111111"
"2020-10-31T00:00:00.000","Oldham","KY","Passenger","0","1","1","4","5","20.0"
"2020-10-31T00:00:00.000","Plaquemines","LA","Passenger","0","1","1","13","14","7.142857142857142857142857143"
"2020-10-31T00:00:00.000","Hampshire","MA","Passenger","1","0","1","4","5","20.0"
"2020-10-31T00:00:00.000","Middlesex","MA","Passenger","1","1","2","92","94","2.127659574468085106382978723"
"2020-10-31T00:00:00.000","Suffolk","MA","Passenger","0","2","2","38","40","5.00"
"2020-10-31T00:00:00.000","Anne Arundel","MD","Passenger","1","1","2","398","400","0.500"
"2020-10-31T00:00:00.000","Calvert","MD","Passenger","0","2","2","82","84","2.380952380952380952380952381"
"2020-10-31T00:00:00.000","Carroll","MD","Passenger","0","1","1","17","18","5.555555555555555555555555556"
"2020-10-31T00:00:00.000","Charles","MD","Passenger","1","1","2","70","72","2.777777777777777777777777778"
"2020-10-31T00:00:00.000","Frederick","MD","Passenger","2","1","3","76","79","3.797468354430379746835443038"
"2020-10-31T00:00:00.000","Howard","MD","Passenger","0","1","1","60","61","1.639344262295081967213114754"
"2020-10-31T00:00:00.000","Montgomery","MD","Passenger","0","2","2","227","229","0.8733624454148471615720524017"
"2020-10-31T00:00:00.000","Prince George's","MD","Passenger","1","0","1","144","145","0.6896551724137931034482758621"
"2020-10-31T00:00:00.000","St. Mary's","MD","Passenger","1","0","1","196","197","0.5076142131979695431472081218"
"2020-10-31T00:00:00.000","Penobscot","ME","Passenger","0","1","1","13","14","7.142857142857142857142857143"
"2020-10-31T00:00:00.000","Kent","MI","Passenger","0","1","1","21","22","4.545454545454545454545454545"
"2020-10-31T00:00:00.000","Saginaw","MI","Passenger","1","0","1","10","11","9.090909090909090909090909091"
"2020-10-31T00:00:00.000","Washtenaw","MI","Passenger","1","0","1","25","26","3.846153846153846153846153846"
"2020-10-31T00:00:00.000","Hennepin","MN","Passenger","1","0","1","75","76","1.315789473684210526315789474"
"2020-10-31T00:00:00.000","Kanabec","MN","Passenger","1","0","1","0","1","100"
"2020-10-31T00:00:00.000","Ramsey","MN","Passenger","1","0","1","31","32","3.12500"
"2020-10-31T00:00:00.000","Boone","MO","Passenger","0","1","1","9","10","10.0"
"2020-10-31T00:00:00.000","Greene","MO","Passenger","0","1","1","26","27","3.703703703703703703703703704"
"2020-10-31T00:00:00.000","Platte","MO","Passenger","1","0","1","17","18","5.555555555555555555555555556"
"2020-10-31T00:00:00.000","St. Louis","MO","Passenger","1","0","1","93","94","1.063829787234042553191489362"
"2020-10-31T00:00:00.000","Harrison","MS","Passenger","1","0","1","51","52","1.923076923076923076923076923"
"2020-10-31T00:00:00.000","Cascade","MT","Passenger","0","1","1","53","54","1.851851851851851851851851852"
"2020-10-31T00:00:00.000","Flathead","MT","Passenger","1","0","1","50","51","1.960784313725490196078431373"
"2020-10-31T00:00:00.000","Glacier","MT","Passenger","0","1","1","3","4","25.00"
"2020-10-31T00:00:00.000","Cumberland","NC","Passenger","0","3","3","458","461","0.6507592190889370932754880694"
"2020-10-31T00:00:00.000","Guilford","NC","Passenger","1","0","1","28","29","3.448275862068965517241379310"
"2020-10-31T00:00:00.000","Moore","NC","Passenger","0","1","1","156","157","0.6369426751592356687898089172"
"2020-10-31T00:00:00.000","Williams","ND","Passenger","0","1","1","11","12","8.333333333333333333333333333"
"2020-10-31T00:00:00.000","Douglas","NE","Passenger","0","1","1","50","51","1.960784313725490196078431373"
"2020-10-31T00:00:00.000","Carroll","NH","Passenger","0","1","1","3","4","25.00"
"2020-10-31T00:00:00.000","Camden","NJ","Passenger","0","1","1","19","20","5.00"
"2020-10-31T00:00:00.000","Hudson","NJ","Passenger","1","0","1","137","138","0.7246376811594202898550724638"
"2020-10-31T00:00:00.000","Morris","NJ","Passenger","1","0","1","19","20","5.00"
"2020-10-31T00:00:00.000","Chaves","NM","Passenger","1","0","1","9","10","10.0"
"2020-10-31T00:00:00.000","Carson City","NV","Passenger","1","0","1","11","12","8.333333333333333333333333333"
"2020-10-31T00:00:00.000","Clark","NV","Passenger","3","4","7","638","645","1.085271317829457364341085271"
"2020-10-31T00:00:00.000","Washoe","NV","Passenger","1","0","1","80","81","1.234567901234567901234567901"
"2020-10-31T00:00:00.000","Erie","NY","Passenger","1","0","1","39","40","2.500"
"2020-10-31T00:00:00.000","Jefferson","NY","Passenger","0","1","1","213","214","0.4672897196261682242990654206"
"2020-10-31T00:00:00.000","Kings","NY","Passenger","1","0","1","55","56","1.785714285714285714285714286"
"2020-10-31T00:00:00.000","Nassau","NY","Passenger","2","0","2","24","26","7.692307692307692307692307692"
"2020-10-31T00:00:00.000","New York","NY","Passenger","1","0","1","61","62","1.612903225806451612903225806"
"2020-10-31T00:00:00.000","Queens","NY","Passenger","1","0","1","49","50","2.00"
"2020-10-31T00:00:00.000","Westchester","NY","Passenger","0","1","1","21","22","4.545454545454545454545454545"
"2020-10-31T00:00:00.000","Montgomery","OH","Passenger","0","1","1","44","45","2.222222222222222222222222222"
"2020-10-31T00:00:00.000","Shelby","OH","Passenger","0","1","1","1","2","50.0"
"2020-10-31T00:00:00.000","Rogers","OK","Passenger","1","0","1","5","6","16.66666666666666666666666667"
"2020-10-31T00:00:00.000","Tulsa","OK","Passenger","1","1","2","38","40","5.00"
"2020-10-31T00:00:00.000","Clackamas","OR","Passenger","2","0","2","166","168","1.190476190476190476190476190"
"2020-10-31T00:00:00.000","Deschutes","OR","Passenger","1","0","1","114","115","0.8695652173913043478260869565"
"2020-10-31T00:00:00.000","Klamath","OR","Passenger","1","0","1","24","25","4.00"
"2020-10-31T00:00:00.000","Multnomah","OR","Passenger","3","5","8","655","663","1.206636500754147812971342383"
"2020-10-31T00:00:00.000","Washington","OR","Passenger","1","0","1","384","385","0.2597402597402597402597402597"
"2020-10-31T00:00:00.000","Allegheny","PA","Passenger","1","0","1","60","61","1.639344262295081967213114754"
"2020-10-31T00:00:00.000","Bucks","PA","Passenger","1","0","1","19","20","5.00"
"2020-10-31T00:00:00.000","Montgomery","PA","Passenger","1","0","1","19","20","5.00"
"2020-10-31T00:00:00.000","RÃ­o Grande","PR","Passenger","1","0","1","1","2","50.0"
"2020-10-31T00:00:00.000","Newport","RI","Passenger","1","0","1","83","84","1.190476190476190476190476190"
"2020-10-31T00:00:00.000","Charleston","SC","Passenger","1","0","1","88","89","1.123595505617977528089887640"
"2020-10-31T00:00:00.000","Richland","SC","Passenger","0","1","1","143","144","0.6944444444444444444444444444"
"2020-10-31T00:00:00.000","Spartanburg","SC","Passenger","0","1","1","38","39","2.564102564102564102564102564"
"2020-10-31T00:00:00.000","Bradley","TN","Passenger","1","0","1","0","1","100"
"2020-10-31T00:00:00.000","Davidson","TN","Passenger","1","0","1","50","51","1.960784313725490196078431373"
"2020-10-31T00:00:00.000","Putnam","TN","Passenger","0","1","1","1","2","50.0"
"2020-10-31T00:00:00.000","Tipton","TN","Passenger","1","0","1","14","15","6.666666666666666666666666667"
"2020-10-31T00:00:00.000","Bell","TX","Passenger","0","1","1","380","381","0.2624671916010498687664041995"
"2020-10-31T00:00:00.000","Bexar","TX","Passenger","6","5","11","539","550","2.00"
"2020-10-31T00:00:00.000","Dallas","TX","Passenger","1","0","1","171","172","0.5813953488372093023255813953"
"2020-10-31T00:00:00.000","Denton","TX","Passenger","1","0","1","69","70","1.428571428571428571428571429"
"2020-10-31T00:00:00.000","El Paso","TX","Passenger","2","0","2","402","404","0.4950495049504950495049504950"
"2020-10-31T00:00:00.000","Harris","TX","Passenger","1","0","1","214","215","0.4651162790697674418604651163"
"2020-10-31T00:00:00.000","Hidalgo","TX","Passenger","0","1","1","62","63","1.587301587301587301587301587"
"2020-10-31T00:00:00.000","Montgomery","TX","Passenger","1","0","1","38","39","2.564102564102564102564102564"
"2020-10-31T00:00:00.000","Nueces","TX","Passenger","1","0","1","80","81","1.234567901234567901234567901"
"2020-10-31T00:00:00.000","Travis","TX","Passenger","2","2","4","155","159","2.515723270440251572327044025"
"2020-10-31T00:00:00.000","Salt Lake","UT","Passenger","0","2","2","158","160","1.2500"
"2020-10-31T00:00:00.000","Utah","UT","Passenger","0","1","1","120","121","0.8264462809917355371900826446"
"2020-10-31T00:00:00.000","Albemarle","VA","Passenger","1","0","1","20","21","4.761904761904761904761904762"
"2020-10-31T00:00:00.000","Alexandria","VA","Passenger","4","0","4","139","143","2.797202797202797202797202797"
"2020-10-31T00:00:00.000","Arlington","VA","Passenger","0","2","2","136","138","1.449275362318840579710144928"
"2020-10-31T00:00:00.000","Chesapeake","VA","Passenger","0","3","3","408","411","0.7299270072992700729927007299"
"2020-10-31T00:00:00.000","Fairfax","VA","Passenger","4","4","8","706","714","1.120448179271708683473389356"
"2020-10-31T00:00:00.000","Goochland","VA","Passenger","3","1","4","210","214","1.869158878504672897196261682"
"2020-10-31T00:00:00.000","Loudoun","VA","Passenger","1","0","1","75","76","1.315789473684210526315789474"
"2020-10-31T00:00:00.000","Manassas","VA","Passenger","0","1","1","4","5","20.0"
"2020-10-31T00:00:00.000","Norfolk","VA","Passenger","1","1","2","343","345","0.5797101449275362318840579710"
"2020-10-31T00:00:00.000","Portsmouth","VA","Passenger","0","1","1","63","64","1.562500"
"2020-10-31T00:00:00.000","Powhatan","VA","Passenger","1","0","1","0","1","100"
"2020-10-31T00:00:00.000","Prince William","VA","Passenger","2","2","4","215","219","1.826484018264840182648401826"
"2020-10-31T00:00:00.000","Stafford","VA","Passenger","1","1","2","93","95","2.105263157894736842105263158"
"2020-10-31T00:00:00.000","Suffolk","VA","Passenger","1","0","1","110","111","0.9009009009009009009009009009"
"2020-10-31T00:00:00.000","Virginia Beach","VA","Passenger","1","0","1","618","619","0.1615508885298869143780290792"
"2020-10-31T00:00:00.000","Adams","WA","Truck","0","0","0","5336","5336","0"
"2020-10-31T00:00:00.000","Adams","WA","Passenger","8","8","16","12939","12955","0.1235044384407564646854496333"
"2020-10-31T00:00:00.000","Asotin","WA","Passenger","18","15","33","12410","12443","0.2652093546572370007232982400"
"2020-10-31T00:00:00.000","Asotin","WA","Truck","0","0","0","6691","6691","0"
"2020-10-31T00:00:00.000","Benton","WA","Truck","0","0","0","43073","43073","0"
"2020-10-31T00:00:00.000","Benton","WA","Passenger","414","349","763","134724","135487","0.5631536604987932421560740145"
"2020-10-31T00:00:00.000","Chelan","WA","Passenger","269","81","350","54384","54734","0.6394562794606643037234625644"
"2020-10-31T00:00:00.000","Chelan","WA","Truck","0","0","0","22777","22777","0"
"2020-10-31T00:00:00.000","Clallam","WA","Passenger","263","177","440","49894","50334","0.8741606071442762347518575913"
"2020-10-31T00:00:00.000","Clallam","WA","Truck","1","0","1","21772","21773","0.004592844348505029164561613007"
"2020-10-31T00:00:00.000","Clark","WA","Passenger","2313","1163","3476","318832","322308","1.078471524132196532509276841"
"2020-10-31T00:00:00.000","Clark","WA","Truck","0","0","0","83187","83187","0"
"2020-10-31T00:00:00.000","Columbia","WA","Passenger","4","3","7","2438","2445","0.2862985685071574642126789366"
"2020-10-31T00:00:00.000","Columbia","WA","Truck","0","0","0","1533","1533","0"
"2020-10-31T00:00:00.000","Cowlitz","WA","Truck","0","0","0","28907","28907","0"
"2020-10-31T00:00:00.000","Cowlitz","WA","Passenger","168","135","303","72096","72399","0.4185140678738656611279161314"
"2020-10-31T00:00:00.000","Douglas","WA","Truck","0","0","0","12420","12420","0"
"2020-10-31T00:00:00.000","Douglas","WA","Passenger","81","44","125","28080","28205","0.4431838326537847899308633221"
"2020-10-31T00:00:00.000","Ferry","WA","Passenger","8","3","11","4352","4363","0.2521201008480403392161356865"
"2020-10-31T00:00:00.000","Ferry","WA","Truck","0","0","0","3594","3594","0"
"2020-10-31T00:00:00.000","Franklin","WA","Passenger","79","82","161","61111","61272","0.2627627627627627627627627628"
"2020-10-31T00:00:00.000","Franklin","WA","Truck","0","0","0","20378","20378","0"
"2020-10-31T00:00:00.000","Garfield","WA","Passenger","0","1","1","1354","1355","0.07380073800738007380073800738"
"2020-10-31T00:00:00.000","Garfield","WA","Truck","0","0","0","990","990","0"
"2020-10-31T00:00:00.000","Grant","WA","Truck","0","0","0","27399","27399","0"
"2020-10-31T00:00:00.000","Grant","WA","Passenger","74","85","159","65758","65917","0.2412124338182866331902240697"
"2020-10-31T00:00:00.000","Grays Harbor","WA","Passenger","134","123","257","48515","48772","0.5269416878536865414582137292"
"2020-10-31T00:00:00.000","Grays Harbor","WA","Truck","0","0","0","21122","21122","0"
"2020-10-31T00:00:00.000","Island","WA","Truck","1","0","1","21336","21337","0.004686694474387214697473871678"
"2020-10-31T00:00:00.000","Island","WA","Passenger","477","302","779","63003","63782","1.221347715656454799159637515"
"2020-10-31T00:00:00.000","Jefferson","WA","Passenger","266","162","428","24718","25146","1.702059969776505209576075718"
"2020-10-31T00:00:00.000","Jefferson","WA","Truck","0","0","0","9579","9579","0"
"2020-10-31T00:00:00.000","King","WA","Truck","5","1","6","184142","184148","0.003258248799878358711471207941"
"2020-10-31T00:00:00.000","King","WA","Passenger","26278","8335","34613","1373179","1407792","2.458672872128837214588518758"
"2020-10-31T00:00:00.000","Kitsap","WA","Truck","0","0","0","54298","54298","0"
"2020-10-31T00:00:00.000","Kitsap","WA","Passenger","1537","765","2302","179832","182134","1.263904597713771179461275764"
"2020-10-31T00:00:00.000","Kittitas","WA","Passenger","125","52","177","29710","29887","0.5922307357714056278649580085"
"2020-10-31T00:00:00.000","Kittitas","WA","Truck","0","0","0","14636","14636","0"
"2020-10-31T00:00:00.000","Klickitat","WA","Truck","0","0","0","8090","8090","0"
"2020-10-31T00:00:00.000","Klickitat","WA","Passenger","61","45","106","15007","15113","0.7013829153708727585522397936"
"2020-10-31T00:00:00.000","Lewis","WA","Passenger","125","121","246","58430","58676","0.4192514827186583952553002931"
"2020-10-31T00:00:00.000","Lewis","WA","Truck","0","0","0","26505","26505","0"
"2020-10-31T00:00:00.000","Lincoln","WA","Truck","0","0","0","4662","4662","0"
"2020-10-31T00:00:00.000","Lincoln","WA","Passenger","6","10","16","7615","7631","0.2096710784956100117939981654"
"2020-10-31T00:00:00.000","Mason","WA","Truck","0","0","0","20842","20842","0"
"2020-10-31T00:00:00.000","Mason","WA","Passenger","187","144","331","47487","47818","0.6922079551633276172152745828"
"2020-10-31T00:00:00.000","Okanogan","WA","Passenger","48","37","85","25994","26079","0.3259327428198934008205836113"
"2020-10-31T00:00:00.000","Okanogan","WA","Truck","0","0","0","16580","16580","0"
"2020-10-31T00:00:00.000","Pacific","WA","Passenger","43","38","81","15712","15793","0.5128854555815867789527005635"
"2020-10-31T00:00:00.000","Pacific","WA","Truck","0","0","0","7755","7755","0"
"2020-10-31T00:00:00.000","Pend Oreille","WA","Passenger","8","4","12","9159","9171","0.1308472358521426234870788355"
"2020-10-31T00:00:00.000","Pend Oreille","WA","Truck","0","0","0","5717","5717","0"
"2020-10-31T00:00:00.000","Pierce","WA","Truck","0","0","0","144506","144506","0"
"2020-10-31T00:00:00.000","Pierce","WA","Passenger","2868","1853","4721","555069","559790","0.8433519712749423891102020401"
"2020-10-31T00:00:00.000","San Juan","WA","Passenger","342","104","446","13970","14416","3.093784683684794672586015538"
"2020-10-31T00:00:00.000","San Juan","WA","Truck","0","0","0","5864","5864","0"
"2020-10-31T00:00:00.000","Skagit","WA","Truck","1","0","1","32698","32699","0.003058197498394446313342915685"
"2020-10-31T00:00:00.000","Skagit","WA","Passenger","491","253","744","91534","92278","0.8062593467565400203732200525"
"2020-10-31T00:00:00.000","Skamania","WA","Passenger","36","20","56","8329","8385","0.6678592725104353011329755516"
"2020-10-31T00:00:00.000","Skamania","WA","Truck","0","0","0","3998","3998","0"
"2020-10-31T00:00:00.000","Snohomish","WA","Passenger","4978","1915","6893","537915","544808","1.265216369803673954861162097"
"2020-10-31T00:00:00.000","Snohomish","WA","Truck","0","0","0","125357","125357","0"
"2020-10-31T00:00:00.000","Spokane","WA","Passenger","864","563","1427","319880","321307","0.4441235329451272459050067381"
"2020-10-31T00:00:00.000","Spokane","WA","Truck","0","0","0","100265","100265","0"
"2020-10-31T00:00:00.000","Stevens","WA","Passenger","39","40","79","30370","30449","0.2594502282505172583664488161"
"2020-10-31T00:00:00.000","Stevens","WA","Truck","0","0","0","18696","18696","0"
"2020-10-31T00:00:00.000","Thurston","WA","Truck","0","0","0","56355","56355","0"
"2020-10-31T00:00:00.000","Thurston","WA","Passenger","1338","812","2150","197431","199581","1.077256853107259709090544691"
"2020-10-31T00:00:00.000","Wahkiakum","WA","Passenger","6","7","13","3036","3049","0.4263693014102984585109872089"
"2020-10-31T00:00:00.000","Wahkiakum","WA","Truck","0","0","0","1765","1765","0"
"2020-10-31T00:00:00.000","Walla Walla","WA","Passenger","87","68","155","36034","36189","0.4283069440990356185581253972"
"2020-10-31T00:00:00.000","Walla Walla","WA","Truck","0","0","0","13804","13804","0"
"2020-10-31T00:00:00.000","Whatcom","WA","Passenger","1223","553","1776","149677","151453","1.172641017345315048232785088"
"2020-10-31T00:00:00.000","Whatcom","WA","Truck","3","0","3","43473","43476","0.006900358818658570245652773944"
"2020-10-31T00:00:00.000","Whitman","WA","Truck","0","0","0","8491","8491","0"
"2020-10-31T00:00:00.000","Whitman","WA","Passenger","52","49","101","22009","22110","0.4568068747173224785165083673"
"2020-10-31T00:00:00.000","Yakima","WA","Truck","0","0","0","60710","60710","0"
"2020-10-31T00:00:00.000","Yakima","WA","Passenger","171","131","302","166923","167225","0.1805950067274629989535057557"
"2020-10-31T00:00:00.000","Ozaukee","WI","Passenger","0","1","1","3","4","25.00"
"2020-10-31T00:00:00.000",,,"Passenger","1","0","1","182","183","0.5464480874316939890710382514"
"2020-11-30T00:00:00.000","Anchorage","AK","Passenger","1","0","1","141","142","0.7042253521126760563380281690"
"2020-11-30T00:00:00.000","Fairbanks North Star","AK","Passenger","0","1","1","92","93","1.075268817204301075268817204"
"2020-11-30T00:00:00.000","Juneau","AK","Passenger","0","1","1","25","26","3.846153846153846153846153846"
"2020-11-30T00:00:00.000","Montgomery","AL","Passenger","0","1","1","37","38","2.631578947368421052631578947"
"2020-11-30T00:00:00.000","Maricopa","AZ","Passenger","6","6","12","1146","1158","1.036269430051813471502590674"
"2020-11-30T00:00:00.000","Pima","AZ","Passenger","3","1","4","299","303","1.320132013201320132013201320"
"2020-11-30T00:00:00.000","Alameda","CA","Passenger","3","0","3","244","247","1.214574898785425101214574899"
"2020-11-30T00:00:00.000","Contra Costa","CA","Passenger","3","3","6","322","328","1.829268292682926829268292683"
"2020-11-30T00:00:00.000","El Dorado","CA","Passenger","1","0","1","32","33","3.030303030303030303030303030"
"2020-11-30T00:00:00.000","Fresno","CA","Passenger","1","0","1","168","169","0.5917159763313609467455621302"
"2020-11-30T00:00:00.000","Kern","CA","Passenger","1","1","2","212","214","0.9345794392523364485981308411"
"2020-11-30T00:00:00.000","Los Angeles","CA","Passenger","8","9","17","907","924","1.839826839826839826839826840"
"2020-11-30T00:00:00.000","Monterey","CA","Passenger","1","1","2","149","151","1.324503311258278145695364238"
"2020-11-30T00:00:00.000","Orange","CA","Passenger","3","3","6","441","447","1.342281879194630872483221477"
"2020-11-30T00:00:00.000","Placer","CA","Passenger","1","0","1","76","77","1.298701298701298701298701299"
"2020-11-30T00:00:00.000","Riverside","CA","Passenger","4","1","5","559","564","0.8865248226950354609929078014"
"2020-11-30T00:00:00.000","Sacramento","CA","Passenger","2","0","2","234","236","0.8474576271186440677966101695"
"2020-11-30T00:00:00.000","San Bernardino","CA","Passenger","0","1","1","400","401","0.2493765586034912718204488778"
"2020-11-30T00:00:00.000","San Diego","CA","Passenger","15","5","20","2749","2769","0.7222824124232574936800288913"
"2020-11-30T00:00:00.000","San Francisco","CA","Passenger","1","1","2","80","82","2.439024390243902439024390244"
"2020-11-30T00:00:00.000","San Mateo","CA","Passenger","0","1","1","104","105","0.9523809523809523809523809524"
"2020-11-30T00:00:00.000","Santa Barbara","CA","Passenger","2","0","2","76","78","2.564102564102564102564102564"
"2020-11-30T00:00:00.000","Santa Clara","CA","Passenger","5","2","7","251","258","2.713178294573643410852713178"
"2020-11-30T00:00:00.000","Santa Cruz","CA","Passenger","1","0","1","29","30","3.333333333333333333333333333"
"2020-11-30T00:00:00.000","Solano","CA","Passenger","1","0","1","211","212","0.4716981132075471698113207547"
"2020-11-30T00:00:00.000","Ventura","CA","Passenger","1","1","2","270","272","0.7352941176470588235294117647"
"2020-11-30T00:00:00.000","Arapahoe","CO","Passenger","1","0","1","117","118","0.8474576271186440677966101695"
"2020-11-30T00:00:00.000","Boulder","CO","Passenger","0","1","1","35","36","2.777777777777777777777777778"
"2020-11-30T00:00:00.000","Denver","CO","Passenger","1","0","1","105","106","0.9433962264150943396226415094"
"2020-11-30T00:00:00.000","El Paso","CO","Passenger","2","0","2","667","669","0.2989536621823617339312406577"
"2020-11-30T00:00:00.000","Larimer","CO","Passenger","1","1","2","44","46","4.347826086956521739130434783"
"2020-11-30T00:00:00.000","New London","CT","Passenger","0","2","2","248","250","0.800"
"2020-11-30T00:00:00.000","District of Columbia","DC","Passenger","2","3","5","198","203","2.463054187192118226600985222"
"2020-11-30T00:00:00.000","Kent","DE","Passenger","0","1","1","67","68","1.470588235294117647058823529"
"2020-11-30T00:00:00.000","New Castle","DE","Passenger","1","0","1","26","27","3.703703703703703703703703704"
"2020-11-30T00:00:00.000","Broward","FL","Passenger","1","1","2","104","106","1.886792452830188679245283019"
"2020-11-30T00:00:00.000","Duval","FL","Passenger","0","1","1","334","335","0.2985074626865671641791044776"
"2020-11-30T00:00:00.000","Lake","FL","Passenger","1","0","1","19","20","5.00"
"2020-11-30T00:00:00.000","Nassau","FL","Passenger","1","0","1","28","29","3.448275862068965517241379310"
"2020-11-30T00:00:00.000","Okaloosa","FL","Passenger","0","1","1","126","127","0.7874015748031496062992125984"
"2020-11-30T00:00:00.000","Orange","FL","Passenger","1","0","1","106","107","0.9345794392523364485981308411"
"2020-11-30T00:00:00.000","Palm Beach","FL","Passenger","0","1","1","61","62","1.612903225806451612903225806"
"2020-11-30T00:00:00.000","Pinellas","FL","Passenger","1","1","2","85","87","2.298850574712643678160919540"
"2020-11-30T00:00:00.000","Polk","FL","Passenger","1","0","1","58","59","1.694915254237288135593220339"
"2020-11-30T00:00:00.000","Sarasota","FL","Passenger","2","0","2","26","28","7.142857142857142857142857143"
"2020-11-30T00:00:00.000","St. Johns","FL","Passenger","0","1","1","46","47","2.127659574468085106382978723"
"2020-11-30T00:00:00.000","Sumter","FL","Passenger","0","1","1","10","11","9.090909090909090909090909091"
"2020-11-30T00:00:00.000","Bartow","GA","Passenger","0","1","1","3","4","25.00"
"2020-11-30T00:00:00.000","Bryan","GA","Passenger","1","0","1","50","51","1.960784313725490196078431373"
"2020-11-30T00:00:00.000","Camden","GA","Passenger","0","1","1","137","138","0.7246376811594202898550724638"
"2020-11-30T00:00:00.000","Columbia","GA","Passenger","1","0","1","130","131","0.7633587786259541984732824427"
"2020-11-30T00:00:00.000","DeKalb","GA","Passenger","1","0","1","65","66","1.515151515151515151515151515"
"2020-11-30T00:00:00.000","Fulton","GA","Passenger","1","2","3","83","86","3.488372093023255813953488372"
"2020-11-30T00:00:00.000","Houston","GA","Passenger","1","0","1","51","52","1.923076923076923076923076923"
"2020-11-30T00:00:00.000","Jones","GA","Passenger","1","0","1","1","2","50.0"
"2020-11-30T00:00:00.000","Liberty","GA","Passenger","1","0","1","114","115","0.8695652173913043478260869565"
"2020-11-30T00:00:00.000","Honolulu","HI","Passenger","5","1","6","405","411","1.459854014598540145985401460"
"2020-11-30T00:00:00.000","Maui","HI","Passenger","1","0","1","26","27","3.703703703703703703703703704"
"2020-11-30T00:00:00.000","Ada","ID","Passenger","0","1","1","223","224","0.4464285714285714285714285714"
"2020-11-30T00:00:00.000","Twin Falls","ID","Passenger","0","1","1","17","18","5.555555555555555555555555556"
"2020-11-30T00:00:00.000","DuPage","IL","Passenger","3","0","3","48","51","5.882352941176470588235294118"
"2020-11-30T00:00:00.000","Lake","IL","Passenger","3","0","3","164","167","1.796407185628742514970059880"
"2020-11-30T00:00:00.000","Monroe","IL","Passenger","1","0","1","2","3","33.33333333333333333333333333"
"2020-11-30T00:00:00.000","St. Clair","IL","Passenger","1","0","1","138","139","0.7194244604316546762589928058"
"2020-11-30T00:00:00.000","DeKalb","IN","Passenger","1","0","1","0","1","100"
"2020-11-30T00:00:00.000","Hamilton","IN","Passenger","2","0","2","33","35","5.714285714285714285714285714"
"2020-11-30T00:00:00.000","Howard","IN","Passenger","0","1","1","3","4","25.00"
"2020-11-30T00:00:00.000","Vigo","IN","Passenger","1","0","1","5","6","16.66666666666666666666666667"
"2020-11-30T00:00:00.000","Leavenworth","KS","Passenger","0","1","1","122","123","0.8130081300813008130081300813"
"2020-11-30T00:00:00.000","Sedgwick","KS","Passenger","1","0","1","86","87","1.149425287356321839080459770"
"2020-11-30T00:00:00.000","Oldham","KY","Passenger","0","1","1","4","5","20.0"
"2020-11-30T00:00:00.000","Plaquemines","LA","Passenger","0","1","1","13","14","7.142857142857142857142857143"
"2020-11-30T00:00:00.000","Hampshire","MA","Passenger","1","0","1","4","5","20.0"
"2020-11-30T00:00:00.000","Middlesex","MA","Passenger","1","1","2","89","91","2.197802197802197802197802198"
"2020-11-30T00:00:00.000","Suffolk","MA","Passenger","0","2","2","37","39","5.128205128205128205128205128"
"2020-11-30T00:00:00.000","Anne Arundel","MD","Passenger","1","1","2","392","394","0.5076142131979695431472081218"
"2020-11-30T00:00:00.000","Calvert","MD","Passenger","0","2","2","84","86","2.325581395348837209302325581"
"2020-11-30T00:00:00.000","Carroll","MD","Passenger","0","1","1","17","18","5.555555555555555555555555556"
"2020-11-30T00:00:00.000","Charles","MD","Passenger","1","1","2","69","71","2.816901408450704225352112676"
"2020-11-30T00:00:00.000","Frederick","MD","Passenger","2","1","3","76","79","3.797468354430379746835443038"
"2020-11-30T00:00:00.000","Howard","MD","Passenger","0","1","1","60","61","1.639344262295081967213114754"
"2020-11-30T00:00:00.000","Montgomery","MD","Passenger","0","2","2","227","229","0.8733624454148471615720524017"
"2020-11-30T00:00:00.000","Prince George's","MD","Passenger","1","0","1","142","143","0.6993006993006993006993006993"
"2020-11-30T00:00:00.000","St. Mary's","MD","Passenger","1","0","1","194","195","0.5128205128205128205128205128"
"2020-11-30T00:00:00.000","Penobscot","ME","Passenger","0","1","1","11","12","8.333333333333333333333333333"
"2020-11-30T00:00:00.000","Kent","MI","Passenger","0","1","1","21","22","4.545454545454545454545454545"
"2020-11-30T00:00:00.000","Saginaw","MI","Passenger","1","0","1","10","11","9.090909090909090909090909091"
"2020-11-30T00:00:00.000","Washtenaw","MI","Passenger","1","0","1","25","26","3.846153846153846153846153846"
"2020-11-30T00:00:00.000","Hennepin","MN","Passenger","1","0","1","75","76","1.315789473684210526315789474"
"2020-11-30T00:00:00.000","Kanabec","MN","Passenger","1","0","1","0","1","100"
"2020-11-30T00:00:00.000","Ramsey","MN","Passenger","1","0","1","31","32","3.12500"
"2020-11-30T00:00:00.000","Boone","MO","Passenger","0","1","1","9","10","10.0"
"2020-11-30T00:00:00.000","Greene","MO","Passenger","0","1","1","25","26","3.846153846153846153846153846"
"2020-11-30T00:00:00.000","Platte","MO","Passenger","1","0","1","17","18","5.555555555555555555555555556"
"2020-11-30T00:00:00.000","St. Louis","MO","Passenger","1","0","1","91","92","1.086956521739130434782608696"
"2020-11-30T00:00:00.000","Harrison","MS","Passenger","1","0","1","53","54","1.851851851851851851851851852"
"2020-11-30T00:00:00.000","Cascade","MT","Passenger","0","1","1","54","55","1.818181818181818181818181818"
"2020-11-30T00:00:00.000","Flathead","MT","Passenger","1","0","1","49","50","2.00"
"2020-11-30T00:00:00.000","Glacier","MT","Passenger","0","1","1","3","4","25.00"
"2020-11-30T00:00:00.000","Missoula","MT","Passenger","1","0","1","55","56","1.785714285714285714285714286"
"2020-11-30T00:00:00.000","Cumberland","NC","Passenger","0","3","3","454","457","0.6564551422319474835886214442"
"2020-11-30T00:00:00.000","Moore","NC","Passenger","0","1","1","156","157","0.6369426751592356687898089172"
"2020-11-30T00:00:00.000","Williams","ND","Passenger","0","1","1","10","11","9.090909090909090909090909091"
"2020-11-30T00:00:00.000","Douglas","NE","Passenger","0","1","1","50","51","1.960784313725490196078431373"
"2020-11-30T00:00:00.000","Carroll","NH","Passenger","0","1","1","3","4","25.00"
"2020-11-30T00:00:00.000","Camden","NJ","Passenger","0","1","1","19","20","5.00"
"2020-11-30T00:00:00.000","Hudson","NJ","Passenger","1","0","1","136","137","0.7299270072992700729927007299"
"2020-11-30T00:00:00.000","Morris","NJ","Passenger","1","0","1","18","19","5.263157894736842105263157895"
"2020-11-30T00:00:00.000","Chaves","NM","Passenger","1","0","1","9","10","10.0"
"2020-11-30T00:00:00.000","Carson City","NV","Passenger","1","0","1","12","13","7.692307692307692307692307692"
"2020-11-30T00:00:00.000","Clark","NV","Passenger","3","4","7","631","638","1.097178683385579937304075235"
"2020-11-30T00:00:00.000","Washoe","NV","Passenger","1","0","1","82","83","1.204819277108433734939759036"
"2020-11-30T00:00:00.000","Erie","NY","Passenger","1","0","1","38","39","2.564102564102564102564102564"
"2020-11-30T00:00:00.000","Jefferson","NY","Passenger","0","1","1","213","214","0.4672897196261682242990654206"
"2020-11-30T00:00:00.000","Kings","NY","Passenger","1","0","1","55","56","1.785714285714285714285714286"
"2020-11-30T00:00:00.000","Nassau","NY","Passenger","2","0","2","24","26","7.692307692307692307692307692"
"2020-11-30T00:00:00.000","New York","NY","Passenger","1","0","1","59","60","1.666666666666666666666666667"
"2020-11-30T00:00:00.000","Queens","NY","Passenger","1","0","1","49","50","2.00"
"2020-11-30T00:00:00.000","Westchester","NY","Passenger","0","1","1","21","22","4.545454545454545454545454545"
"2020-11-30T00:00:00.000","Montgomery","OH","Passenger","0","1","1","48","49","2.040816326530612244897959184"
"2020-11-30T00:00:00.000","Shelby","OH","Passenger","0","1","1","1","2","50.0"
"2020-11-30T00:00:00.000","Rogers","OK","Passenger","1","0","1","5","6","16.66666666666666666666666667"
"2020-11-30T00:00:00.000","Tulsa","OK","Passenger","1","1","2","37","39","5.128205128205128205128205128"
"2020-11-30T00:00:00.000","Clackamas","OR","Passenger","2","0","2","160","162","1.234567901234567901234567901"
"2020-11-30T00:00:00.000","Deschutes","OR","Passenger","1","0","1","114","115","0.8695652173913043478260869565"
"2020-11-30T00:00:00.000","Klamath","OR","Passenger","1","0","1","24","25","4.00"
"2020-11-30T00:00:00.000","Multnomah","OR","Passenger","3","5","8","644","652","1.226993865030674846625766871"
"2020-11-30T00:00:00.000","Washington","OR","Passenger","1","0","1","379","380","0.2631578947368421052631578947"
"2020-11-30T00:00:00.000","Allegheny","PA","Passenger","1","1","2","58","60","3.333333333333333333333333333"
"2020-11-30T00:00:00.000","Bucks","PA","Passenger","1","0","1","19","20","5.00"
"2020-11-30T00:00:00.000","Montgomery","PA","Passenger","1","0","1","18","19","5.263157894736842105263157895"
"2020-11-30T00:00:00.000","RÃ­o Grande","PR","Passenger","1","0","1","1","2","50.0"
"2020-11-30T00:00:00.000","Newport","RI","Passenger","1","0","1","84","85","1.176470588235294117647058824"
"2020-11-30T00:00:00.000","Charleston","SC","Passenger","1","0","1","87","88","1.136363636363636363636363636"
"2020-11-30T00:00:00.000","Richland","SC","Passenger","0","1","1","139","140","0.7142857142857142857142857143"
"2020-11-30T00:00:00.000","Spartanburg","SC","Passenger","0","1","1","37","38","2.631578947368421052631578947"
"2020-11-30T00:00:00.000","Bradley","TN","Passenger","1","0","1","0","1","100"
"2020-11-30T00:00:00.000","Davidson","TN","Passenger","1","0","1","48","49","2.040816326530612244897959184"
"2020-11-30T00:00:00.000","Putnam","TN","Passenger","0","1","1","1","2","50.0"
"2020-11-30T00:00:00.000","Tipton","TN","Passenger","1","0","1","14","15","6.666666666666666666666666667"
"2020-11-30T00:00:00.000","Bell","TX","Passenger","0","1","1","376","377","0.2652519893899204244031830239"
"2020-11-30T00:00:00.000","Bexar","TX","Passenger","6","5","11","531","542","2.029520295202952029520295203"
"2020-11-30T00:00:00.000","Dallas","TX","Passenger","1","0","1","164","165","0.6060606060606060606060606061"
"2020-11-30T00:00:00.000","Denton","TX","Passenger","1","0","1","68","69","1.449275362318840579710144928"
"2020-11-30T00:00:00.000","El Paso","TX","Passenger","2","0","2","393","395","0.5063291139240506329113924051"
"2020-11-30T00:00:00.000","Harris","TX","Passenger","1","0","1","209","210","0.4761904761904761904761904762"
"2020-11-30T00:00:00.000","Hidalgo","TX","Passenger","0","1","1","61","62","1.612903225806451612903225806"
"2020-11-30T00:00:00.000","Montgomery","TX","Passenger","1","0","1","38","39","2.564102564102564102564102564"
"2020-11-30T00:00:00.000","Nueces","TX","Passenger","1","0","1","79","80","1.2500"
"2020-11-30T00:00:00.000","Travis","TX","Passenger","2","1","3","158","161","1.863354037267080745341614907"
"2020-11-30T00:00:00.000","Wichita","TX","Passenger","1","0","1","40","41","2.439024390243902439024390244"
"2020-11-30T00:00:00.000","Salt Lake","UT","Passenger","0","2","2","154","156","1.282051282051282051282051282"
"2020-11-30T00:00:00.000","Utah","UT","Passenger","0","1","1","120","121","0.8264462809917355371900826446"
"2020-11-30T00:00:00.000","Albemarle","VA","Passenger","1","0","1","20","21","4.761904761904761904761904762"
"2020-11-30T00:00:00.000","Alexandria","VA","Passenger","4","0","4","139","143","2.797202797202797202797202797"
"2020-11-30T00:00:00.000","Arlington","VA","Passenger","0","2","2","135","137","1.459854014598540145985401460"
"2020-11-30T00:00:00.000","Chesapeake","VA","Passenger","0","3","3","408","411","0.7299270072992700729927007299"
"2020-11-30T00:00:00.000","Fairfax","VA","Passenger","4","4","8","699","707","1.131541725601131541725601132"
"2020-11-30T00:00:00.000","Goochland","VA","Passenger","4","1","5","207","212","2.358490566037735849056603774"
"2020-11-30T00:00:00.000","Loudoun","VA","Passenger","1","0","1","72","73","1.369863013698630136986301370"
"2020-11-30T00:00:00.000","Manassas","VA","Passenger","0","1","1","4","5","20.0"
"2020-11-30T00:00:00.000","Norfolk","VA","Passenger","1","1","2","340","342","0.5847953216374269005847953216"
"2020-11-30T00:00:00.000","Portsmouth","VA","Passenger","0","1","1","64","65","1.538461538461538461538461538"
"2020-11-30T00:00:00.000","Powhatan","VA","Passenger","1","0","1","0","1","100"
"2020-11-30T00:00:00.000","Prince William","VA","Passenger","2","2","4","214","218","1.834862385321100917431192661"
"2020-11-30T00:00:00.000","Stafford","VA","Passenger","1","1","2","92","94","2.127659574468085106382978723"
"2020-11-30T00:00:00.000","Suffolk","VA","Passenger","1","0","1","110","111","0.9009009009009009009009009009"
"2020-11-30T00:00:00.000","Virginia Beach","VA","Passenger","1","0","1","613","614","0.1628664495114006514657980456"
"2020-11-30T00:00:00.000","Adams","WA","Truck","0","0","0","5326","5326","0"
"2020-11-30T00:00:00.000","Adams","WA","Passenger","10","7","17","12945","12962","0.1311525999074216941829964512"
"2020-11-30T00:00:00.000","Asotin","WA","Passenger","18","15","33","12420","12453","0.2649963864129125511924837389"
"2020-11-30T00:00:00.000","Asotin","WA","Truck","0","0","0","6672","6672","0"
"2020-11-30T00:00:00.000","Benton","WA","Truck","0","0","0","43115","43115","0"
"2020-11-30T00:00:00.000","Benton","WA","Passenger","437","357","794","134836","135630","0.5854162058541620585416205854"
"2020-11-30T00:00:00.000","Chelan","WA","Passenger","275","83","358","54384","54742","0.6539768367980709510065397684"
"2020-11-30T00:00:00.000","Chelan","WA","Truck","0","0","0","22786","22786","0"
"2020-11-30T00:00:00.000","Clallam","WA","Passenger","274","180","454","49874","50328","0.9020823398505801939278334128"
"2020-11-30T00:00:00.000","Clallam","WA","Truck","1","0","1","21788","21789","0.004589471751801367662582036808"
"2020-11-30T00:00:00.000","Clark","WA","Truck","0","0","0","83251","83251","0"
"2020-11-30T00:00:00.000","Clark","WA","Passenger","2386","1183","3569","318820","322389","1.107047697036809568564684279"
"2020-11-30T00:00:00.000","Columbia","WA","Passenger","4","3","7","2438","2445","0.2862985685071574642126789366"
"2020-11-30T00:00:00.000","Columbia","WA","Truck","0","0","0","1531","1531","0"
"2020-11-30T00:00:00.000","Cowlitz","WA","Passenger","178","137","315","72011","72326","0.4355280258828083953211846362"
"2020-11-30T00:00:00.000","Cowlitz","WA","Truck","0","0","0","28883","28883","0"
"2020-11-30T00:00:00.000","Douglas","WA","Truck","0","0","0","12457","12457","0"
"2020-11-30T00:00:00.000","Douglas","WA","Passenger","83","44","127","28139","28266","0.4493030496002264204344442086"
"2020-11-30T00:00:00.000","Ferry","WA","Truck","0","0","0","3596","3596","0"
"2020-11-30T00:00:00.000","Ferry","WA","Passenger","8","3","11","4348","4359","0.2523514567561367286074787795"
"2020-11-30T00:00:00.000","Franklin","WA","Passenger","85","84","169","61175","61344","0.2754955659885237350026082420"
"2020-11-30T00:00:00.000","Franklin","WA","Truck","0","0","0","20384","20384","0"
"2020-11-30T00:00:00.000","Garfield","WA","Truck","0","0","0","996","996","0"
"2020-11-30T00:00:00.000","Garfield","WA","Passenger","0","1","1","1365","1366","0.07320644216691068814055636896"
"2020-11-30T00:00:00.000","Grant","WA","Truck","0","0","0","27430","27430","0"
"2020-11-30T00:00:00.000","Grant","WA","Passenger","81","83","164","65779","65943","0.2486996345328541315985017363"
"2020-11-30T00:00:00.000","Grays Harbor","WA","Passenger","139","123","262","48542","48804","0.5368412425211048274731579379"
"2020-11-30T00:00:00.000","Grays Harbor","WA","Truck","0","0","0","21133","21133","0"
"2020-11-30T00:00:00.000","Island","WA","Passenger","494","305","799","63045","63844","1.251488002004886911847628595"
"2020-11-30T00:00:00.000","Island","WA","Truck","0","0","0","21332","21332","0"
"2020-11-30T00:00:00.000","Jefferson","WA","Passenger","282","164","446","24724","25170","1.771950735001986491855383393"
"2020-11-30T00:00:00.000","Jefferson","WA","Truck","0","0","0","9586","9586","0"
"2020-11-30T00:00:00.000","King","WA","Truck","6","1","7","184263","184270","0.003798773538828892386172464319"
"2020-11-30T00:00:00.000","King","WA","Passenger","27003","8399","35402","1371419","1406821","2.516453763485191079746463836"
"2020-11-30T00:00:00.000","Kitsap","WA","Truck","0","0","0","54357","54357","0"
"2020-11-30T00:00:00.000","Kitsap","WA","Passenger","1594","772","2366","179913","182279","1.298010193165422237339463131"
"2020-11-30T00:00:00.000","Kittitas","WA","Passenger","129","55","184","29751","29935","0.6146651077334224152330048438"
"2020-11-30T00:00:00.000","Kittitas","WA","Truck","0","0","0","14648","14648","0"
"2020-11-30T00:00:00.000","Klickitat","WA","Passenger","64","43","107","14983","15090","0.7090788601722995361166335321"
"2020-11-30T00:00:00.000","Klickitat","WA","Truck","0","0","0","8087","8087","0"
"2020-11-30T00:00:00.000","Lewis","WA","Passenger","128","123","251","58614","58865","0.4263993884311560349953282936"
"2020-11-30T00:00:00.000","Lewis","WA","Truck","0","0","0","26557","26557","0"
"2020-11-30T00:00:00.000","Lincoln","WA","Passenger","6","11","17","7620","7637","0.2226004975775828204792457771"
"2020-11-30T00:00:00.000","Lincoln","WA","Truck","0","0","0","4661","4661","0"
"2020-11-30T00:00:00.000","Mason","WA","Passenger","192","144","336","47489","47825","0.7025614218504966021955044433"
"2020-11-30T00:00:00.000","Mason","WA","Truck","0","0","0","20864","20864","0"
"2020-11-30T00:00:00.000","Okanogan","WA","Passenger","52","38","90","25986","26076","0.3451449608835710998619420156"
"2020-11-30T00:00:00.000","Okanogan","WA","Truck","0","0","0","16586","16586","0"
"2020-11-30T00:00:00.000","Pacific","WA","Passenger","44","38","82","15727","15809","0.5186918843696628502751597191"
"2020-11-30T00:00:00.000","Pacific","WA","Truck","0","0","0","7765","7765","0"
"2020-11-30T00:00:00.000","Pend Oreille","WA","Passenger","9","4","13","9148","9161","0.1419059054688352799912673289"
"2020-11-30T00:00:00.000","Pend Oreille","WA","Truck","0","0","0","5720","5720","0"
"2020-11-30T00:00:00.000","Pierce","WA","Passenger","2971","1866","4837","555206","560043","0.8636836814316043589510091189"
"2020-11-30T00:00:00.000","Pierce","WA","Truck","0","0","0","144649","144649","0"
"2020-11-30T00:00:00.000","San Juan","WA","Passenger","357","107","464","14017","14481","3.204198605068710724397486361"
"2020-11-30T00:00:00.000","San Juan","WA","Truck","0","0","0","5867","5867","0"
"2020-11-30T00:00:00.000","Skagit","WA","Passenger","507","257","764","91411","92175","0.8288581502576620558719826417"
"2020-11-30T00:00:00.000","Skagit","WA","Truck","1","0","1","32732","32733","0.003055020926893349219442153179"
"2020-11-30T00:00:00.000","Skamania","WA","Truck","0","0","0","4011","4011","0"
"2020-11-30T00:00:00.000","Skamania","WA","Passenger","37","21","58","8304","8362","0.6936139679502511360918440564"
"2020-11-30T00:00:00.000","Snohomish","WA","Passenger","5103","1922","7025","538129","545154","1.288626699978354740128477458"
"2020-11-30T00:00:00.000","Snohomish","WA","Truck","0","0","0","125513","125513","0"
"2020-11-30T00:00:00.000","Spokane","WA","Passenger","896","579","1475","320422","321897","0.4582211079941720488230707338"
"2020-11-30T00:00:00.000","Spokane","WA","Truck","0","0","0","100432","100432","0"
"2020-11-30T00:00:00.000","Stevens","WA","Truck","0","0","0","18673","18673","0"
"2020-11-30T00:00:00.000","Stevens","WA","Passenger","39","40","79","30279","30358","0.2602279465050398576981355821"
"2020-11-30T00:00:00.000","Thurston","WA","Passenger","1373","814","2187","197367","199554","1.095943955019693917435882017"
"2020-11-30T00:00:00.000","Thurston","WA","Truck","0","0","0","56340","56340","0"
"2020-11-30T00:00:00.000","Wahkiakum","WA","Passenger","6","7","13","3041","3054","0.4256712508185985592665356909"
"2020-11-30T00:00:00.000","Wahkiakum","WA","Truck","0","0","0","1767","1767","0"
"2020-11-30T00:00:00.000","Walla Walla","WA","Truck","0","0","0","13827","13827","0"
"2020-11-30T00:00:00.000","Walla Walla","WA","Passenger","96","70","166","36087","36253","0.4578931398780790555264391912"
"2020-11-30T00:00:00.000","Whatcom","WA","Passenger","1257","555","1812","149752","151564","1.195534559657966271674012298"
"2020-11-30T00:00:00.000","Whatcom","WA","Truck","3","0","3","43497","43500","0.006896551724137931034482758621"
"2020-11-30T00:00:00.000","Whitman","WA","Truck","0","0","0","8492","8492","0"
"2020-11-30T00:00:00.000","Whitman","WA","Passenger","53","47","100","21989","22089","0.4527140205532165331160306035"
"2020-11-30T00:00:00.000","Yakima","WA","Passenger","180","131","311","167050","167361","0.1858258495109374346472595169"
"2020-11-30T00:00:00.000","Yakima","WA","Truck","0","0","0","60792","60792","0"
"2020-11-30T00:00:00.000","Ozaukee","WI","Passenger","0","1","1","3","4","25.00"
"2020-11-30T00:00:00.000",,,"Passenger","1","0","1","180","181","0.5524861878453038674033149171"
"2020-12-31T00:00:00.000","Anchorage","AK","Passenger","1","0","1","141","142","0.7042253521126760563380281690"
"2020-12-31T00:00:00.000","Fairbanks North Star","AK","Passenger","0","1","1","90","91","1.098901098901098901098901099"
"2020-12-31T00:00:00.000","Juneau","AK","Passenger","0","1","1","24","25","4.00"
"2020-12-31T00:00:00.000","Maricopa","AZ","Passenger","7","6","13","1134","1147","1.133391455972101133391455972"
"2020-12-31T00:00:00.000","Pima","AZ","Passenger","2","1","3","295","298","1.006711409395973154362416107"
"2020-12-31T00:00:00.000","Alameda","CA","Passenger","3","0","3","245","248","1.209677419354838709677419355"
"2020-12-31T00:00:00.000","Contra Costa","CA","Passenger","2","3","5","314","319","1.567398119122257053291536050"
"2020-12-31T00:00:00.000","El Dorado","CA","Passenger","1","0","1","32","33","3.030303030303030303030303030"
"2020-12-31T00:00:00.000","Fresno","CA","Passenger","1","0","1","167","168","0.5952380952380952380952380952"
"2020-12-31T00:00:00.000","Kern","CA","Passenger","1","1","2","211","213","0.9389671361502347417840375587"
"2020-12-31T00:00:00.000","Los Angeles","CA","Passenger","9","10","19","886","905","2.099447513812154696132596685"
"2020-12-31T00:00:00.000","Monterey","CA","Passenger","1","1","2","150","152","1.315789473684210526315789474"
"2020-12-31T00:00:00.000","Orange","CA","Passenger","3","3","6","435","441","1.360544217687074829931972789"
"2020-12-31T00:00:00.000","Placer","CA","Passenger","1","0","1","74","75","1.333333333333333333333333333"
"2020-12-31T00:00:00.000","Riverside","CA","Passenger","4","1","5","553","558","0.8960573476702508960573476703"
"2020-12-31T00:00:00.000","Sacramento","CA","Passenger","2","0","2","226","228","0.8771929824561403508771929825"
"2020-12-31T00:00:00.000","San Bernardino","CA","Passenger","0","1","1","388","389","0.2570694087403598971722365039"
"2020-12-31T00:00:00.000","San Diego","CA","Passenger","14","5","19","2739","2758","0.6889050036258158085569253082"
"2020-12-31T00:00:00.000","San Francisco","CA","Passenger","1","1","2","81","83","2.409638554216867469879518072"
"2020-12-31T00:00:00.000","San Mateo","CA","Passenger","0","1","1","103","104","0.9615384615384615384615384615"
"2020-12-31T00:00:00.000","Santa Barbara","CA","Passenger","2","0","2","76","78","2.564102564102564102564102564"
"2020-12-31T00:00:00.000","Santa Clara","CA","Passenger","6","2","8","248","256","3.12500"
"2020-12-31T00:00:00.000","Santa Cruz","CA","Passenger","1","0","1","27","28","3.571428571428571428571428571"
"2020-12-31T00:00:00.000","Solano","CA","Passenger","1","0","1","211","212","0.4716981132075471698113207547"
"2020-12-31T00:00:00.000","Ventura","CA","Passenger","1","2","3","271","274","1.094890510948905109489051095"
"2020-12-31T00:00:00.000","Arapahoe","CO","Passenger","1","0","1","116","117","0.8547008547008547008547008547"
"2020-12-31T00:00:00.000","Boulder","CO","Passenger","0","1","1","34","35","2.857142857142857142857142857"
"2020-12-31T00:00:00.000","Denver","CO","Passenger","1","0","1","105","106","0.9433962264150943396226415094"
"2020-12-31T00:00:00.000","El Paso","CO","Passenger","2","0","2","664","666","0.3003003003003003003003003003"
"2020-12-31T00:00:00.000","Larimer","CO","Passenger","1","1","2","44","46","4.347826086956521739130434783"
"2020-12-31T00:00:00.000","New London","CT","Passenger","0","2","2","242","244","0.8196721311475409836065573770"
"2020-12-31T00:00:00.000","District of Columbia","DC","Passenger","2","3","5","200","205","2.439024390243902439024390244"
"2020-12-31T00:00:00.000","Kent","DE","Passenger","0","1","1","67","68","1.470588235294117647058823529"
"2020-12-31T00:00:00.000","New Castle","DE","Passenger","1","0","1","27","28","3.571428571428571428571428571"
"2020-12-31T00:00:00.000","Broward","FL","Passenger","1","1","2","100","102","1.960784313725490196078431373"
"2020-12-31T00:00:00.000","Duval","FL","Passenger","0","1","1","330","331","0.3021148036253776435045317221"
"2020-12-31T00:00:00.000","Lake","FL","Passenger","1","0","1","19","20","5.00"
"2020-12-31T00:00:00.000","Nassau","FL","Passenger","1","0","1","26","27","3.703703703703703703703703704"
"2020-12-31T00:00:00.000","Okaloosa","FL","Passenger","0","1","1","125","126","0.7936507936507936507936507937"
"2020-12-31T00:00:00.000","Orange","FL","Passenger","1","0","1","104","105","0.9523809523809523809523809524"
"2020-12-31T00:00:00.000","Palm Beach","FL","Passenger","0","1","1","60","61","1.639344262295081967213114754"
"2020-12-31T00:00:00.000","Pinellas","FL","Passenger","1","1","2","84","86","2.325581395348837209302325581"
"2020-12-31T00:00:00.000","Polk","FL","Passenger","1","0","1","56","57","1.754385964912280701754385965"
"2020-12-31T00:00:00.000","Sarasota","FL","Passenger","2","0","2","26","28","7.142857142857142857142857143"
"2020-12-31T00:00:00.000","St. Johns","FL","Passenger","0","1","1","46","47","2.127659574468085106382978723"
"2020-12-31T00:00:00.000","Sumter","FL","Passenger","0","1","1","10","11","9.090909090909090909090909091"
"2020-12-31T00:00:00.000","Bartow","GA","Passenger","0","1","1","3","4","25.00"
"2020-12-31T00:00:00.000","Bryan","GA","Passenger","1","0","1","49","50","2.00"
"2020-12-31T00:00:00.000","Camden","GA","Passenger","0","1","1","136","137","0.7299270072992700729927007299"
"2020-12-31T00:00:00.000","Columbia","GA","Passenger","1","0","1","128","129","0.7751937984496124031007751938"
"2020-12-31T00:00:00.000","DeKalb","GA","Passenger","1","0","1","63","64","1.562500"
"2020-12-31T00:00:00.000","Fulton","GA","Passenger","1","2","3","83","86","3.488372093023255813953488372"
"2020-12-31T00:00:00.000","Houston","GA","Passenger","1","0","1","50","51","1.960784313725490196078431373"
"2020-12-31T00:00:00.000","Jones","GA","Passenger","1","0","1","1","2","50.0"
"2020-12-31T00:00:00.000","Liberty","GA","Passenger","1","0","1","112","113","0.8849557522123893805309734513"
"2020-12-31T00:00:00.000","Honolulu","HI","Passenger","5","1","6","392","398","1.507537688442211055276381910"
"2020-12-31T00:00:00.000","Maui","HI","Passenger","1","0","1","25","26","3.846153846153846153846153846"
"2020-12-31T00:00:00.000","Ada","ID","Passenger","0","1","1","220","221","0.4524886877828054298642533937"
"2020-12-31T00:00:00.000","Twin Falls","ID","Passenger","0","1","1","17","18","5.555555555555555555555555556"
"2020-12-31T00:00:00.000","DuPage","IL","Passenger","2","0","2","48","50","4.00"
"2020-12-31T00:00:00.000","Lake","IL","Passenger","3","0","3","162","165","1.818181818181818181818181818"
"2020-12-31T00:00:00.000","Monroe","IL","Passenger","1","0","1","2","3","33.33333333333333333333333333"
"2020-12-31T00:00:00.000","St. Clair","IL","Passenger","1","0","1","137","138","0.7246376811594202898550724638"
"2020-12-31T00:00:00.000","DeKalb","IN","Passenger","1","0","1","0","1","100"
"2020-12-31T00:00:00.000","Hamilton","IN","Passenger","2","0","2","33","35","5.714285714285714285714285714"
"2020-12-31T00:00:00.000","Howard","IN","Passenger","0","1","1","3","4","25.00"
"2020-12-31T00:00:00.000","Vigo","IN","Passenger","1","0","1","5","6","16.66666666666666666666666667"
"2020-12-31T00:00:00.000","Leavenworth","KS","Passenger","0","1","1","121","122","0.8196721311475409836065573770"
"2020-12-31T00:00:00.000","Sedgwick","KS","Passenger","1","0","1","85","86","1.162790697674418604651162791"
"2020-12-31T00:00:00.000","Oldham","KY","Passenger","0","1","1","4","5","20.0"
"2020-12-31T00:00:00.000","Plaquemines","LA","Passenger","0","1","1","13","14","7.142857142857142857142857143"
"2020-12-31T00:00:00.000","Hampshire","MA","Passenger","1","0","1","4","5","20.0"
"2020-12-31T00:00:00.000","Middlesex","MA","Passenger","1","1","2","91","93","2.150537634408602150537634409"
"2020-12-31T00:00:00.000","Suffolk","MA","Passenger","0","2","2","36","38","5.263157894736842105263157895"
"2020-12-31T00:00:00.000","Anne Arundel","MD","Passenger","1","1","2","390","392","0.5102040816326530612244897959"
"2020-12-31T00:00:00.000","Calvert","MD","Passenger","0","2","2","84","86","2.325581395348837209302325581"
"2020-12-31T00:00:00.000","Carroll","MD","Passenger","0","1","1","17","18","5.555555555555555555555555556"
"2020-12-31T00:00:00.000","Charles","MD","Passenger","1","1","2","66","68","2.941176470588235294117647059"
"2020-12-31T00:00:00.000","Frederick","MD","Passenger","2","1","3","75","78","3.846153846153846153846153846"
"2020-12-31T00:00:00.000","Howard","MD","Passenger","0","1","1","62","63","1.587301587301587301587301587"
"2020-12-31T00:00:00.000","Montgomery","MD","Passenger","1","2","3","228","231","1.298701298701298701298701299"
"2020-12-31T00:00:00.000","Prince George's","MD","Passenger","1","0","1","139","140","0.7142857142857142857142857143"
"2020-12-31T00:00:00.000","St. Mary's","MD","Passenger","1","0","1","188","189","0.5291005291005291005291005291"
"2020-12-31T00:00:00.000","Penobscot","ME","Passenger","0","1","1","10","11","9.090909090909090909090909091"
"2020-12-31T00:00:00.000","Kent","MI","Passenger","0","1","1","20","21","4.761904761904761904761904762"
"2020-12-31T00:00:00.000","Saginaw","MI","Passenger","2","0","2","10","12","16.66666666666666666666666667"
"2020-12-31T00:00:00.000","Washtenaw","MI","Passenger","1","0","1","25","26","3.846153846153846153846153846"
"2020-12-31T00:00:00.000","Hennepin","MN","Passenger","1","0","1","74","75","1.333333333333333333333333333"
"2020-12-31T00:00:00.000","Kanabec","MN","Passenger","1","0","1","0","1","100"
"2020-12-31T00:00:00.000","Ramsey","MN","Passenger","1","0","1","31","32","3.12500"
"2020-12-31T00:00:00.000","Boone","MO","Passenger","0","1","1","9","10","10.0"
"2020-12-31T00:00:00.000","Greene","MO","Passenger","0","1","1","25","26","3.846153846153846153846153846"
"2020-12-31T00:00:00.000","Platte","MO","Passenger","1","0","1","17","18","5.555555555555555555555555556"
"2020-12-31T00:00:00.000","St. Louis","MO","Passenger","1","0","1","91","92","1.086956521739130434782608696"
"2020-12-31T00:00:00.000","Harrison","MS","Passenger","2","0","2","52","54","3.703703703703703703703703704"
"2020-12-31T00:00:00.000","Cascade","MT","Passenger","0","1","1","56","57","1.754385964912280701754385965"
"2020-12-31T00:00:00.000","Flathead","MT","Passenger","1","0","1","46","47","2.127659574468085106382978723"
"2020-12-31T00:00:00.000","Glacier","MT","Passenger","0","1","1","4","5","20.0"
"2020-12-31T00:00:00.000","Missoula","MT","Passenger","1","0","1","56","57","1.754385964912280701754385965"
"2020-12-31T00:00:00.000","Cumberland","NC","Passenger","0","3","3","447","450","0.6666666666666666666666666667"
"2020-12-31T00:00:00.000","Moore","NC","Passenger","0","1","1","151","152","0.6578947368421052631578947368"
"2020-12-31T00:00:00.000","Williams","ND","Passenger","0","1","1","10","11","9.090909090909090909090909091"
"2020-12-31T00:00:00.000","Douglas","NE","Passenger","0","1","1","52","53","1.886792452830188679245283019"
"2020-12-31T00:00:00.000","Carroll","NH","Passenger","0","1","1","3","4","25.00"
"2020-12-31T00:00:00.000","Camden","NJ","Passenger","0","1","1","16","17","5.882352941176470588235294118"
"2020-12-31T00:00:00.000","Hudson","NJ","Passenger","1","0","1","137","138","0.7246376811594202898550724638"
"2020-12-31T00:00:00.000","Morris","NJ","Passenger","1","0","1","17","18","5.555555555555555555555555556"
"2020-12-31T00:00:00.000","Chaves","NM","Passenger","1","0","1","9","10","10.0"
"2020-12-31T00:00:00.000","Carson City","NV","Passenger","1","0","1","12","13","7.692307692307692307692307692"
"2020-12-31T00:00:00.000","Clark","NV","Passenger","3","4","7","623","630","1.111111111111111111111111111"
"2020-12-31T00:00:00.000","Washoe","NV","Passenger","1","0","1","80","81","1.234567901234567901234567901"
"2020-12-31T00:00:00.000","Erie","NY","Passenger","1","0","1","36","37","2.702702702702702702702702703"
"2020-12-31T00:00:00.000","Jefferson","NY","Passenger","0","1","1","212","213","0.4694835680751173708920187793"
"2020-12-31T00:00:00.000","Kings","NY","Passenger","1","0","1","54","55","1.818181818181818181818181818"
"2020-12-31T00:00:00.000","Nassau","NY","Passenger","2","0","2","24","26","7.692307692307692307692307692"
"2020-12-31T00:00:00.000","New York","NY","Passenger","1","0","1","58","59","1.694915254237288135593220339"
"2020-12-31T00:00:00.000","Queens","NY","Passenger","1","0","1","49","50","2.00"
"2020-12-31T00:00:00.000","Westchester","NY","Passenger","0","1","1","19","20","5.00"
"2020-12-31T00:00:00.000","Montgomery","OH","Passenger","0","1","1","48","49","2.040816326530612244897959184"
"2020-12-31T00:00:00.000","Shelby","OH","Passenger","0","1","1","1","2","50.0"
"2020-12-31T00:00:00.000","Rogers","OK","Passenger","1","0","1","4","5","20.0"
"2020-12-31T00:00:00.000","Tulsa","OK","Passenger","1","1","2","36","38","5.263157894736842105263157895"
"2020-12-31T00:00:00.000","Clackamas","OR","Passenger","3","0","3","161","164","1.829268292682926829268292683"
"2020-12-31T00:00:00.000","Deschutes","OR","Passenger","1","0","1","108","109","0.9174311926605504587155963303"
"2020-12-31T00:00:00.000","Klamath","OR","Passenger","1","0","1","23","24","4.166666666666666666666666667"
"2020-12-31T00:00:00.000","Multnomah","OR","Passenger","3","5","8","638","646","1.238390092879256965944272446"
"2020-12-31T00:00:00.000","Washington","OR","Passenger","1","0","1","372","373","0.2680965147453083109919571046"
"2020-12-31T00:00:00.000","Allegheny","PA","Passenger","1","1","2","58","60","3.333333333333333333333333333"
"2020-12-31T00:00:00.000","Bucks","PA","Passenger","1","0","1","19","20","5.00"
"2020-12-31T00:00:00.000","Montgomery","PA","Passenger","1","0","1","19","20","5.00"
"2020-12-31T00:00:00.000","Philadelphia","PA","Passenger","1","0","1","59","60","1.666666666666666666666666667"
"2020-12-31T00:00:00.000","RÃ­o Grande","PR","Passenger","1","0","1","1","2","50.0"
"2020-12-31T00:00:00.000","Newport","RI","Passenger","1","0","1","84","85","1.176470588235294117647058824"
"2020-12-31T00:00:00.000","Charleston","SC","Passenger","1","0","1","85","86","1.162790697674418604651162791"
"2020-12-31T00:00:00.000","Richland","SC","Passenger","0","1","1","138","139","0.7194244604316546762589928058"
"2020-12-31T00:00:00.000","Spartanburg","SC","Passenger","0","1","1","38","39","2.564102564102564102564102564"
"2020-12-31T00:00:00.000","Pennington","SD","Passenger","1","0","1","33","34","2.941176470588235294117647059"
"2020-12-31T00:00:00.000","Bradley","TN","Passenger","1","0","1","0","1","100"
"2020-12-31T00:00:00.000","Davidson","TN","Passenger","1","0","1","47","48","2.083333333333333333333333333"
"2020-12-31T00:00:00.000","Putnam","TN","Passenger","0","1","1","1","2","50.0"
"2020-12-31T00:00:00.000","Tipton","TN","Passenger","1","0","1","14","15","6.666666666666666666666666667"
"2020-12-31T00:00:00.000","Bell","TX","Passenger","0","1","1","368","369","0.2710027100271002710027100271"
"2020-12-31T00:00:00.000","Bexar","TX","Passenger","5","5","10","530","540","1.851851851851851851851851852"
"2020-12-31T00:00:00.000","Dallas","TX","Passenger","1","0","1","161","162","0.6172839506172839506172839506"
"2020-12-31T00:00:00.000","Denton","TX","Passenger","1","0","1","67","68","1.470588235294117647058823529"
"2020-12-31T00:00:00.000","El Paso","TX","Passenger","2","0","2","389","391","0.5115089514066496163682864450"
"2020-12-31T00:00:00.000","Harris","TX","Passenger","1","0","1","208","209","0.4784688995215311004784688995"
"2020-12-31T00:00:00.000","Hidalgo","TX","Passenger","0","1","1","58","59","1.694915254237288135593220339"
"2020-12-31T00:00:00.000","Montgomery","TX","Passenger","1","0","1","37","38","2.631578947368421052631578947"
"2020-12-31T00:00:00.000","Nueces","TX","Passenger","1","0","1","78","79","1.265822784810126582278481013"
"2020-12-31T00:00:00.000","Travis","TX","Passenger","2","0","2","157","159","1.257861635220125786163522013"
"2020-12-31T00:00:00.000","Wichita","TX","Passenger","1","0","1","40","41","2.439024390243902439024390244"
"2020-12-31T00:00:00.000","Salt Lake","UT","Passenger","0","2","2","154","156","1.282051282051282051282051282"
"2020-12-31T00:00:00.000","Utah","UT","Passenger","0","1","1","116","117","0.8547008547008547008547008547"
"2020-12-31T00:00:00.000","Albemarle","VA","Passenger","1","0","1","20","21","4.761904761904761904761904762"
"2020-12-31T00:00:00.000","Alexandria","VA","Passenger","4","0","4","140","144","2.777777777777777777777777778"
"2020-12-31T00:00:00.000","Arlington","VA","Passenger","0","2","2","132","134","1.492537313432835820895522388"
"2020-12-31T00:00:00.000","Chesapeake","VA","Passenger","0","3","3","406","409","0.7334963325183374083129584352"
"2020-12-31T00:00:00.000","Fairfax","VA","Passenger","4","4","8","691","699","1.144492131616595135908440629"
"2020-12-31T00:00:00.000","Goochland","VA","Passenger","4","1","5","208","213","2.347417840375586854460093897"
"2020-12-31T00:00:00.000","Loudoun","VA","Passenger","1","0","1","70","71","1.408450704225352112676056338"
"2020-12-31T00:00:00.000","Manassas","VA","Passenger","0","1","1","4","5","20.0"
"2020-12-31T00:00:00.000","Norfolk","VA","Passenger","1","1","2","336","338","0.5917159763313609467455621302"
"2020-12-31T00:00:00.000","Portsmouth","VA","Passenger","0","1","1","65","66","1.515151515151515151515151515"
"2020-12-31T00:00:00.000","Powhatan","VA","Passenger","1","0","1","1","2","50.0"
"2020-12-31T00:00:00.000","Prince William","VA","Passenger","1","2","3","211","214","1.401869158878504672897196262"
"2020-12-31T00:00:00.000","Stafford","VA","Passenger","2","1","3","91","94","3.191489361702127659574468085"
"2020-12-31T00:00:00.000","Suffolk","VA","Passenger","1","0","1","109","110","0.9090909090909090909090909091"
"2020-12-31T00:00:00.000","Virginia Beach","VA","Passenger","2","0","2","608","610","0.3278688524590163934426229508"
"2020-12-31T00:00:00.000","Adams","WA","Truck","0","0","0","5339","5339","0"
"2020-12-31T00:00:00.000","Adams","WA","Passenger","10","8","18","12963","12981","0.1386642015253062167783683846"
"2020-12-31T00:00:00.000","Asotin","WA","Passenger","17","14","31","12423","12454","0.2489160109201862855307531717"
"2020-12-31T00:00:00.000","Asotin","WA","Truck","0","0","0","6682","6682","0"
"2020-12-31T00:00:00.000","Benton","WA","Truck","0","0","0","43216","43216","0"
"2020-12-31T00:00:00.000","Benton","WA","Passenger","450","365","815","135032","135847","0.5999396379750749004394649863"
"2020-12-31T00:00:00.000","Chelan","WA","Truck","0","0","0","22813","22813","0"
"2020-12-31T00:00:00.000","Chelan","WA","Passenger","282","87","369","54513","54882","0.6723515906854706461134798295"
"2020-12-31T00:00:00.000","Clallam","WA","Truck","1","0","1","21837","21838","0.004579173917025368623500320542"
"2020-12-31T00:00:00.000","Clallam","WA","Passenger","285","189","474","49926","50400","0.9404761904761904761904761905"
"2020-12-31T00:00:00.000","Clark","WA","Truck","0","0","0","83524","83524","0"
"2020-12-31T00:00:00.000","Clark","WA","Passenger","2456","1224","3680","319511","323191","1.138645568719425974114378185"
"2020-12-31T00:00:00.000","Columbia","WA","Passenger","5","3","8","2440","2448","0.3267973856209150326797385621"
"2020-12-31T00:00:00.000","Columbia","WA","Truck","0","0","0","1544","1544","0"
"2020-12-31T00:00:00.000","Cowlitz","WA","Passenger","187","137","324","72115","72439","0.4472728778696558483689725148"
"2020-12-31T00:00:00.000","Cowlitz","WA","Truck","0","0","0","28942","28942","0"
"2020-12-31T00:00:00.000","Douglas","WA","Passenger","87","45","132","28204","28336","0.4658385093167701863354037267"
"2020-12-31T00:00:00.000","Douglas","WA","Truck","0","0","0","12501","12501","0"
"2020-12-31T00:00:00.000","Ferry","WA","Truck","0","0","0","3605","3605","0"
"2020-12-31T00:00:00.000","Ferry","WA","Passenger","9","3","12","4363","4375","0.2742857142857142857142857143"
"2020-12-31T00:00:00.000","Franklin","WA","Passenger","92","87","179","61382","61561","0.2907685060346648040155293124"
"2020-12-31T00:00:00.000","Franklin","WA","Truck","0","0","0","20439","20439","0"
"2020-12-31T00:00:00.000","Garfield","WA","Truck","0","0","0","995","995","0"
"2020-12-31T00:00:00.000","Garfield","WA","Passenger","0","2","2","1369","1371","0.1458789204959883296863603209"
"2020-12-31T00:00:00.000","Grant","WA","Passenger","83","85","168","65941","66109","0.2541257619991226610597649337"
"2020-12-31T00:00:00.000","Grant","WA","Truck","0","0","0","27517","27517","0"
"2020-12-31T00:00:00.000","Grays Harbor","WA","Passenger","144","128","272","48646","48918","0.5560325442577374381618218243"
"2020-12-31T00:00:00.000","Grays Harbor","WA","Truck","0","0","0","21204","21204","0"
"2020-12-31T00:00:00.000","Island","WA","Passenger","521","306","827","63122","63949","1.293218033120142613645248557"
"2020-12-31T00:00:00.000","Island","WA","Truck","0","0","0","21398","21398","0"
"2020-12-31T00:00:00.000","Jefferson","WA","Truck","0","0","0","9592","9592","0"
"2020-12-31T00:00:00.000","Jefferson","WA","Passenger","291","165","456","24810","25266","1.804796960341961529327950606"
"2020-12-31T00:00:00.000","King","WA","Truck","6","1","7","184450","184457","0.003794922393837046032408637243"
"2020-12-31T00:00:00.000","King","WA","Passenger","27329","8487","35816","1370414","1406230","2.546951778869743925246936845"
"2020-12-31T00:00:00.000","Kitsap","WA","Truck","0","0","0","54437","54437","0"
"2020-12-31T00:00:00.000","Kitsap","WA","Passenger","1629","791","2420","179985","182405","1.326718017598201803678627231"
"2020-12-31T00:00:00.000","Kittitas","WA","Passenger","132","54","186","29832","30018","0.6196282230661603038177093744"
"2020-12-31T00:00:00.000","Kittitas","WA","Truck","0","0","0","14649","14649","0"
"2020-12-31T00:00:00.000","Klickitat","WA","Passenger","64","43","107","14987","15094","0.7088909500463760434609778720"
"2020-12-31T00:00:00.000","Klickitat","WA","Truck","0","0","0","8089","8089","0"
"2020-12-31T00:00:00.000","Lewis","WA","Truck","0","0","0","26632","26632","0"
"2020-12-31T00:00:00.000","Lewis","WA","Passenger","134","128","262","58824","59086","0.4434214534745963510814744610"
"2020-12-31T00:00:00.000","Lincoln","WA","Passenger","6","12","18","7647","7665","0.2348336594911937377690802348"
"2020-12-31T00:00:00.000","Lincoln","WA","Truck","0","0","0","4674","4674","0"
"2020-12-31T00:00:00.000","Mason","WA","Passenger","197","141","338","47639","47977","0.7045042416157742251495508264"
"2020-12-31T00:00:00.000","Mason","WA","Truck","0","0","0","20952","20952","0"
"2020-12-31T00:00:00.000","Okanogan","WA","Passenger","56","37","93","26071","26164","0.3554502369668246445497630332"
"2020-12-31T00:00:00.000","Okanogan","WA","Truck","0","0","0","16614","16614","0"
"2020-12-31T00:00:00.000","Pacific","WA","Passenger","43","39","82","15717","15799","0.5190201911513386923222988797"
"2020-12-31T00:00:00.000","Pacific","WA","Truck","0","0","0","7795","7795","0"
"2020-12-31T00:00:00.000","Pend Oreille","WA","Passenger","12","4","16","9174","9190","0.1741022850924918389553862894"
"2020-12-31T00:00:00.000","Pend Oreille","WA","Truck","0","0","0","5717","5717","0"
"2020-12-31T00:00:00.000","Pierce","WA","Passenger","3041","1880","4921","555962","560883","0.8773665809090309387162741606"
"2020-12-31T00:00:00.000","Pierce","WA","Truck","0","0","0","144899","144899","0"
"2020-12-31T00:00:00.000","San Juan","WA","Passenger","366","112","478","14024","14502","3.296097090056543924975865398"
"2020-12-31T00:00:00.000","San Juan","WA","Truck","0","0","0","5875","5875","0"
"2020-12-31T00:00:00.000","Skagit","WA","Passenger","523","259","782","91425","92207","0.8480917934647044150661012721"
"2020-12-31T00:00:00.000","Skagit","WA","Truck","1","0","1","32797","32798","0.003048966400390267699249954266"
"2020-12-31T00:00:00.000","Skamania","WA","Truck","0","0","0","4007","4007","0"
"2020-12-31T00:00:00.000","Skamania","WA","Passenger","37","22","59","8352","8411","0.7014623707050291285221733444"
"2020-12-31T00:00:00.000","Snohomish","WA","Truck","0","0","0","125741","125741","0"
"2020-12-31T00:00:00.000","Snohomish","WA","Passenger","5184","1950","7134","538694","545828","1.307005137149431689103527118"
"2020-12-31T00:00:00.000","Spokane","WA","Truck","0","0","0","100768","100768","0"
"2020-12-31T00:00:00.000","Spokane","WA","Passenger","925","585","1510","321270","322780","0.4678108928682074477972612925"
"2020-12-31T00:00:00.000","Stevens","WA","Truck","0","0","0","18720","18720","0"
"2020-12-31T00:00:00.000","Stevens","WA","Passenger","39","40","79","30241","30320","0.2605540897097625329815303430"
"2020-12-31T00:00:00.000","Thurston","WA","Passenger","1405","830","2235","197561","199796","1.118641013834110793008869046"
"2020-12-31T00:00:00.000","Thurston","WA","Truck","0","0","0","56451","56451","0"
"2020-12-31T00:00:00.000","Wahkiakum","WA","Truck","0","0","0","1771","1771","0"
"2020-12-31T00:00:00.000","Wahkiakum","WA","Passenger","6","8","14","3038","3052","0.4587155963302752293577981651"
"2020-12-31T00:00:00.000","Walla Walla","WA","Truck","0","0","0","13879","13879","0"
"2020-12-31T00:00:00.000","Walla Walla","WA","Passenger","99","71","170","36156","36326","0.4679843638165501293839123493"
"2020-12-31T00:00:00.000","Whatcom","WA","Passenger","1272","572","1844","150055","151899","1.213964542228717766410575448"
"2020-12-31T00:00:00.000","Whatcom","WA","Truck","3","0","3","43558","43561","0.006886894240260783728564541677"
"2020-12-31T00:00:00.000","Whitman","WA","Truck","0","0","0","8514","8514","0"
"2020-12-31T00:00:00.000","Whitman","WA","Passenger","53","47","100","21931","22031","0.4539058599246516272525078299"
"2020-12-31T00:00:00.000","Yakima","WA","Passenger","185","137","322","167339","167661","0.1920542046152653270587673937"
"2020-12-31T00:00:00.000","Yakima","WA","Truck","0","0","0","61001","61001","0"
"2020-12-31T00:00:00.000","Ozaukee","WI","Passenger","0","1","1","3","4","25.00"
"2020-12-31T00:00:00.000",,,"Passenger","1","0","1","173","174","0.5747126436781609195402298851"
"2021-01-31T00:00:00.000","Anchorage","AK","Passenger","1","0","1","140","141","0.7092198581560283687943262411"
"2021-01-31T00:00:00.000","Fairbanks North Star","AK","Passenger","0","1","1","87","88","1.136363636363636363636363636"
"2021-01-31T00:00:00.000","Juneau","AK","Passenger","0","1","1","24","25","4.00"
"2021-01-31T00:00:00.000","Sevier","AR","Passenger","0","1","1","0","1","100"
"2021-01-31T00:00:00.000","Maricopa","AZ","Passenger","6","5","11","1112","1123","0.9795191451469278717720391808"
"2021-01-31T00:00:00.000","Pima","AZ","Passenger","2","1","3","282","285","1.052631578947368421052631579"
"2021-01-31T00:00:00.000","Alameda","CA","Passenger","3","0","3","242","245","1.224489795918367346938775510"
"2021-01-31T00:00:00.000","Contra Costa","CA","Passenger","2","4","6","314","320","1.87500"
"2021-01-31T00:00:00.000","El Dorado","CA","Passenger","1","0","1","31","32","3.12500"
"2021-01-31T00:00:00.000","Fresno","CA","Passenger","1","0","1","167","168","0.5952380952380952380952380952"
"2021-01-31T00:00:00.000","Kern","CA","Passenger","1","1","2","207","209","0.9569377990430622009569377990"
"2021-01-31T00:00:00.000","Los Angeles","CA","Passenger","9","10","19","870","889","2.137232845894263217097862767"
"2021-01-31T00:00:00.000","Monterey","CA","Passenger","1","1","2","144","146","1.369863013698630136986301370"
"2021-01-31T00:00:00.000","Orange","CA","Passenger","3","3","6","428","434","1.382488479262672811059907834"
"2021-01-31T00:00:00.000","Placer","CA","Passenger","1","0","1","73","74","1.351351351351351351351351351"
"2021-01-31T00:00:00.000","Riverside","CA","Passenger","4","1","5","542","547","0.9140767824497257769652650823"
"2021-01-31T00:00:00.000","Sacramento","CA","Passenger","2","0","2","225","227","0.8810572687224669603524229075"
"2021-01-31T00:00:00.000","San Bernardino","CA","Passenger","0","1","1","386","387","0.2583979328165374677002583979"
"2021-01-31T00:00:00.000","San Diego","CA","Passenger","14","6","20","2715","2735","0.7312614259597806215722120658"
"2021-01-31T00:00:00.000","San Francisco","CA","Passenger","1","1","2","80","82","2.439024390243902439024390244"
"2021-01-31T00:00:00.000","San Mateo","CA","Passenger","0","1","1","101","102","0.9803921568627450980392156863"
"2021-01-31T00:00:00.000","Santa Barbara","CA","Passenger","2","0","2","75","77","2.597402597402597402597402597"
"2021-01-31T00:00:00.000","Santa Clara","CA","Passenger","6","2","8","246","254","3.149606299212598425196850394"
"2021-01-31T00:00:00.000","Santa Cruz","CA","Passenger","1","0","1","27","28","3.571428571428571428571428571"
"2021-01-31T00:00:00.000","Solano","CA","Passenger","1","0","1","204","205","0.4878048780487804878048780488"
"2021-01-31T00:00:00.000","Ventura","CA","Passenger","1","2","3","267","270","1.111111111111111111111111111"
"2021-01-31T00:00:00.000","Arapahoe","CO","Passenger","1","0","1","115","116","0.8620689655172413793103448276"
"2021-01-31T00:00:00.000","Boulder","CO","Passenger","0","1","1","33","34","2.941176470588235294117647059"
"2021-01-31T00:00:00.000","Denver","CO","Passenger","1","0","1","106","107","0.9345794392523364485981308411"
"2021-01-31T00:00:00.000","El Paso","CO","Passenger","2","0","2","655","657","0.3044140030441400304414003044"
"2021-01-31T00:00:00.000","Larimer","CO","Passenger","1","1","2","42","44","4.545454545454545454545454545"
"2021-01-31T00:00:00.000","New London","CT","Passenger","0","2","2","238","240","0.8333333333333333333333333333"
"2021-01-31T00:00:00.000","District of Columbia","DC","Passenger","2","3","5","200","205","2.439024390243902439024390244"
"2021-01-31T00:00:00.000","Kent","DE","Passenger","0","1","1","66","67","1.492537313432835820895522388"
"2021-01-31T00:00:00.000","New Castle","DE","Passenger","1","0","1","27","28","3.571428571428571428571428571"
"2021-01-31T00:00:00.000","Broward","FL","Passenger","1","1","2","99","101","1.980198019801980198019801980"
"2021-01-31T00:00:00.000","Duval","FL","Passenger","0","1","1","327","328","0.3048780487804878048780487805"
"2021-01-31T00:00:00.000","Lake","FL","Passenger","1","0","1","18","19","5.263157894736842105263157895"
"2021-01-31T00:00:00.000","Nassau","FL","Passenger","1","0","1","25","26","3.846153846153846153846153846"
"2021-01-31T00:00:00.000","Okaloosa","FL","Passenger","0","1","1","125","126","0.7936507936507936507936507937"
"2021-01-31T00:00:00.000","Orange","FL","Passenger","1","0","1","102","103","0.9708737864077669902912621359"
"2021-01-31T00:00:00.000","Palm Beach","FL","Passenger","0","1","1","59","60","1.666666666666666666666666667"
"2021-01-31T00:00:00.000","Pinellas","FL","Passenger","1","1","2","82","84","2.380952380952380952380952381"
"2021-01-31T00:00:00.000","Polk","FL","Passenger","1","0","1","55","56","1.785714285714285714285714286"
"2021-01-31T00:00:00.000","Sarasota","FL","Passenger","2","0","2","25","27","7.407407407407407407407407407"
"2021-01-31T00:00:00.000","St. Johns","FL","Passenger","0","1","1","43","44","2.272727272727272727272727273"
"2021-01-31T00:00:00.000","Sumter","FL","Passenger","0","1","1","10","11","9.090909090909090909090909091"
"2021-01-31T00:00:00.000","Bartow","GA","Passenger","0","1","1","3","4","25.00"
"2021-01-31T00:00:00.000","Bryan","GA","Passenger","1","0","1","50","51","1.960784313725490196078431373"
"2021-01-31T00:00:00.000","Camden","GA","Passenger","0","1","1","133","134","0.7462686567164179104477611940"
"2021-01-31T00:00:00.000","Columbia","GA","Passenger","1","0","1","124","125","0.800"
"2021-01-31T00:00:00.000","DeKalb","GA","Passenger","1","0","1","59","60","1.666666666666666666666666667"
"2021-01-31T00:00:00.000","Fulton","GA","Passenger","0","2","2","80","82","2.439024390243902439024390244"
"2021-01-31T00:00:00.000","Houston","GA","Passenger","1","0","1","50","51","1.960784313725490196078431373"
"2021-01-31T00:00:00.000","Jones","GA","Passenger","1","0","1","1","2","50.0"
"2021-01-31T00:00:00.000","Liberty","GA","Passenger","1","0","1","114","115","0.8695652173913043478260869565"
"2021-01-31T00:00:00.000","Honolulu","HI","Passenger","5","1","6","387","393","1.526717557251908396946564885"
"2021-01-31T00:00:00.000","Maui","HI","Passenger","1","0","1","24","25","4.00"
"2021-01-31T00:00:00.000","Twin Falls","ID","Passenger","0","1","1","18","19","5.263157894736842105263157895"
"2021-01-31T00:00:00.000","DuPage","IL","Passenger","2","0","2","48","50","4.00"
"2021-01-31T00:00:00.000","Lake","IL","Passenger","3","0","3","163","166","1.807228915662650602409638554"
"2021-01-31T00:00:00.000","Monroe","IL","Passenger","1","0","1","2","3","33.33333333333333333333333333"
"2021-01-31T00:00:00.000","St. Clair","IL","Passenger","1","0","1","135","136","0.7352941176470588235294117647"
"2021-01-31T00:00:00.000","DeKalb","IN","Passenger","1","0","1","0","1","100"
"2021-01-31T00:00:00.000","Hamilton","IN","Passenger","2","0","2","33","35","5.714285714285714285714285714"
"2021-01-31T00:00:00.000","Howard","IN","Passenger","0","1","1","3","4","25.00"
"2021-01-31T00:00:00.000","Vigo","IN","Passenger","1","0","1","5","6","16.66666666666666666666666667"
"2021-01-31T00:00:00.000","Leavenworth","KS","Passenger","0","1","1","118","119","0.8403361344537815126050420168"
"2021-01-31T00:00:00.000","Sedgwick","KS","Passenger","1","0","1","85","86","1.162790697674418604651162791"
"2021-01-31T00:00:00.000","Oldham","KY","Passenger","0","1","1","4","5","20.0"
"2021-01-31T00:00:00.000","Plaquemines","LA","Passenger","0","1","1","13","14","7.142857142857142857142857143"
"2021-01-31T00:00:00.000","Hampshire","MA","Passenger","1","0","1","4","5","20.0"
"2021-01-31T00:00:00.000","Middlesex","MA","Passenger","1","1","2","89","91","2.197802197802197802197802198"
"2021-01-31T00:00:00.000","Suffolk","MA","Passenger","0","2","2","33","35","5.714285714285714285714285714"
"2021-01-31T00:00:00.000","Anne Arundel","MD","Passenger","3","1","4","389","393","1.017811704834605597964376590"
"2021-01-31T00:00:00.000","Calvert","MD","Passenger","0","2","2","84","86","2.325581395348837209302325581"
"2021-01-31T00:00:00.000","Carroll","MD","Passenger","0","1","1","16","17","5.882352941176470588235294118"
"2021-01-31T00:00:00.000","Charles","MD","Passenger","1","1","2","66","68","2.941176470588235294117647059"
"2021-01-31T00:00:00.000","Frederick","MD","Passenger","2","1","3","72","75","4.00"
"2021-01-31T00:00:00.000","Howard","MD","Passenger","0","1","1","61","62","1.612903225806451612903225806"
"2021-01-31T00:00:00.000","Montgomery","MD","Passenger","1","2","3","227","230","1.304347826086956521739130435"
"2021-01-31T00:00:00.000","Prince George's","MD","Passenger","1","0","1","138","139","0.7194244604316546762589928058"
"2021-01-31T00:00:00.000","St. Mary's","MD","Passenger","1","0","1","190","191","0.5235602094240837696335078534"
"2021-01-31T00:00:00.000","Penobscot","ME","Passenger","0","1","1","10","11","9.090909090909090909090909091"
"2021-01-31T00:00:00.000","Kent","MI","Passenger","0","1","1","20","21","4.761904761904761904761904762"
"2021-01-31T00:00:00.000","Saginaw","MI","Passenger","2","0","2","10","12","16.66666666666666666666666667"
"2021-01-31T00:00:00.000","Washtenaw","MI","Passenger","1","0","1","25","26","3.846153846153846153846153846"
"2021-01-31T00:00:00.000","Hennepin","MN","Passenger","1","0","1","71","72","1.388888888888888888888888889"
"2021-01-31T00:00:00.000","Kanabec","MN","Passenger","1","0","1","0","1","100"
"2021-01-31T00:00:00.000","Ramsey","MN","Passenger","1","0","1","31","32","3.12500"
"2021-01-31T00:00:00.000","Boone","MO","Passenger","0","1","1","9","10","10.0"
"2021-01-31T00:00:00.000","Greene","MO","Passenger","0","1","1","25","26","3.846153846153846153846153846"
"2021-01-31T00:00:00.000","Platte","MO","Passenger","1","0","1","17","18","5.555555555555555555555555556"
"2021-01-31T00:00:00.000","Ray","MO","Passenger","0","1","1","0","1","100"
"2021-01-31T00:00:00.000","St. Louis","MO","Passenger","1","0","1","90","91","1.098901098901098901098901099"
"2021-01-31T00:00:00.000","Harrison","MS","Passenger","2","0","2","52","54","3.703703703703703703703703704"
"2021-01-31T00:00:00.000","Cascade","MT","Passenger","0","1","1","56","57","1.754385964912280701754385965"
"2021-01-31T00:00:00.000","Flathead","MT","Passenger","1","0","1","44","45","2.222222222222222222222222222"
"2021-01-31T00:00:00.000","Glacier","MT","Passenger","0","1","1","6","7","14.28571428571428571428571429"
"2021-01-31T00:00:00.000","Missoula","MT","Passenger","1","0","1","56","57","1.754385964912280701754385965"
"2021-01-31T00:00:00.000","Cumberland","NC","Passenger","0","2","2","446","448","0.4464285714285714285714285714"
"2021-01-31T00:00:00.000","Moore","NC","Passenger","0","1","1","144","145","0.6896551724137931034482758621"
"2021-01-31T00:00:00.000","Williams","ND","Passenger","0","1","1","10","11","9.090909090909090909090909091"
"2021-01-31T00:00:00.000","Douglas","NE","Passenger","1","1","2","52","54","3.703703703703703703703703704"
"2021-01-31T00:00:00.000","Carroll","NH","Passenger","0","1","1","3","4","25.00"
"2021-01-31T00:00:00.000","Camden","NJ","Passenger","0","1","1","15","16","6.2500"
"2021-01-31T00:00:00.000","Hudson","NJ","Passenger","1","0","1","136","137","0.7299270072992700729927007299"
"2021-01-31T00:00:00.000","Morris","NJ","Passenger","1","0","1","17","18","5.555555555555555555555555556"
"2021-01-31T00:00:00.000","Chaves","NM","Passenger","1","0","1","9","10","10.0"
"2021-01-31T00:00:00.000","Carson City","NV","Passenger","1","0","1","12","13","7.692307692307692307692307692"
"2021-01-31T00:00:00.000","Clark","NV","Passenger","4","4","8","616","624","1.282051282051282051282051282"
"2021-01-31T00:00:00.000","Washoe","NV","Passenger","1","0","1","78","79","1.265822784810126582278481013"
"2021-01-31T00:00:00.000","Erie","NY","Passenger","1","0","1","37","38","2.631578947368421052631578947"
"2021-01-31T00:00:00.000","Jefferson","NY","Passenger","0","1","1","213","214","0.4672897196261682242990654206"
"2021-01-31T00:00:00.000","Kings","NY","Passenger","1","0","1","54","55","1.818181818181818181818181818"
"2021-01-31T00:00:00.000","Nassau","NY","Passenger","2","0","2","23","25","8.00"
"2021-01-31T00:00:00.000","New York","NY","Passenger","1","0","1","56","57","1.754385964912280701754385965"
"2021-01-31T00:00:00.000","Queens","NY","Passenger","1","0","1","47","48","2.083333333333333333333333333"
"2021-01-31T00:00:00.000","Westchester","NY","Passenger","0","1","1","18","19","5.263157894736842105263157895"
"2021-01-31T00:00:00.000","Montgomery","OH","Passenger","0","1","1","48","49","2.040816326530612244897959184"
"2021-01-31T00:00:00.000","Shelby","OH","Passenger","0","1","1","1","2","50.0"
"2021-01-31T00:00:00.000","Rogers","OK","Passenger","1","0","1","5","6","16.66666666666666666666666667"
"2021-01-31T00:00:00.000","Tulsa","OK","Passenger","1","1","2","35","37","5.405405405405405405405405405"
"2021-01-31T00:00:00.000","Clackamas","OR","Passenger","3","0","3","158","161","1.863354037267080745341614907"
"2021-01-31T00:00:00.000","Deschutes","OR","Passenger","1","0","1","110","111","0.9009009009009009009009009009"
"2021-01-31T00:00:00.000","Klamath","OR","Passenger","1","0","1","23","24","4.166666666666666666666666667"
"2021-01-31T00:00:00.000","Multnomah","OR","Passenger","3","4","7","624","631","1.109350237717908082408874802"
"2021-01-31T00:00:00.000","Washington","OR","Passenger","1","0","1","360","361","0.2770083102493074792243767313"
"2021-01-31T00:00:00.000","Allegheny","PA","Passenger","1","1","2","57","59","3.389830508474576271186440678"
"2021-01-31T00:00:00.000","Bucks","PA","Passenger","1","0","1","19","20","5.00"
"2021-01-31T00:00:00.000","Montgomery","PA","Passenger","1","0","1","20","21","4.761904761904761904761904762"
"2021-01-31T00:00:00.000","Philadelphia","PA","Passenger","1","0","1","57","58","1.724137931034482758620689655"
"2021-01-31T00:00:00.000","RÃ­o Grande","PR","Passenger","1","0","1","1","2","50.0"
"2021-01-31T00:00:00.000","Newport","RI","Passenger","1","0","1","83","84","1.190476190476190476190476190"
"2021-01-31T00:00:00.000","Charleston","SC","Passenger","1","0","1","81","82","1.219512195121951219512195122"
"2021-01-31T00:00:00.000","Richland","SC","Passenger","0","1","1","138","139","0.7194244604316546762589928058"
"2021-01-31T00:00:00.000","Spartanburg","SC","Passenger","0","1","1","37","38","2.631578947368421052631578947"
"2021-01-31T00:00:00.000","Pennington","SD","Passenger","1","0","1","33","34","2.941176470588235294117647059"
"2021-01-31T00:00:00.000","Bradley","TN","Passenger","1","0","1","0","1","100"
"2021-01-31T00:00:00.000","Davidson","TN","Passenger","1","0","1","47","48","2.083333333333333333333333333"
"2021-01-31T00:00:00.000","Putnam","TN","Passenger","0","1","1","1","2","50.0"
"2021-01-31T00:00:00.000","Tipton","TN","Passenger","1","0","1","14","15","6.666666666666666666666666667"
"2021-01-31T00:00:00.000","Bell","TX","Passenger","0","1","1","365","366","0.2732240437158469945355191257"
"2021-01-31T00:00:00.000","Bexar","TX","Passenger","5","5","10","522","532","1.879699248120300751879699248"
"2021-01-31T00:00:00.000","Dallas","TX","Passenger","1","0","1","156","157","0.6369426751592356687898089172"
"2021-01-31T00:00:00.000","El Paso","TX","Passenger","2","0","2","381","383","0.5221932114882506527415143603"
"2021-01-31T00:00:00.000","Harris","TX","Passenger","1","0","1","203","204","0.4901960784313725490196078431"
"2021-01-31T00:00:00.000","Hidalgo","TX","Passenger","0","1","1","56","57","1.754385964912280701754385965"
"2021-01-31T00:00:00.000","Montgomery","TX","Passenger","1","0","1","36","37","2.702702702702702702702702703"
"2021-01-31T00:00:00.000","Nueces","TX","Passenger","1","0","1","77","78","1.282051282051282051282051282"
"2021-01-31T00:00:00.000","Travis","TX","Passenger","2","2","4","150","154","2.597402597402597402597402597"
"2021-01-31T00:00:00.000","Wichita","TX","Passenger","1","0","1","41","42","2.380952380952380952380952381"
"2021-01-31T00:00:00.000","Salt Lake","UT","Passenger","0","2","2","153","155","1.290322580645161290322580645"
"2021-01-31T00:00:00.000","Utah","UT","Passenger","0","1","1","115","116","0.8620689655172413793103448276"
"2021-01-31T00:00:00.000","Albemarle","VA","Passenger","1","0","1","20","21","4.761904761904761904761904762"
"2021-01-31T00:00:00.000","Alexandria","VA","Passenger","4","0","4","139","143","2.797202797202797202797202797"
"2021-01-31T00:00:00.000","Arlington","VA","Passenger","0","1","1","130","131","0.7633587786259541984732824427"
"2021-01-31T00:00:00.000","Chesapeake","VA","Passenger","0","3","3","402","405","0.7407407407407407407407407407"
"2021-01-31T00:00:00.000","Fairfax","VA","Passenger","4","4","8","683","691","1.157742402315484804630969609"
"2021-01-31T00:00:00.000","Goochland","VA","Passenger","4","1","5","202","207","2.415458937198067632850241546"
"2021-01-31T00:00:00.000","Loudoun","VA","Passenger","1","0","1","68","69","1.449275362318840579710144928"
"2021-01-31T00:00:00.000","Manassas","VA","Passenger","0","1","1","4","5","20.0"
"2021-01-31T00:00:00.000","Norfolk","VA","Passenger","1","1","2","333","335","0.5970149253731343283582089552"
"2021-01-31T00:00:00.000","Portsmouth","VA","Passenger","0","1","1","63","64","1.562500"
"2021-01-31T00:00:00.000","Powhatan","VA","Passenger","1","0","1","1","2","50.0"
"2021-01-31T00:00:00.000","Prince William","VA","Passenger","1","1","2","211","213","0.9389671361502347417840375587"
"2021-01-31T00:00:00.000","Stafford","VA","Passenger","2","1","3","94","97","3.092783505154639175257731959"
"2021-01-31T00:00:00.000","Suffolk","VA","Passenger","1","0","1","108","109","0.9174311926605504587155963303"
"2021-01-31T00:00:00.000","Virginia Beach","VA","Passenger","3","0","3","598","601","0.4991680532445923460898502496"
"2021-01-31T00:00:00.000","Adams","WA","Passenger","10","8","18","12973","12991","0.1385574628589023169886844739"
"2021-01-31T00:00:00.000","Adams","WA","Truck","0","0","0","5349","5349","0"
"2021-01-31T00:00:00.000","Asotin","WA","Truck","0","0","0","6696","6696","0"
"2021-01-31T00:00:00.000","Asotin","WA","Passenger","17","14","31","12451","12482","0.2483576349943919243710943759"
"2021-01-31T00:00:00.000","Benton","WA","Truck","0","0","0","43343","43343","0"
"2021-01-31T00:00:00.000","Benton","WA","Passenger","464","368","832","135202","136034","0.6116118029316200361674287311"
"2021-01-31T00:00:00.000","Chelan","WA","Truck","0","0","0","22853","22853","0"
"2021-01-31T00:00:00.000","Chelan","WA","Passenger","298","86","384","54490","54874","0.6997849619127455625615045377"
"2021-01-31T00:00:00.000","Clallam","WA","Truck","1","0","1","21875","21876","0.004571219601389650758822453831"
"2021-01-31T00:00:00.000","Clallam","WA","Passenger","294","194","488","49982","50470","0.9669110362591638597186447394"
"2021-01-31T00:00:00.000","Clark","WA","Passenger","2563","1255","3818","319415","323233","1.181191276880764030900310302"
"2021-01-31T00:00:00.000","Clark","WA","Truck","0","0","0","83591","83591","0"
"2021-01-31T00:00:00.000","Columbia","WA","Truck","0","0","0","1548","1548","0"
"2021-01-31T00:00:00.000","Columbia","WA","Passenger","5","3","8","2451","2459","0.3253355022366815778771858479"
"2021-01-31T00:00:00.000","Cowlitz","WA","Passenger","199","139","338","72161","72499","0.4662133270803735223934123229"
"2021-01-31T00:00:00.000","Cowlitz","WA","Truck","0","0","0","28984","28984","0"
"2021-01-31T00:00:00.000","Douglas","WA","Passenger","85","47","132","28212","28344","0.4657070279424216765453005927"
"2021-01-31T00:00:00.000","Douglas","WA","Truck","0","0","0","12513","12513","0"
"2021-01-31T00:00:00.000","Ferry","WA","Truck","0","0","0","3604","3604","0"
"2021-01-31T00:00:00.000","Ferry","WA","Passenger","9","3","12","4343","4355","0.2755453501722158438576349024"
"2021-01-31T00:00:00.000","Franklin","WA","Passenger","97","89","186","61514","61700","0.3014586709886547811993517018"
"2021-01-31T00:00:00.000","Franklin","WA","Truck","0","0","0","20497","20497","0"
"2021-01-31T00:00:00.000","Garfield","WA","Passenger","0","2","2","1364","1366","0.1464128843338213762811127379"
"2021-01-31T00:00:00.000","Garfield","WA","Truck","0","0","0","1002","1002","0"
"2021-01-31T00:00:00.000","Grant","WA","Passenger","90","89","179","66118","66297","0.2699971341086323664720877264"
"2021-01-31T00:00:00.000","Grant","WA","Truck","0","0","0","27607","27607","0"
"2021-01-31T00:00:00.000","Grays Harbor","WA","Truck","0","0","0","21243","21243","0"
"2021-01-31T00:00:00.000","Grays Harbor","WA","Passenger","150","132","282","48775","49057","0.5748415108954889210510222802"
"2021-01-31T00:00:00.000","Island","WA","Passenger","542","311","853","63104","63957","1.333708585455853151336053911"
"2021-01-31T00:00:00.000","Island","WA","Truck","0","0","0","21439","21439","0"
"2021-01-31T00:00:00.000","Jefferson","WA","Truck","0","0","0","9602","9602","0"
"2021-01-31T00:00:00.000","Jefferson","WA","Passenger","296","177","473","24799","25272","1.871636593858816081038303261"
"2021-01-31T00:00:00.000","King","WA","Passenger","28206","8633","36839","1367547","1404386","2.623139222407514743097695363"
"2021-01-31T00:00:00.000","King","WA","Truck","6","1","7","184424","184431","0.003795457379724666677510830609"
"2021-01-31T00:00:00.000","Kitsap","WA","Passenger","1682","800","2482","179480","181962","1.364021059342060430199712028"
"2021-01-31T00:00:00.000","Kitsap","WA","Truck","0","0","0","54371","54371","0"
"2021-01-31T00:00:00.000","Kittitas","WA","Passenger","139","55","194","29842","30036","0.6458915967505659874816886403"
"2021-01-31T00:00:00.000","Kittitas","WA","Truck","0","0","0","14678","14678","0"
"2021-01-31T00:00:00.000","Klickitat","WA","Passenger","65","43","108","14996","15104","0.7150423728813559322033898305"
"2021-01-31T00:00:00.000","Klickitat","WA","Truck","0","0","0","8118","8118","0"
"2021-01-31T00:00:00.000","Lewis","WA","Truck","0","0","0","26724","26724","0"
"2021-01-31T00:00:00.000","Lewis","WA","Passenger","137","137","274","58886","59160","0.4631507775524002704530087897"
"2021-01-31T00:00:00.000","Lincoln","WA","Truck","0","0","0","4694","4694","0"
"2021-01-31T00:00:00.000","Lincoln","WA","Passenger","7","12","19","7635","7654","0.2482362163574601515547426182"
"2021-01-31T00:00:00.000","Mason","WA","Passenger","202","146","348","47682","48030","0.7245471580262336039975015615"
"2021-01-31T00:00:00.000","Mason","WA","Truck","0","0","0","21029","21029","0"
"2021-01-31T00:00:00.000","Okanogan","WA","Passenger","57","37","94","26144","26238","0.3582590136443326473054348655"
"2021-01-31T00:00:00.000","Okanogan","WA","Truck","0","0","0","16601","16601","0"
"2021-01-31T00:00:00.000","Pacific","WA","Truck","0","0","0","7805","7805","0"
"2021-01-31T00:00:00.000","Pacific","WA","Passenger","45","41","86","15787","15873","0.5418005418005418005418005418"
"2021-01-31T00:00:00.000","Pend Oreille","WA","Truck","0","0","0","5719","5719","0"
"2021-01-31T00:00:00.000","Pend Oreille","WA","Passenger","12","3","15","9184","9199","0.1630612023045983259049896728"
"2021-01-31T00:00:00.000","Pierce","WA","Passenger","3177","1900","5077","556066","561143","0.9047604621281919225580645219"
"2021-01-31T00:00:00.000","Pierce","WA","Truck","1","0","1","145003","145004","0.0006896361479683319080852941988"
"2021-01-31T00:00:00.000","San Juan","WA","Passenger","378","114","492","14026","14518","3.388896542223446755751480920"
"2021-01-31T00:00:00.000","San Juan","WA","Truck","0","0","0","5868","5868","0"
"2021-01-31T00:00:00.000","Skagit","WA","Passenger","543","265","808","91435","92243","0.8759472263477987489565603894"
"2021-01-31T00:00:00.000","Skagit","WA","Truck","1","0","1","32883","32884","0.003040992579978104853424157645"
"2021-01-31T00:00:00.000","Skamania","WA","Truck","0","0","0","4019","4019","0"
"2021-01-31T00:00:00.000","Skamania","WA","Passenger","38","23","61","8339","8400","0.7261904761904761904761904762"
"2021-01-31T00:00:00.000","Snohomish","WA","Truck","3","0","3","125738","125741","0.002385856641827248073420761724"
"2021-01-31T00:00:00.000","Snohomish","WA","Passenger","5327","1978","7305","538473","545778","1.338456295416817827028572057"
"2021-01-31T00:00:00.000","Spokane","WA","Truck","0","0","0","100944","100944","0"
"2021-01-31T00:00:00.000","Spokane","WA","Passenger","949","589","1538","321166","322704","0.4765977490207744558480836928"
"2021-01-31T00:00:00.000","Stevens","WA","Passenger","40","40","80","30280","30360","0.2635046113306982872200263505"
"2021-01-31T00:00:00.000","Stevens","WA","Truck","0","0","0","18756","18756","0"
"2021-01-31T00:00:00.000","Thurston","WA","Passenger","1432","844","2276","197627","199903","1.138552197815940731254658509"
"2021-01-31T00:00:00.000","Thurston","WA","Truck","0","0","0","56514","56514","0"
"2021-01-31T00:00:00.000","Wahkiakum","WA","Truck","0","0","0","1770","1770","0"
"2021-01-31T00:00:00.000","Wahkiakum","WA","Passenger","7","7","14","3042","3056","0.4581151832460732984293193717"
"2021-01-31T00:00:00.000","Walla Walla","WA","Truck","0","0","0","13907","13907","0"
"2021-01-31T00:00:00.000","Walla Walla","WA","Passenger","104","72","176","36187","36363","0.4840084701482275939828947007"
"2021-01-31T00:00:00.000","Whatcom","WA","Passenger","1306","586","1892","150114","152006","1.244687709695669907766798679"
"2021-01-31T00:00:00.000","Whatcom","WA","Truck","3","0","3","43618","43621","0.006877421425460214117053712661"
"2021-01-31T00:00:00.000","Whitman","WA","Passenger","53","49","102","21872","21974","0.4641849458450896514062073359"
"2021-01-31T00:00:00.000","Whitman","WA","Truck","1","0","1","8517","8518","0.01173984503404555059873209674"
"2021-01-31T00:00:00.000","Yakima","WA","Passenger","194","138","332","167611","167943","0.1976861196953728348308652340"
"2021-01-31T00:00:00.000","Yakima","WA","Truck","0","0","0","61102","61102","0"
"2021-01-31T00:00:00.000","Milwaukee","WI","Passenger","1","0","1","38","39","2.564102564102564102564102564"
"2021-01-31T00:00:00.000","Ozaukee","WI","Passenger","0","1","1","3","4","25.00"
"2021-01-31T00:00:00.000",,,"Passenger","1","0","1","170","171","0.5847953216374269005847953216"
"2021-02-28T00:00:00.000","Anchorage","AK","Passenger","1","0","1","138","139","0.7194244604316546762589928058"
"2021-02-28T00:00:00.000","Fairbanks North Star","AK","Passenger","0","1","1","86","87","1.149425287356321839080459770"
"2021-02-28T00:00:00.000","Juneau","AK","Passenger","0","1","1","24","25","4.00"
"2021-02-28T00:00:00.000","Sevier","AR","Passenger","0","1","1","0","1","100"
"2021-02-28T00:00:00.000","Maricopa","AZ","Passenger","5","5","10","1088","1098","0.9107468123861566484517304189"
"2021-02-28T00:00:00.000","Pima","AZ","Passenger","2","1","3","280","283","1.060070671378091872791519435"
"2021-02-28T00:00:00.000","Alameda","CA","Passenger","3","0","3","236","239","1.255230125523012552301255230"
"2021-02-28T00:00:00.000","Contra Costa","CA","Passenger","2","4","6","314","320","1.87500"
"2021-02-28T00:00:00.000","El Dorado","CA","Passenger","1","0","1","31","32","3.12500"
"2021-02-28T00:00:00.000","Fresno","CA","Passenger","1","0","1","166","167","0.5988023952095808383233532934"
"2021-02-28T00:00:00.000","Kern","CA","Passenger","1","1","2","210","212","0.9433962264150943396226415094"
"2021-02-28T00:00:00.000","Los Angeles","CA","Passenger","9","9","18","856","874","2.059496567505720823798627002"
"2021-02-28T00:00:00.000","Monterey","CA","Passenger","1","1","2","144","146","1.369863013698630136986301370"
"2021-02-28T00:00:00.000","Orange","CA","Passenger","3","3","6","424","430","1.395348837209302325581395349"
"2021-02-28T00:00:00.000","Placer","CA","Passenger","1","0","1","71","72","1.388888888888888888888888889"
"2021-02-28T00:00:00.000","Riverside","CA","Passenger","4","1","5","540","545","0.9174311926605504587155963303"
"2021-02-28T00:00:00.000","Sacramento","CA","Passenger","2","0","2","226","228","0.8771929824561403508771929825"
"2021-02-28T00:00:00.000","San Bernardino","CA","Passenger","0","1","1","379","380","0.2631578947368421052631578947"
"2021-02-28T00:00:00.000","San Diego","CA","Passenger","14","6","20","2687","2707","0.7388252678241595862578500185"
"2021-02-28T00:00:00.000","San Francisco","CA","Passenger","1","1","2","81","83","2.409638554216867469879518072"
"2021-02-28T00:00:00.000","San Mateo","CA","Passenger","0","1","1","98","99","1.010101010101010101010101010"
"2021-02-28T00:00:00.000","Santa Barbara","CA","Passenger","2","0","2","75","77","2.597402597402597402597402597"
"2021-02-28T00:00:00.000","Santa Clara","CA","Passenger","6","2","8","245","253","3.162055335968379446640316206"
"2021-02-28T00:00:00.000","Santa Cruz","CA","Passenger","1","0","1","30","31","3.225806451612903225806451613"
"2021-02-28T00:00:00.000","Solano","CA","Passenger","1","0","1","199","200","0.500"
"2021-02-28T00:00:00.000","Ventura","CA","Passenger","1","2","3","266","269","1.115241635687732342007434944"
"2021-02-28T00:00:00.000","Arapahoe","CO","Passenger","1","0","1","113","114","0.8771929824561403508771929825"
"2021-02-28T00:00:00.000","Boulder","CO","Passenger","0","1","1","34","35","2.857142857142857142857142857"
"2021-02-28T00:00:00.000","Denver","CO","Passenger","1","0","1","103","104","0.9615384615384615384615384615"
"2021-02-28T00:00:00.000","El Paso","CO","Passenger","2","0","2","651","653","0.3062787136294027565084226646"
"2021-02-28T00:00:00.000","Larimer","CO","Passenger","1","1","2","43","45","4.444444444444444444444444444"
"2021-02-28T00:00:00.000","New London","CT","Passenger","0","2","2","234","236","0.8474576271186440677966101695"
"2021-02-28T00:00:00.000","District of Columbia","DC","Passenger","2","3","5","200","205","2.439024390243902439024390244"
"2021-02-28T00:00:00.000","Kent","DE","Passenger","0","1","1","66","67","1.492537313432835820895522388"
"2021-02-28T00:00:00.000","New Castle","DE","Passenger","1","0","1","27","28","3.571428571428571428571428571"
"2021-02-28T00:00:00.000","Broward","FL","Passenger","1","0","1","99","100","1.00"
"2021-02-28T00:00:00.000","Duval","FL","Passenger","0","1","1","322","323","0.3095975232198142414860681115"
"2021-02-28T00:00:00.000","Lake","FL","Passenger","1","0","1","18","19","5.263157894736842105263157895"
"2021-02-28T00:00:00.000","Nassau","FL","Passenger","1","0","1","24","25","4.00"
"2021-02-28T00:00:00.000","Okaloosa","FL","Passenger","0","1","1","122","123","0.8130081300813008130081300813"
"2021-02-28T00:00:00.000","Orange","FL","Passenger","1","0","1","101","102","0.9803921568627450980392156863"
"2021-02-28T00:00:00.000","Palm Beach","FL","Passenger","0","1","1","59","60","1.666666666666666666666666667"
"2021-02-28T00:00:00.000","Pinellas","FL","Passenger","1","1","2","83","85","2.352941176470588235294117647"
"2021-02-28T00:00:00.000","Polk","FL","Passenger","1","0","1","53","54","1.851851851851851851851851852"
"2021-02-28T00:00:00.000","Sarasota","FL","Passenger","2","0","2","25","27","7.407407407407407407407407407"
"2021-02-28T00:00:00.000","St. Johns","FL","Passenger","0","1","1","42","43","2.325581395348837209302325581"
"2021-02-28T00:00:00.000","Sumter","FL","Passenger","0","1","1","10","11","9.090909090909090909090909091"
"2021-02-28T00:00:00.000","Bartow","GA","Passenger","0","1","1","3","4","25.00"
"2021-02-28T00:00:00.000","Bryan","GA","Passenger","1","0","1","50","51","1.960784313725490196078431373"
"2021-02-28T00:00:00.000","Camden","GA","Passenger","0","1","1","131","132","0.7575757575757575757575757576"
"2021-02-28T00:00:00.000","Columbia","GA","Passenger","1","0","1","122","123","0.8130081300813008130081300813"
"2021-02-28T00:00:00.000","DeKalb","GA","Passenger","1","0","1","59","60","1.666666666666666666666666667"
"2021-02-28T00:00:00.000","Fulton","GA","Passenger","0","2","2","79","81","2.469135802469135802469135802"
"2021-02-28T00:00:00.000","Houston","GA","Passenger","1","0","1","48","49","2.040816326530612244897959184"
"2021-02-28T00:00:00.000","Jones","GA","Passenger","1","0","1","1","2","50.0"
"2021-02-28T00:00:00.000","Liberty","GA","Passenger","1","0","1","114","115","0.8695652173913043478260869565"
"2021-02-28T00:00:00.000","Honolulu","HI","Passenger","5","1","6","380","386","1.554404145077720207253886010"
"2021-02-28T00:00:00.000","Maui","HI","Passenger","1","0","1","25","26","3.846153846153846153846153846"
"2021-02-28T00:00:00.000","Twin Falls","ID","Passenger","0","1","1","15","16","6.2500"
"2021-02-28T00:00:00.000","DuPage","IL","Passenger","2","0","2","48","50","4.00"
"2021-02-28T00:00:00.000","Lake","IL","Passenger","3","0","3","157","160","1.87500"
"2021-02-28T00:00:00.000","Monroe","IL","Passenger","1","0","1","2","3","33.33333333333333333333333333"
"2021-02-28T00:00:00.000","St. Clair","IL","Passenger","1","0","1","136","137","0.7299270072992700729927007299"
"2021-02-28T00:00:00.000","DeKalb","IN","Passenger","1","0","1","0","1","100"
"2021-02-28T00:00:00.000","Hamilton","IN","Passenger","2","0","2","33","35","5.714285714285714285714285714"
"2021-02-28T00:00:00.000","Howard","IN","Passenger","0","1","1","3","4","25.00"
"2021-02-28T00:00:00.000","Vigo","IN","Passenger","1","0","1","4","5","20.0"
"2021-02-28T00:00:00.000","Leavenworth","KS","Passenger","0","1","1","118","119","0.8403361344537815126050420168"
"2021-02-28T00:00:00.000","Sedgwick","KS","Passenger","1","0","1","85","86","1.162790697674418604651162791"
"2021-02-28T00:00:00.000","Oldham","KY","Passenger","0","1","1","4","5","20.0"
"2021-02-28T00:00:00.000","Plaquemines","LA","Passenger","0","1","1","13","14","7.142857142857142857142857143"
"2021-02-28T00:00:00.000","Hampshire","MA","Passenger","1","0","1","4","5","20.0"
"2021-02-28T00:00:00.000","Middlesex","MA","Passenger","1","1","2","90","92","2.173913043478260869565217391"
"2021-02-28T00:00:00.000","Suffolk","MA","Passenger","0","2","2","35","37","5.405405405405405405405405405"
"2021-02-28T00:00:00.000","Anne Arundel","MD","Passenger","3","1","4","384","388","1.030927835051546391752577320"
"2021-02-28T00:00:00.000","Calvert","MD","Passenger","0","2","2","84","86","2.325581395348837209302325581"
"2021-02-28T00:00:00.000","Carroll","MD","Passenger","0","1","1","17","18","5.555555555555555555555555556"
"2021-02-28T00:00:00.000","Charles","MD","Passenger","1","1","2","66","68","2.941176470588235294117647059"
"2021-02-28T00:00:00.000","Frederick","MD","Passenger","2","1","3","71","74","4.054054054054054054054054054"
"2021-02-28T00:00:00.000","Howard","MD","Passenger","0","1","1","60","61","1.639344262295081967213114754"
"2021-02-28T00:00:00.000","Montgomery","MD","Passenger","1","2","3","228","231","1.298701298701298701298701299"
"2021-02-28T00:00:00.000","Prince George's","MD","Passenger","1","0","1","132","133","0.7518796992481203007518796992"
"2021-02-28T00:00:00.000","St. Mary's","MD","Passenger","1","0","1","189","190","0.5263157894736842105263157895"
"2021-02-28T00:00:00.000","Washington","MD","Passenger","1","0","1","10","11","9.090909090909090909090909091"
"2021-02-28T00:00:00.000","Penobscot","ME","Passenger","0","1","1","11","12","8.333333333333333333333333333"
"2021-02-28T00:00:00.000","Kent","MI","Passenger","0","1","1","21","22","4.545454545454545454545454545"
"2021-02-28T00:00:00.000","Saginaw","MI","Passenger","2","0","2","10","12","16.66666666666666666666666667"
"2021-02-28T00:00:00.000","Washtenaw","MI","Passenger","1","0","1","25","26","3.846153846153846153846153846"
"2021-02-28T00:00:00.000","Hennepin","MN","Passenger","1","0","1","69","70","1.428571428571428571428571429"
"2021-02-28T00:00:00.000","Kanabec","MN","Passenger","1","0","1","0","1","100"
"2021-02-28T00:00:00.000","Ramsey","MN","Passenger","1","0","1","30","31","3.225806451612903225806451613"
"2021-02-28T00:00:00.000","Boone","MO","Passenger","0","1","1","9","10","10.0"
"2021-02-28T00:00:00.000","Greene","MO","Passenger","0","1","1","24","25","4.00"
"2021-02-28T00:00:00.000","Platte","MO","Passenger","1","0","1","17","18","5.555555555555555555555555556"
"2021-02-28T00:00:00.000","Ray","MO","Passenger","0","1","1","0","1","100"
"2021-02-28T00:00:00.000","St. Louis","MO","Passenger","1","0","1","87","88","1.136363636363636363636363636"
"2021-02-28T00:00:00.000","Harrison","MS","Passenger","2","0","2","53","55","3.636363636363636363636363636"
"2021-02-28T00:00:00.000","Flathead","MT","Passenger","1","0","1","42","43","2.325581395348837209302325581"
"2021-02-28T00:00:00.000","Glacier","MT","Passenger","0","1","1","5","6","16.66666666666666666666666667"
"2021-02-28T00:00:00.000","Missoula","MT","Passenger","1","0","1","57","58","1.724137931034482758620689655"
"2021-02-28T00:00:00.000","Cumberland","NC","Passenger","0","2","2","445","447","0.4474272930648769574944071588"
"2021-02-28T00:00:00.000","Moore","NC","Passenger","0","1","1","141","142","0.7042253521126760563380281690"
"2021-02-28T00:00:00.000","Williams","ND","Passenger","0","1","1","10","11","9.090909090909090909090909091"
"2021-02-28T00:00:00.000","Douglas","NE","Passenger","1","1","2","51","53","3.773584905660377358490566038"
"2021-02-28T00:00:00.000","Carroll","NH","Passenger","0","1","1","3","4","25.00"
"2021-02-28T00:00:00.000","Camden","NJ","Passenger","0","1","1","13","14","7.142857142857142857142857143"
"2021-02-28T00:00:00.000","Hudson","NJ","Passenger","1","0","1","130","131","0.7633587786259541984732824427"
"2021-02-28T00:00:00.000","Morris","NJ","Passenger","1","0","1","17","18","5.555555555555555555555555556"
"2021-02-28T00:00:00.000","Chaves","NM","Passenger","1","0","1","8","9","11.11111111111111111111111111"
"2021-02-28T00:00:00.000","Carson City","NV","Passenger","1","0","1","12","13","7.692307692307692307692307692"
"2021-02-28T00:00:00.000","Clark","NV","Passenger","4","4","8","618","626","1.277955271565495207667731629"
"2021-02-28T00:00:00.000","Washoe","NV","Passenger","1","0","1","76","77","1.298701298701298701298701299"
"2021-02-28T00:00:00.000","Erie","NY","Passenger","1","0","1","37","38","2.631578947368421052631578947"
"2021-02-28T00:00:00.000","Jefferson","NY","Passenger","0","1","1","212","213","0.4694835680751173708920187793"
"2021-02-28T00:00:00.000","Kings","NY","Passenger","1","0","1","54","55","1.818181818181818181818181818"
"2021-02-28T00:00:00.000","Nassau","NY","Passenger","2","0","2","23","25","8.00"
"2021-02-28T00:00:00.000","New York","NY","Passenger","1","0","1","55","56","1.785714285714285714285714286"
"2021-02-28T00:00:00.000","Queens","NY","Passenger","2","0","2","46","48","4.166666666666666666666666667"
"2021-02-28T00:00:00.000","Westchester","NY","Passenger","0","1","1","18","19","5.263157894736842105263157895"
"2021-02-28T00:00:00.000","Montgomery","OH","Passenger","0","1","1","48","49","2.040816326530612244897959184"
"2021-02-28T00:00:00.000","Shelby","OH","Passenger","0","1","1","1","2","50.0"
"2021-02-28T00:00:00.000","Rogers","OK","Passenger","1","0","1","5","6","16.66666666666666666666666667"
"2021-02-28T00:00:00.000","Tulsa","OK","Passenger","1","1","2","36","38","5.263157894736842105263157895"
"2021-02-28T00:00:00.000","Clackamas","OR","Passenger","3","0","3","155","158","1.898734177215189873417721519"
"2021-02-28T00:00:00.000","Deschutes","OR","Passenger","1","0","1","110","111","0.9009009009009009009009009009"
"2021-02-28T00:00:00.000","Klamath","OR","Passenger","1","0","1","22","23","4.347826086956521739130434783"
"2021-02-28T00:00:00.000","Multnomah","OR","Passenger","3","4","7","617","624","1.121794871794871794871794872"
"2021-02-28T00:00:00.000","Washington","OR","Passenger","1","0","1","356","357","0.2801120448179271708683473389"
"2021-02-28T00:00:00.000","Allegheny","PA","Passenger","1","1","2","57","59","3.389830508474576271186440678"
"2021-02-28T00:00:00.000","Bucks","PA","Passenger","1","0","1","19","20","5.00"
"2021-02-28T00:00:00.000","Montgomery","PA","Passenger","1","0","1","19","20","5.00"
"2021-02-28T00:00:00.000","Philadelphia","PA","Passenger","1","0","1","55","56","1.785714285714285714285714286"
"2021-02-28T00:00:00.000","RÃ­o Grande","PR","Passenger","1","0","1","1","2","50.0"
"2021-02-28T00:00:00.000","Newport","RI","Passenger","1","0","1","83","84","1.190476190476190476190476190"
"2021-02-28T00:00:00.000","Charleston","SC","Passenger","1","0","1","79","80","1.2500"
"2021-02-28T00:00:00.000","Richland","SC","Passenger","0","1","1","137","138","0.7246376811594202898550724638"
"2021-02-28T00:00:00.000","Spartanburg","SC","Passenger","0","1","1","36","37","2.702702702702702702702702703"
"2021-02-28T00:00:00.000","Pennington","SD","Passenger","1","0","1","33","34","2.941176470588235294117647059"
"2021-02-28T00:00:00.000","Bradley","TN","Passenger","1","0","1","0","1","100"
"2021-02-28T00:00:00.000","Davidson","TN","Passenger","1","0","1","46","47","2.127659574468085106382978723"
"2021-02-28T00:00:00.000","Putnam","TN","Passenger","0","1","1","1","2","50.0"
"2021-02-28T00:00:00.000","Tipton","TN","Passenger","1","0","1","13","14","7.142857142857142857142857143"
"2021-02-28T00:00:00.000","Bell","TX","Passenger","0","1","1","363","364","0.2747252747252747252747252747"
"2021-02-28T00:00:00.000","Bexar","TX","Passenger","5","5","10","514","524","1.908396946564885496183206107"
"2021-02-28T00:00:00.000","Dallas","TX","Passenger","1","0","1","155","156","0.6410256410256410256410256410"
"2021-02-28T00:00:00.000","El Paso","TX","Passenger","2","0","2","377","379","0.5277044854881266490765171504"
"2021-02-28T00:00:00.000","Harris","TX","Passenger","1","0","1","198","199","0.5025125628140703517587939698"
"2021-02-28T00:00:00.000","Hidalgo","TX","Passenger","0","1","1","56","57","1.754385964912280701754385965"
"2021-02-28T00:00:00.000","Montgomery","TX","Passenger","1","0","1","37","38","2.631578947368421052631578947"
"2021-02-28T00:00:00.000","Nueces","TX","Passenger","1","0","1","75","76","1.315789473684210526315789474"
"2021-02-28T00:00:00.000","Travis","TX","Passenger","2","2","4","148","152","2.631578947368421052631578947"
"2021-02-28T00:00:00.000","Wichita","TX","Passenger","1","0","1","40","41","2.439024390243902439024390244"
"2021-02-28T00:00:00.000","Salt Lake","UT","Passenger","0","2","2","152","154","1.298701298701298701298701299"
"2021-02-28T00:00:00.000","Utah","UT","Passenger","0","1","1","114","115","0.8695652173913043478260869565"
"2021-02-28T00:00:00.000","Albemarle","VA","Passenger","1","0","1","20","21","4.761904761904761904761904762"
"2021-02-28T00:00:00.000","Alexandria","VA","Passenger","4","0","4","139","143","2.797202797202797202797202797"
"2021-02-28T00:00:00.000","Arlington","VA","Passenger","0","1","1","131","132","0.7575757575757575757575757576"
"2021-02-28T00:00:00.000","Chesapeake","VA","Passenger","0","3","3","399","402","0.7462686567164179104477611940"
"2021-02-28T00:00:00.000","Fairfax","VA","Passenger","4","5","9","678","687","1.310043668122270742358078603"
"2021-02-28T00:00:00.000","Goochland","VA","Passenger","4","1","5","199","204","2.450980392156862745098039216"
"2021-02-28T00:00:00.000","Loudoun","VA","Passenger","1","0","1","67","68","1.470588235294117647058823529"
"2021-02-28T00:00:00.000","Manassas","VA","Passenger","0","1","1","5","6","16.66666666666666666666666667"
"2021-02-28T00:00:00.000","Norfolk","VA","Passenger","1","1","2","328","330","0.6060606060606060606060606061"
"2021-02-28T00:00:00.000","Portsmouth","VA","Passenger","0","1","1","63","64","1.562500"
"2021-02-28T00:00:00.000","Powhatan","VA","Passenger","1","0","1","1","2","50.0"
"2021-02-28T00:00:00.000","Prince William","VA","Passenger","1","1","2","207","209","0.9569377990430622009569377990"
"2021-02-28T00:00:00.000","Stafford","VA","Passenger","2","1","3","95","98","3.061224489795918367346938776"
"2021-02-28T00:00:00.000","Suffolk","VA","Passenger","1","0","1","106","107","0.9345794392523364485981308411"
"2021-02-28T00:00:00.000","Virginia Beach","VA","Passenger","3","0","3","592","595","0.5042016806722689075630252101"
"2021-02-28T00:00:00.000","Adams","WA","Passenger","10","8","18","12977","12995","0.1385148133897652943439784533"
"2021-02-28T00:00:00.000","Adams","WA","Truck","0","0","0","5346","5346","0"
"2021-02-28T00:00:00.000","Asotin","WA","Truck","0","0","0","6704","6704","0"
"2021-02-28T00:00:00.000","Asotin","WA","Passenger","18","15","33","12499","12532","0.2633258857325247366741142675"
"2021-02-28T00:00:00.000","Benton","WA","Passenger","471","372","843","135129","135972","0.6199805842379313388050480981"
"2021-02-28T00:00:00.000","Benton","WA","Truck","0","0","0","43395","43395","0"
"2021-02-28T00:00:00.000","Chelan","WA","Passenger","305","87","392","54502","54894","0.7141035450140270339199183882"
"2021-02-28T00:00:00.000","Chelan","WA","Truck","0","0","0","22887","22887","0"
"2021-02-28T00:00:00.000","Clallam","WA","Passenger","294","199","493","50005","50498","0.9762762881698285080597251376"
"2021-02-28T00:00:00.000","Clallam","WA","Truck","1","0","1","21909","21910","0.004564125969876768598813327248"
"2021-02-28T00:00:00.000","Clark","WA","Passenger","2609","1288","3897","318968","322865","1.207006024189676799900887368"
"2021-02-28T00:00:00.000","Clark","WA","Truck","3","0","3","83559","83562","0.003590148632153371149565592016"
"2021-02-28T00:00:00.000","Columbia","WA","Truck","1","0","1","1543","1544","0.06476683937823834196891191710"
"2021-02-28T00:00:00.000","Columbia","WA","Passenger","5","4","9","2452","2461","0.3657049979683055668427468509"
"2021-02-28T00:00:00.000","Cowlitz","WA","Truck","0","0","0","28988","28988","0"
"2021-02-28T00:00:00.000","Cowlitz","WA","Passenger","206","140","346","71934","72280","0.4786939679026009961261759823"
"2021-02-28T00:00:00.000","Douglas","WA","Truck","1","0","1","12524","12525","0.007984031936127744510978043912"
"2021-02-28T00:00:00.000","Douglas","WA","Passenger","87","47","134","28263","28397","0.4718808324823044687819135824"
"2021-02-28T00:00:00.000","Ferry","WA","Passenger","10","3","13","4334","4347","0.2990568207959512307338394295"
"2021-02-28T00:00:00.000","Ferry","WA","Truck","0","0","0","3624","3624","0"
"2021-02-28T00:00:00.000","Franklin","WA","Truck","0","0","0","20516","20516","0"
"2021-02-28T00:00:00.000","Franklin","WA","Passenger","100","91","191","61622","61813","0.3089964894116124439842751525"
"2021-02-28T00:00:00.000","Garfield","WA","Passenger","0","2","2","1358","1360","0.1470588235294117647058823529"
"2021-02-28T00:00:00.000","Garfield","WA","Truck","0","0","0","1005","1005","0"
"2021-02-28T00:00:00.000","Grant","WA","Passenger","93","91","184","66088","66272","0.2776436504104297440849831000"
"2021-02-28T00:00:00.000","Grant","WA","Truck","0","0","0","27676","27676","0"
"2021-02-28T00:00:00.000","Grays Harbor","WA","Truck","1","0","1","21249","21250","0.004705882352941176470588235294"
"2021-02-28T00:00:00.000","Grays Harbor","WA","Passenger","159","136","295","48795","49090","0.6009370543898961091872071705"
"2021-02-28T00:00:00.000","Island","WA","Truck","0","0","0","21465","21465","0"
"2021-02-28T00:00:00.000","Island","WA","Passenger","560","312","872","63004","63876","1.365144968376228943578182729"
"2021-02-28T00:00:00.000","Jefferson","WA","Passenger","301","179","480","24788","25268","1.899635903118568940952984011"
"2021-02-28T00:00:00.000","Jefferson","WA","Truck","0","0","0","9581","9581","0"
"2021-02-28T00:00:00.000","King","WA","Passenger","28639","8749","37388","1365279","1402667","2.665493663143140888036861208"
"2021-02-28T00:00:00.000","King","WA","Truck","12","1","13","184399","184412","0.007049432791792291174110144676"
"2021-02-28T00:00:00.000","Kitsap","WA","Passenger","1718","813","2531","179520","182051","1.390269759572866943878363755"
"2021-02-28T00:00:00.000","Kitsap","WA","Truck","1","0","1","54352","54353","0.001839824848674406196530090335"
"2021-02-28T00:00:00.000","Kittitas","WA","Truck","0","0","0","14698","14698","0"
"2021-02-28T00:00:00.000","Kittitas","WA","Passenger","148","56","204","29832","30036","0.6791849780263683579704354774"
"2021-02-28T00:00:00.000","Klickitat","WA","Truck","0","0","0","8120","8120","0"
"2021-02-28T00:00:00.000","Klickitat","WA","Passenger","67","45","112","15006","15118","0.7408387352824447678264320677"
"2021-02-28T00:00:00.000","Lewis","WA","Passenger","138","139","277","58845","59122","0.4685227157403335475795812050"
"2021-02-28T00:00:00.000","Lewis","WA","Truck","0","0","0","26713","26713","0"
"2021-02-28T00:00:00.000","Lincoln","WA","Truck","0","0","0","4690","4690","0"
"2021-02-28T00:00:00.000","Lincoln","WA","Passenger","8","13","21","7651","7672","0.2737226277372262773722627737"
"2021-02-28T00:00:00.000","Mason","WA","Truck","0","0","0","21058","21058","0"
"2021-02-28T00:00:00.000","Mason","WA","Passenger","199","143","342","47643","47985","0.7127227258518286964676461394"
"2021-02-28T00:00:00.000","Okanogan","WA","Truck","0","0","0","16637","16637","0"
"2021-02-28T00:00:00.000","Okanogan","WA","Passenger","57","36","93","26138","26231","0.3545423354046738591742594640"
"2021-02-28T00:00:00.000","Pacific","WA","Truck","0","0","0","7831","7831","0"
"2021-02-28T00:00:00.000","Pacific","WA","Passenger","46","42","88","15812","15900","0.5534591194968553459119496855"
"2021-02-28T00:00:00.000","Pend Oreille","WA","Truck","1","0","1","5723","5724","0.01747030048916841369671558351"
"2021-02-28T00:00:00.000","Pend Oreille","WA","Passenger","12","4","16","9197","9213","0.1736676435471616194507760773"
"2021-02-28T00:00:00.000","Pierce","WA","Truck","5","0","5","145148","145153","0.003444641171729140975384594187"
"2021-02-28T00:00:00.000","Pierce","WA","Passenger","3241","1920","5161","555880","561041","0.9198971198183376972449428830"
"2021-02-28T00:00:00.000","San Juan","WA","Truck","0","0","0","5867","5867","0"
"2021-02-28T00:00:00.000","San Juan","WA","Passenger","384","119","503","14061","14564","3.453721505081021697335896732"
"2021-02-28T00:00:00.000","Skagit","WA","Truck","1","0","1","32873","32874","0.003041917624870718500942994464"
"2021-02-28T00:00:00.000","Skagit","WA","Passenger","562","270","832","91348","92180","0.9025819049685398134085484921"
"2021-02-28T00:00:00.000","Skamania","WA","Passenger","41","24","65","8292","8357","0.7777910733516812253200909417"
"2021-02-28T00:00:00.000","Skamania","WA","Truck","0","0","0","4031","4031","0"
"2021-02-28T00:00:00.000","Snohomish","WA","Passenger","5423","1995","7418","538359","545777","1.359163174703221279020552350"
"2021-02-28T00:00:00.000","Snohomish","WA","Truck","5","0","5","125784","125789","0.003974910365771251858270595998"
"2021-02-28T00:00:00.000","Spokane","WA","Passenger","963","600","1563","321592","323155","0.4836688276523649641812752394"
"2021-02-28T00:00:00.000","Spokane","WA","Truck","3","0","3","101070","101073","0.002968151731916535573298507020"
"2021-02-28T00:00:00.000","Stevens","WA","Passenger","41","42","83","30236","30319","0.2737557307299053398858801412"
"2021-02-28T00:00:00.000","Stevens","WA","Truck","0","0","0","18727","18727","0"
"2021-02-28T00:00:00.000","Thurston","WA","Passenger","1465","859","2324","197420","199744","1.163489266260813841717398270"
"2021-02-28T00:00:00.000","Thurston","WA","Truck","3","0","3","56511","56514","0.005308419152776303216902006582"
"2021-02-28T00:00:00.000","Wahkiakum","WA","Passenger","8","7","15","3047","3062","0.4898758981058131939908556499"
"2021-02-28T00:00:00.000","Wahkiakum","WA","Truck","0","0","0","1783","1783","0"
"2021-02-28T00:00:00.000","Walla Walla","WA","Passenger","106","73","179","36158","36337","0.4926108374384236453201970443"
"2021-02-28T00:00:00.000","Walla Walla","WA","Truck","0","0","0","13917","13917","0"
"2021-02-28T00:00:00.000","Whatcom","WA","Truck","3","0","3","43653","43656","0.006871907641561297416162726773"
"2021-02-28T00:00:00.000","Whatcom","WA","Passenger","1330","594","1924","150068","151992","1.265856097689352071161640086"
"2021-02-28T00:00:00.000","Whitman","WA","Passenger","55","49","104","21879","21983","0.4730928444707273802483737433"
"2021-02-28T00:00:00.000","Whitman","WA","Truck","2","0","2","8519","8521","0.02347142354183781246332590072"
"2021-02-28T00:00:00.000","Yakima","WA","Truck","0","0","0","61168","61168","0"
"2021-02-28T00:00:00.000","Yakima","WA","Passenger","201","145","346","167545","167891","0.2060860915713171045499758772"
"2021-02-28T00:00:00.000","Milwaukee","WI","Passenger","1","0","1","39","40","2.500"
"2021-02-28T00:00:00.000","Ozaukee","WI","Passenger","0","1","1","3","4","25.00"
"2021-03-31T00:00:00.000","Anchorage","AK","Passenger","1","0","1","138","139","0.7194244604316546762589928058"
"2021-03-31T00:00:00.000","Fairbanks North Star","AK","Passenger","0","1","1","85","86","1.162790697674418604651162791"
"2021-03-31T00:00:00.000","Juneau","AK","Passenger","0","1","1","25","26","3.846153846153846153846153846"
"2021-03-31T00:00:00.000","Sevier","AR","Passenger","0","1","1","0","1","100"
"2021-03-31T00:00:00.000","Maricopa","AZ","Passenger","5","4","9","1052","1061","0.8482563619227144203581526861"
"2021-03-31T00:00:00.000","Pima","AZ","Passenger","2","1","3","273","276","1.086956521739130434782608696"
"2021-03-31T00:00:00.000","Alameda","CA","Passenger","3","0","3","233","236","1.271186440677966101694915254"
"2021-03-31T00:00:00.000","Contra Costa","CA","Passenger","2","5","7","310","317","2.208201892744479495268138801"
"2021-03-31T00:00:00.000","El Dorado","CA","Passenger","1","0","1","29","30","3.333333333333333333333333333"
"2021-03-31T00:00:00.000","Fresno","CA","Passenger","1","0","1","164","165","0.6060606060606060606060606061"
"2021-03-31T00:00:00.000","Kern","CA","Passenger","1","1","2","203","205","0.9756097560975609756097560976"
"2021-03-31T00:00:00.000","Los Angeles","CA","Passenger","9","9","18","842","860","2.093023255813953488372093023"
"2021-03-31T00:00:00.000","Monterey","CA","Passenger","1","1","2","144","146","1.369863013698630136986301370"
"2021-03-31T00:00:00.000","Orange","CA","Passenger","3","3","6","425","431","1.392111368909512761020881671"
"2021-03-31T00:00:00.000","Placer","CA","Passenger","1","0","1","71","72","1.388888888888888888888888889"
"2021-03-31T00:00:00.000","Riverside","CA","Passenger","6","1","7","529","536","1.305970149253731343283582090"
"2021-03-31T00:00:00.000","Sacramento","CA","Passenger","2","0","2","226","228","0.8771929824561403508771929825"
"2021-03-31T00:00:00.000","San Bernardino","CA","Passenger","0","1","1","371","372","0.2688172043010752688172043011"
"2021-03-31T00:00:00.000","San Diego","CA","Passenger","15","6","21","2653","2674","0.7853403141361256544502617801"
"2021-03-31T00:00:00.000","San Francisco","CA","Passenger","1","1","2","79","81","2.469135802469135802469135802"
"2021-03-31T00:00:00.000","San Mateo","CA","Passenger","0","1","1","98","99","1.010101010101010101010101010"
"2021-03-31T00:00:00.000","Santa Barbara","CA","Passenger","2","0","2","74","76","2.631578947368421052631578947"
"2021-03-31T00:00:00.000","Santa Clara","CA","Passenger","7","2","9","243","252","3.571428571428571428571428571"
"2021-03-31T00:00:00.000","Santa Cruz","CA","Passenger","1","0","1","28","29","3.448275862068965517241379310"
"2021-03-31T00:00:00.000","Solano","CA","Passenger","1","0","1","198","199","0.5025125628140703517587939698"
"2021-03-31T00:00:00.000","Ventura","CA","Passenger","1","2","3","266","269","1.115241635687732342007434944"
"2021-03-31T00:00:00.000","Arapahoe","CO","Passenger","1","0","1","111","112","0.8928571428571428571428571429"
"2021-03-31T00:00:00.000","Boulder","CO","Passenger","0","1","1","36","37","2.702702702702702702702702703"
"2021-03-31T00:00:00.000","Denver","CO","Passenger","1","0","1","101","102","0.9803921568627450980392156863"
"2021-03-31T00:00:00.000","El Paso","CO","Passenger","3","0","3","643","646","0.4643962848297213622291021672"
"2021-03-31T00:00:00.000","Larimer","CO","Passenger","1","0","1","44","45","2.222222222222222222222222222"
"2021-03-31T00:00:00.000","New London","CT","Passenger","0","2","2","232","234","0.8547008547008547008547008547"
"2021-03-31T00:00:00.000","District of Columbia","DC","Passenger","2","3","5","198","203","2.463054187192118226600985222"
"2021-03-31T00:00:00.000","Kent","DE","Passenger","0","1","1","66","67","1.492537313432835820895522388"
"2021-03-31T00:00:00.000","New Castle","DE","Passenger","1","0","1","24","25","4.00"
"2021-03-31T00:00:00.000","Duval","FL","Passenger","0","1","1","319","320","0.312500"
"2021-03-31T00:00:00.000","Lake","FL","Passenger","1","0","1","17","18","5.555555555555555555555555556"
"2021-03-31T00:00:00.000","Nassau","FL","Passenger","1","0","1","23","24","4.166666666666666666666666667"
"2021-03-31T00:00:00.000","Okaloosa","FL","Passenger","0","1","1","119","120","0.8333333333333333333333333333"
"2021-03-31T00:00:00.000","Orange","FL","Passenger","1","0","1","102","103","0.9708737864077669902912621359"
"2021-03-31T00:00:00.000","Pinellas","FL","Passenger","1","1","2","80","82","2.439024390243902439024390244"
"2021-03-31T00:00:00.000","Polk","FL","Passenger","1","0","1","53","54","1.851851851851851851851851852"
"2021-03-31T00:00:00.000","Sarasota","FL","Passenger","2","0","2","26","28","7.142857142857142857142857143"
"2021-03-31T00:00:00.000","St. Johns","FL","Passenger","0","1","1","40","41","2.439024390243902439024390244"
"2021-03-31T00:00:00.000","Sumter","FL","Passenger","0","1","1","10","11","9.090909090909090909090909091"
"2021-03-31T00:00:00.000","Bartow","GA","Passenger","0","1","1","3","4","25.00"
"2021-03-31T00:00:00.000","Bryan","GA","Passenger","1","0","1","50","51","1.960784313725490196078431373"
"2021-03-31T00:00:00.000","Camden","GA","Passenger","0","1","1","131","132","0.7575757575757575757575757576"
"2021-03-31T00:00:00.000","Columbia","GA","Passenger","1","0","1","119","120","0.8333333333333333333333333333"
"2021-03-31T00:00:00.000","DeKalb","GA","Passenger","1","0","1","57","58","1.724137931034482758620689655"
"2021-03-31T00:00:00.000","Fulton","GA","Passenger","0","2","2","75","77","2.597402597402597402597402597"
"2021-03-31T00:00:00.000","Houston","GA","Passenger","1","0","1","47","48","2.083333333333333333333333333"
"2021-03-31T00:00:00.000","Jones","GA","Passenger","1","0","1","1","2","50.0"
"2021-03-31T00:00:00.000","Liberty","GA","Passenger","1","0","1","115","116","0.8620689655172413793103448276"
"2021-03-31T00:00:00.000","Honolulu","HI","Passenger","5","1","6","378","384","1.562500"
"2021-03-31T00:00:00.000","Maui","HI","Passenger","1","0","1","23","24","4.166666666666666666666666667"
"2021-03-31T00:00:00.000","Twin Falls","ID","Passenger","0","1","1","14","15","6.666666666666666666666666667"
"2021-03-31T00:00:00.000","DuPage","IL","Passenger","2","0","2","48","50","4.00"
"2021-03-31T00:00:00.000","Lake","IL","Passenger","3","0","3","155","158","1.898734177215189873417721519"
"2021-03-31T00:00:00.000","Monroe","IL","Passenger","1","0","1","2","3","33.33333333333333333333333333"
"2021-03-31T00:00:00.000","St. Clair","IL","Passenger","1","0","1","135","136","0.7352941176470588235294117647"
"2021-03-31T00:00:00.000","Hamilton","IN","Passenger","2","0","2","34","36","5.555555555555555555555555556"
"2021-03-31T00:00:00.000","Howard","IN","Passenger","0","1","1","3","4","25.00"
"2021-03-31T00:00:00.000","Vigo","IN","Passenger","1","0","1","4","5","20.0"
"2021-03-31T00:00:00.000","Leavenworth","KS","Passenger","0","1","1","116","117","0.8547008547008547008547008547"
"2021-03-31T00:00:00.000","Sedgwick","KS","Passenger","1","0","1","82","83","1.204819277108433734939759036"
"2021-03-31T00:00:00.000","Oldham","KY","Passenger","0","1","1","4","5","20.0"
"2021-03-31T00:00:00.000","Plaquemines","LA","Passenger","0","1","1","14","15","6.666666666666666666666666667"
"2021-03-31T00:00:00.000","Hampshire","MA","Passenger","1","0","1","4","5","20.0"
"2021-03-31T00:00:00.000","Middlesex","MA","Passenger","1","1","2","89","91","2.197802197802197802197802198"
"2021-03-31T00:00:00.000","Suffolk","MA","Passenger","0","2","2","36","38","5.263157894736842105263157895"
"2021-03-31T00:00:00.000","Anne Arundel","MD","Passenger","4","1","5","381","386","1.295336787564766839378238342"
"2021-03-31T00:00:00.000","Calvert","MD","Passenger","0","2","2","84","86","2.325581395348837209302325581"
"2021-03-31T00:00:00.000","Carroll","MD","Passenger","0","1","1","16","17","5.882352941176470588235294118"
"2021-03-31T00:00:00.000","Charles","MD","Passenger","1","1","2","64","66","3.030303030303030303030303030"
"2021-03-31T00:00:00.000","Frederick","MD","Passenger","2","1","3","73","76","3.947368421052631578947368421"
"2021-03-31T00:00:00.000","Howard","MD","Passenger","0","1","1","62","63","1.587301587301587301587301587"
"2021-03-31T00:00:00.000","Montgomery","MD","Passenger","1","2","3","227","230","1.304347826086956521739130435"
"2021-03-31T00:00:00.000","Prince George's","MD","Passenger","1","0","1","133","134","0.7462686567164179104477611940"
"2021-03-31T00:00:00.000","St. Mary's","MD","Passenger","1","0","1","191","192","0.5208333333333333333333333333"
"2021-03-31T00:00:00.000","Washington","MD","Passenger","1","0","1","11","12","8.333333333333333333333333333"
"2021-03-31T00:00:00.000","Penobscot","ME","Passenger","0","1","1","10","11","9.090909090909090909090909091"
"2021-03-31T00:00:00.000","Kent","MI","Passenger","0","1","1","22","23","4.347826086956521739130434783"
"2021-03-31T00:00:00.000","Saginaw","MI","Passenger","2","0","2","11","13","15.38461538461538461538461538"
"2021-03-31T00:00:00.000","Hennepin","MN","Passenger","1","0","1","70","71","1.408450704225352112676056338"
"2021-03-31T00:00:00.000","Kanabec","MN","Passenger","1","0","1","0","1","100"
"2021-03-31T00:00:00.000","Ramsey","MN","Passenger","1","0","1","28","29","3.448275862068965517241379310"
"2021-03-31T00:00:00.000","Boone","MO","Passenger","0","1","1","9","10","10.0"
"2021-03-31T00:00:00.000","Greene","MO","Passenger","0","1","1","24","25","4.00"
"2021-03-31T00:00:00.000","Platte","MO","Passenger","1","0","1","15","16","6.2500"
"2021-03-31T00:00:00.000","Ray","MO","Passenger","0","1","1","0","1","100"
"2021-03-31T00:00:00.000","St. Louis","MO","Passenger","1","0","1","87","88","1.136363636363636363636363636"
"2021-03-31T00:00:00.000","Harrison","MS","Passenger","2","0","2","50","52","3.846153846153846153846153846"
"2021-03-31T00:00:00.000","Flathead","MT","Passenger","1","0","1","41","42","2.380952380952380952380952381"
"2021-03-31T00:00:00.000","Glacier","MT","Passenger","0","1","1","5","6","16.66666666666666666666666667"
"2021-03-31T00:00:00.000","Missoula","MT","Passenger","1","0","1","56","57","1.754385964912280701754385965"
"2021-03-31T00:00:00.000","Cumberland","NC","Passenger","0","2","2","440","442","0.4524886877828054298642533937"
"2021-03-31T00:00:00.000","Harnett","NC","Passenger","0","1","1","173","174","0.5747126436781609195402298851"
"2021-03-31T00:00:00.000","Moore","NC","Passenger","0","1","1","136","137","0.7299270072992700729927007299"
"2021-03-31T00:00:00.000","Williams","ND","Passenger","0","1","1","10","11","9.090909090909090909090909091"
"2021-03-31T00:00:00.000","Douglas","NE","Passenger","1","1","2","50","52","3.846153846153846153846153846"
"2021-03-31T00:00:00.000","Carroll","NH","Passenger","0","1","1","3","4","25.00"
"2021-03-31T00:00:00.000","Camden","NJ","Passenger","0","1","1","11","12","8.333333333333333333333333333"
"2021-03-31T00:00:00.000","Hudson","NJ","Passenger","1","0","1","131","132","0.7575757575757575757575757576"
"2021-03-31T00:00:00.000","Morris","NJ","Passenger","1","0","1","17","18","5.555555555555555555555555556"
"2021-03-31T00:00:00.000","Chaves","NM","Passenger","1","0","1","7","8","12.500"
"2021-03-31T00:00:00.000","Carson City","NV","Passenger","1","0","1","12","13","7.692307692307692307692307692"
"2021-03-31T00:00:00.000","Clark","NV","Passenger","4","4","8","612","620","1.290322580645161290322580645"
"2021-03-31T00:00:00.000","Washoe","NV","Passenger","1","0","1","75","76","1.315789473684210526315789474"
"2021-03-31T00:00:00.000","Erie","NY","Passenger","1","0","1","35","36","2.777777777777777777777777778"
"2021-03-31T00:00:00.000","Jefferson","NY","Passenger","0","1","1","210","211","0.4739336492890995260663507109"
"2021-03-31T00:00:00.000","Kings","NY","Passenger","1","0","1","56","57","1.754385964912280701754385965"
"2021-03-31T00:00:00.000","Nassau","NY","Passenger","2","0","2","23","25","8.00"
"2021-03-31T00:00:00.000","New York","NY","Passenger","1","0","1","53","54","1.851851851851851851851851852"
"2021-03-31T00:00:00.000","Queens","NY","Passenger","2","0","2","46","48","4.166666666666666666666666667"
"2021-03-31T00:00:00.000","Westchester","NY","Passenger","0","1","1","18","19","5.263157894736842105263157895"
"2021-03-31T00:00:00.000","Montgomery","OH","Passenger","0","1","1","49","50","2.00"
"2021-03-31T00:00:00.000","Shelby","OH","Passenger","0","1","1","1","2","50.0"
"2021-03-31T00:00:00.000","Rogers","OK","Passenger","1","0","1","4","5","20.0"
"2021-03-31T00:00:00.000","Tulsa","OK","Passenger","1","0","1","36","37","2.702702702702702702702702703"
"2021-03-31T00:00:00.000","Clackamas","OR","Passenger","3","0","3","154","157","1.910828025477707006369426752"
"2021-03-31T00:00:00.000","Deschutes","OR","Passenger","1","0","1","109","110","0.9090909090909090909090909091"
"2021-03-31T00:00:00.000","Klamath","OR","Passenger","1","0","1","21","22","4.545454545454545454545454545"
"2021-03-31T00:00:00.000","Multnomah","OR","Passenger","3","4","7","608","615","1.138211382113821138211382114"
"2021-03-31T00:00:00.000","Washington","OR","Passenger","1","0","1","351","352","0.2840909090909090909090909091"
"2021-03-31T00:00:00.000","Yamhill","OR","Passenger","1","0","1","30","31","3.225806451612903225806451613"
"2021-03-31T00:00:00.000","Allegheny","PA","Passenger","1","1","2","57","59","3.389830508474576271186440678"
"2021-03-31T00:00:00.000","Bucks","PA","Passenger","1","0","1","19","20","5.00"
"2021-03-31T00:00:00.000","Montgomery","PA","Passenger","1","0","1","18","19","5.263157894736842105263157895"
"2021-03-31T00:00:00.000","Philadelphia","PA","Passenger","1","0","1","53","54","1.851851851851851851851851852"
"2021-03-31T00:00:00.000","RÃ­o Grande","PR","Passenger","1","0","1","1","2","50.0"
"2021-03-31T00:00:00.000","Newport","RI","Passenger","1","0","1","81","82","1.219512195121951219512195122"
"2021-03-31T00:00:00.000","Charleston","SC","Passenger","1","0","1","80","81","1.234567901234567901234567901"
"2021-03-31T00:00:00.000","Richland","SC","Passenger","0","1","1","134","135","0.7407407407407407407407407407"
"2021-03-31T00:00:00.000","Spartanburg","SC","Passenger","0","1","1","36","37","2.702702702702702702702702703"
"2021-03-31T00:00:00.000","Pennington","SD","Passenger","1","0","1","31","32","3.12500"
"2021-03-31T00:00:00.000","Bradley","TN","Passenger","1","0","1","0","1","100"
"2021-03-31T00:00:00.000","Davidson","TN","Passenger","1","0","1","45","46","2.173913043478260869565217391"
"2021-03-31T00:00:00.000","Putnam","TN","Passenger","0","1","1","0","1","100"
"2021-03-31T00:00:00.000","Tipton","TN","Passenger","1","0","1","13","14","7.142857142857142857142857143"
"2021-03-31T00:00:00.000","Bell","TX","Passenger","0","1","1","362","363","0.2754820936639118457300275482"
"2021-03-31T00:00:00.000","Bexar","TX","Passenger","5","5","10","504","514","1.945525291828793774319066148"
"2021-03-31T00:00:00.000","Dallas","TX","Passenger","1","0","1","150","151","0.6622516556291390728476821192"
"2021-03-31T00:00:00.000","El Paso","TX","Passenger","2","0","2","372","374","0.5347593582887700534759358289"
"2021-03-31T00:00:00.000","Harris","TX","Passenger","1","0","1","196","197","0.5076142131979695431472081218"
"2021-03-31T00:00:00.000","Hidalgo","TX","Passenger","0","1","1","56","57","1.754385964912280701754385965"
"2021-03-31T00:00:00.000","Montgomery","TX","Passenger","1","1","2","35","37","5.405405405405405405405405405"
"2021-03-31T00:00:00.000","Nueces","TX","Passenger","1","0","1","74","75","1.333333333333333333333333333"
"2021-03-31T00:00:00.000","Travis","TX","Passenger","2","2","4","150","154","2.597402597402597402597402597"
"2021-03-31T00:00:00.000","Wichita","TX","Passenger","1","0","1","39","40","2.500"
"2021-03-31T00:00:00.000","Salt Lake","UT","Passenger","0","2","2","152","154","1.298701298701298701298701299"
"2021-03-31T00:00:00.000","Utah","UT","Passenger","0","1","1","110","111","0.9009009009009009009009009009"
"2021-03-31T00:00:00.000","Albemarle","VA","Passenger","1","0","1","20","21","4.761904761904761904761904762"
"2021-03-31T00:00:00.000","Alexandria","VA","Passenger","4","0","4","138","142","2.816901408450704225352112676"
"2021-03-31T00:00:00.000","Arlington","VA","Passenger","0","1","1","130","131","0.7633587786259541984732824427"
"2021-03-31T00:00:00.000","Chesapeake","VA","Passenger","0","3","3","395","398","0.7537688442211055276381909548"
"2021-03-31T00:00:00.000","Fairfax","VA","Passenger","4","5","9","681","690","1.304347826086956521739130435"
"2021-03-31T00:00:00.000","Goochland","VA","Passenger","4","1","5","199","204","2.450980392156862745098039216"
"2021-03-31T00:00:00.000","Loudoun","VA","Passenger","1","0","1","66","67","1.492537313432835820895522388"
"2021-03-31T00:00:00.000","Manassas","VA","Passenger","0","1","1","5","6","16.66666666666666666666666667"
"2021-03-31T00:00:00.000","Norfolk","VA","Passenger","1","1","2","325","327","0.6116207951070336391437308869"
"2021-03-31T00:00:00.000","Portsmouth","VA","Passenger","0","1","1","63","64","1.562500"
"2021-03-31T00:00:00.000","Powhatan","VA","Passenger","1","0","1","1","2","50.0"
"2021-03-31T00:00:00.000","Prince William","VA","Passenger","1","1","2","206","208","0.9615384615384615384615384615"
"2021-03-31T00:00:00.000","Stafford","VA","Passenger","2","1","3","98","101","2.970297029702970297029702970"
"2021-03-31T00:00:00.000","Suffolk","VA","Passenger","1","0","1","107","108","0.9259259259259259259259259259"
"2021-03-31T00:00:00.000","Virginia Beach","VA","Passenger","3","0","3","592","595","0.5042016806722689075630252101"
"2021-03-31T00:00:00.000","Adams","WA","Passenger","10","9","19","12999","13018","0.1459517591027807650944845598"
"2021-03-31T00:00:00.000","Adams","WA","Truck","0","0","0","5377","5377","0"
"2021-03-31T00:00:00.000","Asotin","WA","Truck","0","0","0","6733","6733","0"
"2021-03-31T00:00:00.000","Asotin","WA","Passenger","18","15","33","12583","12616","0.2615726062143310082435003171"
"2021-03-31T00:00:00.000","Benton","WA","Passenger","476","379","855","135549","136404","0.6268144629189759831089997361"
"2021-03-31T00:00:00.000","Benton","WA","Truck","2","0","2","43549","43551","0.004592317053569378429886799385"
"2021-03-31T00:00:00.000","Chelan","WA","Passenger","308","93","401","54549","54950","0.7297543221110100090991810737"
"2021-03-31T00:00:00.000","Chelan","WA","Truck","0","0","0","22997","22997","0"
"2021-03-31T00:00:00.000","Clallam","WA","Passenger","311","203","514","50139","50653","1.014747398969458867194440606"
"2021-03-31T00:00:00.000","Clallam","WA","Truck","1","0","1","21964","21965","0.004552697473252902344639198725"
"2021-03-31T00:00:00.000","Clark","WA","Passenger","2681","1319","4000","320045","324045","1.234396457282167600178987486"
"2021-03-31T00:00:00.000","Clark","WA","Truck","7","0","7","83869","83876","0.008345653106967428108159664266"
"2021-03-31T00:00:00.000","Columbia","WA","Passenger","5","4","9","2465","2474","0.3637833468067906224737267583"
"2021-03-31T00:00:00.000","Columbia","WA","Truck","1","0","1","1549","1550","0.06451612903225806451612903226"
"2021-03-31T00:00:00.000","Cowlitz","WA","Truck","1","0","1","29064","29065","0.003440564252537416136246344400"
"2021-03-31T00:00:00.000","Cowlitz","WA","Passenger","210","143","353","72162","72515","0.4867958353444115010687443977"
"2021-03-31T00:00:00.000","Douglas","WA","Truck","1","0","1","12564","12565","0.007958615200955033824114604059"
"2021-03-31T00:00:00.000","Douglas","WA","Passenger","87","48","135","28393","28528","0.4732192933258553000560852496"
"2021-03-31T00:00:00.000","Ferry","WA","Passenger","10","3","13","4352","4365","0.2978235967926689576174112257"
"2021-03-31T00:00:00.000","Ferry","WA","Truck","0","0","0","3623","3623","0"
"2021-03-31T00:00:00.000","Franklin","WA","Passenger","108","93","201","61685","61886","0.3247907442717254306305141712"
"2021-03-31T00:00:00.000","Franklin","WA","Truck","0","0","0","20613","20613","0"
"2021-03-31T00:00:00.000","Garfield","WA","Truck","0","0","0","1011","1011","0"
"2021-03-31T00:00:00.000","Garfield","WA","Passenger","0","2","2","1367","1369","0.1460920379839298758217677137"
"2021-03-31T00:00:00.000","Grant","WA","Truck","0","0","0","27774","27774","0"
"2021-03-31T00:00:00.000","Grant","WA","Passenger","96","93","189","66453","66642","0.2836049338255154407130638336"
"2021-03-31T00:00:00.000","Grays Harbor","WA","Truck","1","0","1","21269","21270","0.004701457451810061118946873531"
"2021-03-31T00:00:00.000","Grays Harbor","WA","Passenger","167","137","304","49027","49331","0.6162453629563560438669396526"
"2021-03-31T00:00:00.000","Island","WA","Truck","1","0","1","21491","21492","0.004652894100130281034803647869"
"2021-03-31T00:00:00.000","Island","WA","Passenger","570","315","885","63143","64028","1.382207784094458674329980633"
"2021-03-31T00:00:00.000","Jefferson","WA","Passenger","308","185","493","24827","25320","1.947077409162717219589257504"
"2021-03-31T00:00:00.000","Jefferson","WA","Truck","0","0","0","9596","9596","0"
"2021-03-31T00:00:00.000","King","WA","Passenger","28939","8867","37806","1365563","1403369","2.693945783325696947844793493"
"2021-03-31T00:00:00.000","King","WA","Truck","24","1","25","184632","184657","0.01353861483723877242671547789"
"2021-03-31T00:00:00.000","Kitsap","WA","Passenger","1749","836","2585","179946","182531","1.416197796538670143701617807"
"2021-03-31T00:00:00.000","Kitsap","WA","Truck","2","0","2","54472","54474","0.003671476300620479494804861035"
"2021-03-31T00:00:00.000","Kittitas","WA","Passenger","152","58","210","29896","30106","0.6975353750083039925596226666"
"2021-03-31T00:00:00.000","Kittitas","WA","Truck","1","0","1","14762","14763","0.006773690984217300006773690984"
"2021-03-31T00:00:00.000","Klickitat","WA","Truck","0","0","0","8175","8175","0"
"2021-03-31T00:00:00.000","Klickitat","WA","Passenger","67","46","113","15038","15151","0.7458253580621741139198732757"
"2021-03-31T00:00:00.000","Lewis","WA","Truck","0","0","0","26823","26823","0"
"2021-03-31T00:00:00.000","Lewis","WA","Passenger","141","141","282","59282","59564","0.4734403330870995903565912296"
"2021-03-31T00:00:00.000","Lincoln","WA","Passenger","7","13","20","7694","7714","0.2592688618096966554316826549"
"2021-03-31T00:00:00.000","Lincoln","WA","Truck","0","0","0","4734","4734","0"
"2021-03-31T00:00:00.000","Mason","WA","Truck","0","0","0","21172","21172","0"
"2021-03-31T00:00:00.000","Mason","WA","Passenger","208","145","353","47889","48242","0.7317275403175656067327225239"
"2021-03-31T00:00:00.000","Okanogan","WA","Passenger","58","36","94","26233","26327","0.3570478975956242640635089452"
"2021-03-31T00:00:00.000","Okanogan","WA","Truck","0","0","0","16681","16681","0"
"2021-03-31T00:00:00.000","Pacific","WA","Passenger","48","44","92","15910","16002","0.5749281339832520934883139608"
"2021-03-31T00:00:00.000","Pacific","WA","Truck","0","0","0","7882","7882","0"
"2021-03-31T00:00:00.000","Pend Oreille","WA","Passenger","12","6","18","9284","9302","0.1935067727370457966028811008"
"2021-03-31T00:00:00.000","Pend Oreille","WA","Truck","1","0","1","5725","5726","0.01746419839329374781697520084"
"2021-03-31T00:00:00.000","Pierce","WA","Truck","6","0","6","145471","145477","0.004124363301415344006269032218"
"2021-03-31T00:00:00.000","Pierce","WA","Passenger","3339","1956","5295","557181","562476","0.9413734986026070445672348687"
"2021-03-31T00:00:00.000","San Juan","WA","Passenger","395","124","519","14120","14639","3.545324134162169547100211763"
"2021-03-31T00:00:00.000","San Juan","WA","Truck","0","0","0","5885","5885","0"
"2021-03-31T00:00:00.000","Skagit","WA","Truck","2","0","2","32951","32953","0.006069250144144690923436409432"
"2021-03-31T00:00:00.000","Skagit","WA","Passenger","565","282","847","91605","92452","0.9161510838056504997187729849"
"2021-03-31T00:00:00.000","Skamania","WA","Passenger","42","25","67","8308","8375","0.800"
"2021-03-31T00:00:00.000","Skamania","WA","Truck","0","0","0","4028","4028","0"
"2021-03-31T00:00:00.000","Snohomish","WA","Passenger","5533","2032","7565","539021","546586","1.384045694547610074169481106"
"2021-03-31T00:00:00.000","Snohomish","WA","Truck","5","0","5","125991","125996","0.003968379948569795866535445570"
"2021-03-31T00:00:00.000","Spokane","WA","Passenger","993","623","1616","322859","324475","0.4980352877725556668464442561"
"2021-03-31T00:00:00.000","Spokane","WA","Truck","8","0","8","101508","101516","0.007880531147799361676977028252"
"2021-03-31T00:00:00.000","Stevens","WA","Passenger","41","43","84","30326","30410","0.2762249260111805327195001644"
"2021-03-31T00:00:00.000","Stevens","WA","Truck","0","0","0","18803","18803","0"
"2021-03-31T00:00:00.000","Thurston","WA","Truck","7","0","7","56594","56601","0.01236727266302715499726153248"
"2021-03-31T00:00:00.000","Thurston","WA","Passenger","1515","873","2388","197663","200051","1.193695607620056885494198979"
"2021-03-31T00:00:00.000","Wahkiakum","WA","Passenger","9","8","17","3085","3102","0.5480335267569310122501611863"
"2021-03-31T00:00:00.000","Wahkiakum","WA","Truck","0","0","0","1789","1789","0"
"2021-03-31T00:00:00.000","Walla Walla","WA","Passenger","107","76","183","36310","36493","0.5014660345819746252705998411"
"2021-03-31T00:00:00.000","Walla Walla","WA","Truck","0","0","0","13977","13977","0"
"2021-03-31T00:00:00.000","Whatcom","WA","Truck","6","0","6","43798","43804","0.01369737923477308008401059264"
"2021-03-31T00:00:00.000","Whatcom","WA","Passenger","1352","598","1950","150480","152430","1.279275733123400905333595749"
"2021-03-31T00:00:00.000","Whitman","WA","Passenger","57","47","104","21957","22061","0.4714201532115497937536829699"
"2021-03-31T00:00:00.000","Whitman","WA","Truck","2","0","2","8559","8561","0.02336175680411166919752365378"
"2021-03-31T00:00:00.000","Yakima","WA","Truck","1","0","1","61404","61405","0.001628531878511521863040469017"
"2021-03-31T00:00:00.000","Yakima","WA","Passenger","205","145","350","168278","168628","0.2075574637663970396375453661"
"2021-03-31T00:00:00.000","Milwaukee","WI","Passenger","1","0","1","37","38","2.631578947368421052631578947"
"2021-03-31T00:00:00.000","Ozaukee","WI","Passenger","0","1","1","3","4","25.00"
"2021-04-30T00:00:00.000","Anchorage","AK","Passenger","1","0","1","138","139","0.7194244604316546762589928058"
"2021-04-30T00:00:00.000","Fairbanks North Star","AK","Passenger","0","1","1","82","83","1.204819277108433734939759036"
"2021-04-30T00:00:00.000","Juneau","AK","Passenger","0","1","1","25","26","3.846153846153846153846153846"
"2021-04-30T00:00:00.000","Sevier","AR","Passenger","0","1","1","0","1","100"
"2021-04-30T00:00:00.000","Maricopa","AZ","Passenger","5","4","9","1024","1033","0.8712487899322362052274927396"
"2021-04-30T00:00:00.000","Pima","AZ","Passenger","2","1","3","262","265","1.132075471698113207547169811"
"2021-04-30T00:00:00.000","Alameda","CA","Passenger","3","0","3","225","228","1.315789473684210526315789474"
"2021-04-30T00:00:00.000","Contra Costa","CA","Passenger","2","5","7","319","326","2.147239263803680981595092025"
"2021-04-30T00:00:00.000","El Dorado","CA","Passenger","1","0","1","30","31","3.225806451612903225806451613"
"2021-04-30T00:00:00.000","Fresno","CA","Passenger","1","0","1","164","165","0.6060606060606060606060606061"
"2021-04-30T00:00:00.000","Kern","CA","Passenger","1","1","2","203","205","0.9756097560975609756097560976"
"2021-04-30T00:00:00.000","Los Angeles","CA","Passenger","9","9","18","829","847","2.125147579693034238488783943"
"2021-04-30T00:00:00.000","Monterey","CA","Passenger","1","1","2","143","145","1.379310344827586206896551724"
"2021-04-30T00:00:00.000","Orange","CA","Passenger","3","3","6","419","425","1.411764705882352941176470588"
"2021-04-30T00:00:00.000","Placer","CA","Passenger","1","0","1","71","72","1.388888888888888888888888889"
"2021-04-30T00:00:00.000","Riverside","CA","Passenger","6","1","7","520","527","1.328273244781783681214421252"
"2021-04-30T00:00:00.000","Sacramento","CA","Passenger","2","0","2","223","225","0.8888888888888888888888888889"
"2021-04-30T00:00:00.000","San Bernardino","CA","Passenger","0","1","1","372","373","0.2680965147453083109919571046"
"2021-04-30T00:00:00.000","San Diego","CA","Passenger","17","7","24","2636","2660","0.9022556390977443609022556391"
"2021-04-30T00:00:00.000","San Francisco","CA","Passenger","1","1","2","78","80","2.500"
"2021-04-30T00:00:00.000","San Mateo","CA","Passenger","0","1","1","96","97","1.030927835051546391752577320"
"2021-04-30T00:00:00.000","Santa Barbara","CA","Passenger","2","0","2","74","76","2.631578947368421052631578947"
"2021-04-30T00:00:00.000","Santa Clara","CA","Passenger","7","2","9","241","250","3.600"
"2021-04-30T00:00:00.000","Santa Cruz","CA","Passenger","1","0","1","25","26","3.846153846153846153846153846"
"2021-04-30T00:00:00.000","Ventura","CA","Passenger","1","2","3","266","269","1.115241635687732342007434944"
"2021-04-30T00:00:00.000","Arapahoe","CO","Passenger","1","0","1","112","113","0.8849557522123893805309734513"
"2021-04-30T00:00:00.000","Boulder","CO","Passenger","0","1","1","36","37","2.702702702702702702702702703"
"2021-04-30T00:00:00.000","Denver","CO","Passenger","1","0","1","102","103","0.9708737864077669902912621359"
"2021-04-30T00:00:00.000","El Paso","CO","Passenger","3","0","3","644","647","0.4636785162287480680061823802"
"2021-04-30T00:00:00.000","Larimer","CO","Passenger","1","0","1","43","44","2.272727272727272727272727273"
"2021-04-30T00:00:00.000","New London","CT","Passenger","0","2","2","231","233","0.8583690987124463519313304721"
"2021-04-30T00:00:00.000","District of Columbia","DC","Passenger","3","3","6","193","199","3.015075376884422110552763819"
"2021-04-30T00:00:00.000","Kent","DE","Passenger","0","1","1","65","66","1.515151515151515151515151515"
"2021-04-30T00:00:00.000","New Castle","DE","Passenger","1","0","1","24","25","4.00"
"2021-04-30T00:00:00.000","Duval","FL","Passenger","0","1","1","313","314","0.3184713375796178343949044586"
"2021-04-30T00:00:00.000","Lake","FL","Passenger","1","0","1","18","19","5.263157894736842105263157895"
"2021-04-30T00:00:00.000","Nassau","FL","Passenger","1","0","1","23","24","4.166666666666666666666666667"
"2021-04-30T00:00:00.000","Okaloosa","FL","Passenger","0","1","1","115","116","0.8620689655172413793103448276"
"2021-04-30T00:00:00.000","Orange","FL","Passenger","1","0","1","102","103","0.9708737864077669902912621359"
"2021-04-30T00:00:00.000","Palm Beach","FL","Passenger","1","0","1","58","59","1.694915254237288135593220339"
"2021-04-30T00:00:00.000","Pinellas","FL","Passenger","1","1","2","78","80","2.500"
"2021-04-30T00:00:00.000","Polk","FL","Passenger","1","0","1","53","54","1.851851851851851851851851852"
"2021-04-30T00:00:00.000","Sarasota","FL","Passenger","2","0","2","26","28","7.142857142857142857142857143"
"2021-04-30T00:00:00.000","St. Johns","FL","Passenger","0","1","1","39","40","2.500"
"2021-04-30T00:00:00.000","Sumter","FL","Passenger","0","1","1","10","11","9.090909090909090909090909091"
"2021-04-30T00:00:00.000","Bartow","GA","Passenger","0","1","1","3","4","25.00"
"2021-04-30T00:00:00.000","Bryan","GA","Passenger","1","0","1","49","50","2.00"
"2021-04-30T00:00:00.000","Columbia","GA","Passenger","1","0","1","118","119","0.8403361344537815126050420168"
"2021-04-30T00:00:00.000","DeKalb","GA","Passenger","1","0","1","56","57","1.754385964912280701754385965"
"2021-04-30T00:00:00.000","Fulton","GA","Passenger","0","1","1","73","74","1.351351351351351351351351351"
"2021-04-30T00:00:00.000","Houston","GA","Passenger","1","0","1","48","49","2.040816326530612244897959184"
"2021-04-30T00:00:00.000","Jones","GA","Passenger","1","0","1","1","2","50.0"
"2021-04-30T00:00:00.000","Liberty","GA","Passenger","1","0","1","109","110","0.9090909090909090909090909091"
"2021-04-30T00:00:00.000","Honolulu","HI","Passenger","5","1","6","374","380","1.578947368421052631578947368"
"2021-04-30T00:00:00.000","Maui","HI","Passenger","1","0","1","24","25","4.00"
"2021-04-30T00:00:00.000","DuPage","IL","Passenger","2","0","2","48","50","4.00"
"2021-04-30T00:00:00.000","Lake","IL","Passenger","3","0","3","155","158","1.898734177215189873417721519"
"2021-04-30T00:00:00.000","St. Clair","IL","Passenger","1","0","1","132","133","0.7518796992481203007518796992"
"2021-04-30T00:00:00.000","Hamilton","IN","Passenger","2","0","2","33","35","5.714285714285714285714285714"
"2021-04-30T00:00:00.000","Howard","IN","Passenger","0","1","1","3","4","25.00"
"2021-04-30T00:00:00.000","Vigo","IN","Passenger","1","0","1","4","5","20.0"
"2021-04-30T00:00:00.000","Leavenworth","KS","Passenger","0","1","1","117","118","0.8474576271186440677966101695"
"2021-04-30T00:00:00.000","Sedgwick","KS","Passenger","1","0","1","82","83","1.204819277108433734939759036"
"2021-04-30T00:00:00.000","Oldham","KY","Passenger","0","1","1","4","5","20.0"
"2021-04-30T00:00:00.000","Plaquemines","LA","Passenger","0","1","1","16","17","5.882352941176470588235294118"
"2021-04-30T00:00:00.000","Hampshire","MA","Passenger","1","0","1","4","5","20.0"
"2021-04-30T00:00:00.000","Middlesex","MA","Passenger","1","1","2","88","90","2.222222222222222222222222222"
"2021-04-30T00:00:00.000","Suffolk","MA","Passenger","0","2","2","36","38","5.263157894736842105263157895"
"2021-04-30T00:00:00.000","Anne Arundel","MD","Passenger","4","2","6","377","383","1.566579634464751958224543081"
"2021-04-30T00:00:00.000","Calvert","MD","Passenger","0","2","2","86","88","2.272727272727272727272727273"
"2021-04-30T00:00:00.000","Carroll","MD","Passenger","0","1","1","15","16","6.2500"
"2021-04-30T00:00:00.000","Charles","MD","Passenger","1","1","2","63","65","3.076923076923076923076923077"
"2021-04-30T00:00:00.000","Frederick","MD","Passenger","2","1","3","72","75","4.00"
"2021-04-30T00:00:00.000","Howard","MD","Passenger","0","1","1","63","64","1.562500"
"2021-04-30T00:00:00.000","Montgomery","MD","Passenger","1","2","3","225","228","1.315789473684210526315789474"
"2021-04-30T00:00:00.000","Prince George's","MD","Passenger","1","0","1","134","135","0.7407407407407407407407407407"
"2021-04-30T00:00:00.000","St. Mary's","MD","Passenger","1","0","1","188","189","0.5291005291005291005291005291"
"2021-04-30T00:00:00.000","Washington","MD","Passenger","1","0","1","11","12","8.333333333333333333333333333"
"2021-04-30T00:00:00.000","Penobscot","ME","Passenger","0","1","1","10","11","9.090909090909090909090909091"
"2021-04-30T00:00:00.000","Saginaw","MI","Passenger","2","0","2","11","13","15.38461538461538461538461538"
"2021-04-30T00:00:00.000","Hennepin","MN","Passenger","1","0","1","69","70","1.428571428571428571428571429"
"2021-04-30T00:00:00.000","Kanabec","MN","Passenger","1","0","1","0","1","100"
"2021-04-30T00:00:00.000","Ramsey","MN","Passenger","1","0","1","26","27","3.703703703703703703703703704"
"2021-04-30T00:00:00.000","Boone","MO","Passenger","0","1","1","8","9","11.11111111111111111111111111"
"2021-04-30T00:00:00.000","Greene","MO","Passenger","0","1","1","24","25","4.00"
"2021-04-30T00:00:00.000","Platte","MO","Passenger","1","0","1","15","16","6.2500"
"2021-04-30T00:00:00.000","Ray","MO","Passenger","0","1","1","0","1","100"
"2021-04-30T00:00:00.000","St. Louis","MO","Passenger","1","0","1","84","85","1.176470588235294117647058824"
"2021-04-30T00:00:00.000","Harrison","MS","Passenger","2","0","2","49","51","3.921568627450980392156862745"
"2021-04-30T00:00:00.000","Flathead","MT","Passenger","1","0","1","39","40","2.500"
"2021-04-30T00:00:00.000","Glacier","MT","Passenger","0","1","1","5","6","16.66666666666666666666666667"
"2021-04-30T00:00:00.000","Missoula","MT","Passenger","1","0","1","52","53","1.886792452830188679245283019"
"2021-04-30T00:00:00.000","Cumberland","NC","Passenger","0","2","2","435","437","0.4576659038901601830663615561"
"2021-04-30T00:00:00.000","Cumberland","NC","Truck","1","0","1","98","99","1.010101010101010101010101010"
"2021-04-30T00:00:00.000","Harnett","NC","Passenger","0","1","1","170","171","0.5847953216374269005847953216"
"2021-04-30T00:00:00.000","Moore","NC","Passenger","0","1","1","138","139","0.7194244604316546762589928058"
"2021-04-30T00:00:00.000","Williams","ND","Passenger","0","1","1","9","10","10.0"
"2021-04-30T00:00:00.000","Douglas","NE","Passenger","1","1","2","51","53","3.773584905660377358490566038"
"2021-04-30T00:00:00.000","Carroll","NH","Passenger","0","1","1","3","4","25.00"
"2021-04-30T00:00:00.000","Burlington","NJ","Passenger","0","1","1","136","137","0.7299270072992700729927007299"
"2021-04-30T00:00:00.000","Camden","NJ","Passenger","0","1","1","12","13","7.692307692307692307692307692"
"2021-04-30T00:00:00.000","Hudson","NJ","Passenger","1","0","1","131","132","0.7575757575757575757575757576"
"2021-04-30T00:00:00.000","Morris","NJ","Passenger","1","0","1","17","18","5.555555555555555555555555556"
"2021-04-30T00:00:00.000","Chaves","NM","Passenger","1","0","1","7","8","12.500"
"2021-04-30T00:00:00.000","Carson City","NV","Passenger","1","0","1","11","12","8.333333333333333333333333333"
"2021-04-30T00:00:00.000","Clark","NV","Passenger","4","4","8","605","613","1.305057096247960848287112561"
"2021-04-30T00:00:00.000","Washoe","NV","Passenger","1","0","1","72","73","1.369863013698630136986301370"
"2021-04-30T00:00:00.000","Erie","NY","Passenger","1","0","1","33","34","2.941176470588235294117647059"
"2021-04-30T00:00:00.000","Jefferson","NY","Passenger","0","1","1","210","211","0.4739336492890995260663507109"
"2021-04-30T00:00:00.000","Kings","NY","Passenger","1","0","1","56","57","1.754385964912280701754385965"
"2021-04-30T00:00:00.000","Nassau","NY","Passenger","2","0","2","22","24","8.333333333333333333333333333"
"2021-04-30T00:00:00.000","New York","NY","Passenger","1","0","1","51","52","1.923076923076923076923076923"
"2021-04-30T00:00:00.000","Queens","NY","Passenger","2","0","2","46","48","4.166666666666666666666666667"
"2021-04-30T00:00:00.000","Westchester","NY","Passenger","0","1","1","18","19","5.263157894736842105263157895"
"2021-04-30T00:00:00.000","Montgomery","OH","Passenger","0","1","1","51","52","1.923076923076923076923076923"
"2021-04-30T00:00:00.000","Shelby","OH","Passenger","0","1","1","1","2","50.0"
"2021-04-30T00:00:00.000","Rogers","OK","Passenger","1","0","1","3","4","25.00"
"2021-04-30T00:00:00.000","Tulsa","OK","Passenger","1","0","1","36","37","2.702702702702702702702702703"
"2021-04-30T00:00:00.000","Clackamas","OR","Passenger","2","0","2","156","158","1.265822784810126582278481013"
"2021-04-30T00:00:00.000","Deschutes","OR","Passenger","1","0","1","106","107","0.9345794392523364485981308411"
"2021-04-30T00:00:00.000","Klamath","OR","Passenger","1","0","1","23","24","4.166666666666666666666666667"
"2021-04-30T00:00:00.000","Multnomah","OR","Passenger","2","4","6","602","608","0.9868421052631578947368421053"
"2021-04-30T00:00:00.000","Washington","OR","Passenger","1","0","1","349","350","0.2857142857142857142857142857"
"2021-04-30T00:00:00.000","Yamhill","OR","Passenger","1","0","1","30","31","3.225806451612903225806451613"
"2021-04-30T00:00:00.000","Allegheny","PA","Passenger","1","1","2","57","59","3.389830508474576271186440678"
"2021-04-30T00:00:00.000","Bucks","PA","Passenger","1","0","1","18","19","5.263157894736842105263157895"
"2021-04-30T00:00:00.000","Montgomery","PA","Passenger","1","0","1","18","19","5.263157894736842105263157895"
"2021-04-30T00:00:00.000","Philadelphia","PA","Passenger","1","0","1","49","50","2.00"
"2021-04-30T00:00:00.000","RÃ­o Grande","PR","Passenger","1","0","1","1","2","50.0"
"2021-04-30T00:00:00.000","Newport","RI","Passenger","1","0","1","81","82","1.219512195121951219512195122"
"2021-04-30T00:00:00.000","Charleston","SC","Passenger","1","0","1","81","82","1.219512195121951219512195122"
"2021-04-30T00:00:00.000","Richland","SC","Passenger","0","1","1","134","135","0.7407407407407407407407407407"
"2021-04-30T00:00:00.000","Spartanburg","SC","Passenger","0","1","1","36","37","2.702702702702702702702702703"
"2021-04-30T00:00:00.000","Sumter","SC","Passenger","0","1","1","37","38","2.631578947368421052631578947"
"2021-04-30T00:00:00.000","Pennington","SD","Passenger","1","0","1","31","32","3.12500"
"2021-04-30T00:00:00.000","Bradley","TN","Passenger","1","0","1","0","1","100"
"2021-04-30T00:00:00.000","Davidson","TN","Passenger","1","0","1","46","47","2.127659574468085106382978723"
"2021-04-30T00:00:00.000","Putnam","TN","Passenger","0","1","1","0","1","100"
"2021-04-30T00:00:00.000","Tipton","TN","Passenger","1","0","1","13","14","7.142857142857142857142857143"
"2021-04-30T00:00:00.000","Bell","TX","Passenger","0","1","1","361","362","0.2762430939226519337016574586"
"2021-04-30T00:00:00.000","Bexar","TX","Passenger","5","5","10","498","508","1.968503937007874015748031496"
"2021-04-30T00:00:00.000","Dallas","TX","Passenger","1","0","1","149","150","0.6666666666666666666666666667"
"2021-04-30T00:00:00.000","El Paso","TX","Passenger","2","0","2","367","369","0.5420054200542005420054200542"
"2021-04-30T00:00:00.000","Harris","TX","Passenger","1","0","1","194","195","0.5128205128205128205128205128"
"2021-04-30T00:00:00.000","Hidalgo","TX","Passenger","0","1","1","55","56","1.785714285714285714285714286"
"2021-04-30T00:00:00.000","Montgomery","TX","Passenger","1","1","2","35","37","5.405405405405405405405405405"
"2021-04-30T00:00:00.000","Nueces","TX","Passenger","1","0","1","73","74","1.351351351351351351351351351"
"2021-04-30T00:00:00.000","Travis","TX","Passenger","2","2","4","147","151","2.649006622516556291390728477"
"2021-04-30T00:00:00.000","Wichita","TX","Passenger","1","0","1","40","41","2.439024390243902439024390244"
"2021-04-30T00:00:00.000","Salt Lake","UT","Passenger","0","2","2","151","153","1.307189542483660130718954248"
"2021-04-30T00:00:00.000","Utah","UT","Passenger","0","1","1","109","110","0.9090909090909090909090909091"
"2021-04-30T00:00:00.000","Albemarle","VA","Passenger","1","0","1","19","20","5.00"
"2021-04-30T00:00:00.000","Alexandria","VA","Passenger","4","0","4","142","146","2.739726027397260273972602740"
"2021-04-30T00:00:00.000","Arlington","VA","Passenger","0","1","1","129","130","0.7692307692307692307692307692"
"2021-04-30T00:00:00.000","Chesapeake","VA","Passenger","0","3","3","389","392","0.7653061224489795918367346939"
"2021-04-30T00:00:00.000","Danville","VA","Passenger","1","0","1","0","1","100"
"2021-04-30T00:00:00.000","Fairfax","VA","Passenger","4","5","9","676","685","1.313868613138686131386861314"
"2021-04-30T00:00:00.000","Goochland","VA","Passenger","4","0","4","193","197","2.030456852791878172588832487"
"2021-04-30T00:00:00.000","Loudoun","VA","Passenger","1","0","1","66","67","1.492537313432835820895522388"
"2021-04-30T00:00:00.000","Louisa","VA","Passenger","0","1","1","0","1","100"
"2021-04-30T00:00:00.000","Manassas","VA","Passenger","0","1","1","5","6","16.66666666666666666666666667"
"2021-04-30T00:00:00.000","Norfolk","VA","Passenger","1","1","2","324","326","0.6134969325153374233128834356"
"2021-04-30T00:00:00.000","Portsmouth","VA","Passenger","0","1","1","64","65","1.538461538461538461538461538"
"2021-04-30T00:00:00.000","Powhatan","VA","Passenger","1","0","1","1","2","50.0"
"2021-04-30T00:00:00.000","Prince William","VA","Passenger","1","1","2","207","209","0.9569377990430622009569377990"
"2021-04-30T00:00:00.000","Stafford","VA","Passenger","2","1","3","100","103","2.912621359223300970873786408"
"2021-04-30T00:00:00.000","Suffolk","VA","Passenger","1","0","1","109","110","0.9090909090909090909090909091"
"2021-04-30T00:00:00.000","Virginia Beach","VA","Passenger","3","0","3","584","587","0.5110732538330494037478705281"
"2021-04-30T00:00:00.000","Adams","WA","Passenger","11","11","22","13056","13078","0.1682214405872457562318397308"
"2021-04-30T00:00:00.000","Adams","WA","Truck","0","0","0","5408","5408","0"
"2021-04-30T00:00:00.000","Asotin","WA","Passenger","20","15","35","12674","12709","0.2753953890943425918640333622"
"2021-04-30T00:00:00.000","Asotin","WA","Truck","0","0","0","6777","6777","0"
"2021-04-30T00:00:00.000","Benton","WA","Truck","3","0","3","43700","43703","0.006864517310024483445072420658"
"2021-04-30T00:00:00.000","Benton","WA","Passenger","506","387","893","136152","137045","0.6516107847787223174869568390"
"2021-04-30T00:00:00.000","Chelan","WA","Truck","2","0","2","23077","23079","0.008665886736860349235235495472"
"2021-04-30T00:00:00.000","Chelan","WA","Passenger","319","92","411","54685","55096","0.7459706693770872658632205605"
"2021-04-30T00:00:00.000","Clallam","WA","Passenger","321","210","531","50419","50950","1.042198233562315996074582924"
"2021-04-30T00:00:00.000","Clallam","WA","Truck","1","0","1","22001","22002","0.004545041359876374875011362603"
"2021-04-30T00:00:00.000","Clark","WA","Passenger","2790","1372","4162","321655","325817","1.277404187012955125116246236"
"2021-04-30T00:00:00.000","Clark","WA","Truck","13","0","13","84214","84227","0.01543448062972680969285383547"
"2021-04-30T00:00:00.000","Columbia","WA","Passenger","5","4","9","2477","2486","0.3620273531777956556717618665"
"2021-04-30T00:00:00.000","Columbia","WA","Truck","1","0","1","1560","1561","0.06406149903907751441383728379"
"2021-04-30T00:00:00.000","Cowlitz","WA","Passenger","224","144","368","72521","72889","0.5048772791504890998641770363"
"2021-04-30T00:00:00.000","Cowlitz","WA","Truck","2","0","2","29185","29187","0.006852365779285298249220543393"
"2021-04-30T00:00:00.000","Douglas","WA","Passenger","89","47","136","28488","28624","0.4751257685858021240916713248"
"2021-04-30T00:00:00.000","Douglas","WA","Truck","1","0","1","12633","12634","0.007915149596327370587304100047"
"2021-04-30T00:00:00.000","Ferry","WA","Truck","0","0","0","3649","3649","0"
"2021-04-30T00:00:00.000","Ferry","WA","Passenger","10","3","13","4409","4422","0.2939846223428312980551786522"
"2021-04-30T00:00:00.000","Franklin","WA","Passenger","117","100","217","61964","62181","0.3489812000450298322638748171"
"2021-04-30T00:00:00.000","Franklin","WA","Truck","0","0","0","20688","20688","0"
"2021-04-30T00:00:00.000","Garfield","WA","Truck","0","0","0","1006","1006","0"
"2021-04-30T00:00:00.000","Garfield","WA","Passenger","0","2","2","1379","1381","0.1448225923244026068066618392"
"2021-04-30T00:00:00.000","Grant","WA","Truck","1","0","1","27891","27892","0.003585257421482862469525311917"
"2021-04-30T00:00:00.000","Grant","WA","Passenger","106","92","198","66821","67019","0.2954386069622047479073098674"
"2021-04-30T00:00:00.000","Grays Harbor","WA","Passenger","173","140","313","49368","49681","0.6300195245667357742396489604"
"2021-04-30T00:00:00.000","Grays Harbor","WA","Truck","2","0","2","21414","21416","0.009338812103100485618229361225"
"2021-04-30T00:00:00.000","Island","WA","Passenger","596","324","920","63400","64320","1.430348258706467661691542289"
"2021-04-30T00:00:00.000","Island","WA","Truck","2","0","2","21593","21595","0.009261403102570039360963185923"
"2021-04-30T00:00:00.000","Jefferson","WA","Passenger","316","189","505","24903","25408","1.987562972292191435768261965"
"2021-04-30T00:00:00.000","Jefferson","WA","Truck","0","0","0","9628","9628","0"
"2021-04-30T00:00:00.000","King","WA","Truck","41","1","42","184993","185035","0.02269840840921987732050693112"
"2021-04-30T00:00:00.000","King","WA","Passenger","29878","9057","38935","1369959","1408894","2.763515211222419855574656433"
"2021-04-30T00:00:00.000","Kitsap","WA","Truck","6","0","6","54661","54667","0.01097554283205590209815793806"
"2021-04-30T00:00:00.000","Kitsap","WA","Passenger","1807","850","2657","180764","183421","1.448580042634158575081370181"
"2021-04-30T00:00:00.000","Kittitas","WA","Passenger","159","61","220","29988","30208","0.7282838983050847457627118644"
"2021-04-30T00:00:00.000","Kittitas","WA","Truck","1","0","1","14780","14781","0.006765442121642649347134835261"
"2021-04-30T00:00:00.000","Klickitat","WA","Passenger","69","47","116","15196","15312","0.7575757575757575757575757576"
"2021-04-30T00:00:00.000","Klickitat","WA","Truck","1","0","1","8250","8251","0.01211974306144709732153678342"
"2021-04-30T00:00:00.000","Lewis","WA","Passenger","156","142","298","59775","60073","0.4960631232001065370465933115"
"2021-04-30T00:00:00.000","Lewis","WA","Truck","0","0","0","26923","26923","0"
"2021-04-30T00:00:00.000","Lincoln","WA","Passenger","7","13","20","7754","7774","0.2572678157962438898893748392"
"2021-04-30T00:00:00.000","Lincoln","WA","Truck","0","0","0","4755","4755","0"
"2021-04-30T00:00:00.000","Mason","WA","Passenger","215","142","357","48087","48444","0.7369333663611592766906118405"
"2021-04-30T00:00:00.000","Mason","WA","Truck","2","0","2","21293","21295","0.009391876027236440478985677389"
"2021-04-30T00:00:00.000","Okanogan","WA","Passenger","61","37","98","26423","26521","0.3695184947777233136005429660"
"2021-04-30T00:00:00.000","Okanogan","WA","Truck","2","0","2","16758","16760","0.01193317422434367541766109785"
"2021-04-30T00:00:00.000","Pacific","WA","Passenger","50","45","95","16062","16157","0.5879804419137216067339233769"
"2021-04-30T00:00:00.000","Pacific","WA","Truck","0","0","0","7922","7922","0"
"2021-04-30T00:00:00.000","Pend Oreille","WA","Passenger","14","5","19","9306","9325","0.2037533512064343163538873995"
"2021-04-30T00:00:00.000","Pend Oreille","WA","Truck","1","0","1","5738","5739","0.01742463843875239588778532845"
"2021-04-30T00:00:00.000","Pierce","WA","Passenger","3487","2010","5497","560318","565815","0.9715189593771815876213956859"
"2021-04-30T00:00:00.000","Pierce","WA","Truck","13","0","13","146096","146109","0.008897466959598655798068565249"
"2021-04-30T00:00:00.000","San Juan","WA","Passenger","407","126","533","14152","14685","3.629553966632618318011576439"
"2021-04-30T00:00:00.000","San Juan","WA","Truck","0","0","0","5911","5911","0"
"2021-04-30T00:00:00.000","Skagit","WA","Passenger","588","289","877","91974","92851","0.9445240223584021712205576677"
"2021-04-30T00:00:00.000","Skagit","WA","Truck","3","0","3","33043","33046","0.009078254554257701385946861950"
"2021-04-30T00:00:00.000","Skamania","WA","Passenger","44","31","75","8365","8440","0.8886255924170616113744075829"
"2021-04-30T00:00:00.000","Skamania","WA","Truck","0","0","0","4023","4023","0"
"2021-04-30T00:00:00.000","Snohomish","WA","Passenger","5737","2067","7804","540600","548404","1.423038489872429814516305497"
"2021-04-30T00:00:00.000","Snohomish","WA","Truck","19","0","19","126438","126457","0.01502487011395177807476059056"
"2021-04-30T00:00:00.000","Spokane","WA","Passenger","1041","649","1690","325078","326768","0.5171865054105665181413112667"
"2021-04-30T00:00:00.000","Spokane","WA","Truck","14","0","14","102004","102018","0.01372306847811170577741182929"
"2021-04-30T00:00:00.000","Stevens","WA","Passenger","43","43","86","30590","30676","0.2803494588603468509584039640"
"2021-04-30T00:00:00.000","Stevens","WA","Truck","0","0","0","18882","18882","0"
"2021-04-30T00:00:00.000","Thurston","WA","Passenger","1581","884","2465","198298","200763","1.227815882408611148468592320"
"2021-04-30T00:00:00.000","Thurston","WA","Truck","11","0","11","56774","56785","0.01937131284670247424495905609"
"2021-04-30T00:00:00.000","Wahkiakum","WA","Truck","0","0","0","1807","1807","0"
"2021-04-30T00:00:00.000","Wahkiakum","WA","Passenger","11","7","18","3115","3133","0.5745292052345994254707947654"
"2021-04-30T00:00:00.000","Walla Walla","WA","Passenger","108","75","183","36551","36734","0.4981760766592257853759459901"
"2021-04-30T00:00:00.000","Walla Walla","WA","Truck","0","0","0","14059","14059","0"
"2021-04-30T00:00:00.000","Whatcom","WA","Passenger","1410","603","2013","151196","153209","1.313891481570925989987533369"
"2021-04-30T00:00:00.000","Whatcom","WA","Truck","8","0","8","43884","43892","0.01822655609222637382666545156"
"2021-04-30T00:00:00.000","Whitman","WA","Passenger","62","47","109","22017","22126","0.4926331013287535026665461448"
"2021-04-30T00:00:00.000","Whitman","WA","Truck","2","0","2","8570","8572","0.02333177788147456836210919272"
"2021-04-30T00:00:00.000","Yakima","WA","Truck","2","0","2","61678","61680","0.003242542153047989623865110246"
"2021-04-30T00:00:00.000","Yakima","WA","Passenger","223","148","371","169272","169643","0.2186945526782714288240599376"
"2021-04-30T00:00:00.000","Milwaukee","WI","Passenger","1","0","1","37","38","2.631578947368421052631578947"
"2021-04-30T00:00:00.000","Ozaukee","WI","Passenger","0","1","1","3","4","25.00"
"2021-05-31T00:00:00.000","Anchorage","AK","Passenger","1","0","1","133","134","0.7462686567164179104477611940"
"2021-05-31T00:00:00.000","Fairbanks North Star","AK","Passenger","0","1","1","83","84","1.190476190476190476190476190"
"2021-05-31T00:00:00.000","Juneau","AK","Passenger","0","1","1","23","24","4.166666666666666666666666667"
"2021-05-31T00:00:00.000","Sevier","AR","Passenger","0","1","1","0","1","100"
"2021-05-31T00:00:00.000","Maricopa","AZ","Passenger","5","4","9","991","1000","0.900"
"2021-05-31T00:00:00.000","Pima","AZ","Passenger","2","1","3","252","255","1.176470588235294117647058824"
"2021-05-31T00:00:00.000","Alameda","CA","Passenger","3","0","3","219","222","1.351351351351351351351351351"
"2021-05-31T00:00:00.000","Contra Costa","CA","Passenger","2","4","6","310","316","1.898734177215189873417721519"
"2021-05-31T00:00:00.000","El Dorado","CA","Passenger","1","0","1","28","29","3.448275862068965517241379310"
"2021-05-31T00:00:00.000","Fresno","CA","Passenger","1","0","1","162","163","0.6134969325153374233128834356"
"2021-05-31T00:00:00.000","Kern","CA","Passenger","1","1","2","202","204","0.9803921568627450980392156863"
"2021-05-31T00:00:00.000","Los Angeles","CA","Passenger","9","9","18","815","833","2.160864345738295318127250900"
"2021-05-31T00:00:00.000","Monterey","CA","Passenger","1","1","2","142","144","1.388888888888888888888888889"
"2021-05-31T00:00:00.000","Orange","CA","Passenger","3","3","6","410","416","1.442307692307692307692307692"
"2021-05-31T00:00:00.000","Placer","CA","Passenger","1","0","1","71","72","1.388888888888888888888888889"
"2021-05-31T00:00:00.000","Riverside","CA","Passenger","6","1","7","505","512","1.367187500"
"2021-05-31T00:00:00.000","Sacramento","CA","Passenger","2","0","2","217","219","0.9132420091324200913242009132"
"2021-05-31T00:00:00.000","San Bernardino","CA","Passenger","0","1","1","363","364","0.2747252747252747252747252747"
"2021-05-31T00:00:00.000","San Diego","CA","Passenger","17","7","24","2597","2621","0.9156810377718428080885158337"
"2021-05-31T00:00:00.000","San Francisco","CA","Passenger","1","1","2","76","78","2.564102564102564102564102564"
"2021-05-31T00:00:00.000","Santa Barbara","CA","Passenger","2","0","2","72","74","2.702702702702702702702702703"
"2021-05-31T00:00:00.000","Santa Clara","CA","Passenger","7","3","10","233","243","4.115226337448559670781893004"
"2021-05-31T00:00:00.000","Santa Cruz","CA","Passenger","1","0","1","24","25","4.00"
"2021-05-31T00:00:00.000","Ventura","CA","Passenger","1","2","3","263","266","1.127819548872180451127819549"
"2021-05-31T00:00:00.000","Arapahoe","CO","Passenger","1","0","1","108","109","0.9174311926605504587155963303"
"2021-05-31T00:00:00.000","Boulder","CO","Passenger","0","1","1","35","36","2.777777777777777777777777778"
"2021-05-31T00:00:00.000","Denver","CO","Passenger","1","0","1","99","100","1.00"
"2021-05-31T00:00:00.000","El Paso","CO","Passenger","3","0","3","634","637","0.4709576138147566718995290424"
"2021-05-31T00:00:00.000","Larimer","CO","Passenger","1","0","1","42","43","2.325581395348837209302325581"
"2021-05-31T00:00:00.000","New London","CT","Passenger","0","2","2","231","233","0.8583690987124463519313304721"
"2021-05-31T00:00:00.000","District of Columbia","DC","Passenger","4","3","7","194","201","3.482587064676616915422885572"
"2021-05-31T00:00:00.000","Kent","DE","Passenger","0","1","1","65","66","1.515151515151515151515151515"
"2021-05-31T00:00:00.000","New Castle","DE","Passenger","1","0","1","23","24","4.166666666666666666666666667"
"2021-05-31T00:00:00.000","Duval","FL","Passenger","0","1","1","305","306","0.3267973856209150326797385621"
"2021-05-31T00:00:00.000","Hillsborough","FL","Passenger","0","1","1","140","141","0.7092198581560283687943262411"
"2021-05-31T00:00:00.000","Lake","FL","Passenger","1","0","1","18","19","5.263157894736842105263157895"
"2021-05-31T00:00:00.000","Nassau","FL","Passenger","1","0","1","21","22","4.545454545454545454545454545"
"2021-05-31T00:00:00.000","Okaloosa","FL","Passenger","0","1","1","110","111","0.9009009009009009009009009009"
"2021-05-31T00:00:00.000","Orange","FL","Passenger","1","0","1","99","100","1.00"
"2021-05-31T00:00:00.000","Palm Beach","FL","Passenger","1","0","1","55","56","1.785714285714285714285714286"
"2021-05-31T00:00:00.000","Pinellas","FL","Passenger","0","1","1","78","79","1.265822784810126582278481013"
"2021-05-31T00:00:00.000","Polk","FL","Passenger","1","0","1","52","53","1.886792452830188679245283019"
"2021-05-31T00:00:00.000","Sarasota","FL","Passenger","2","0","2","26","28","7.142857142857142857142857143"
"2021-05-31T00:00:00.000","St. Johns","FL","Passenger","0","1","1","37","38","2.631578947368421052631578947"
"2021-05-31T00:00:00.000","Sumter","FL","Passenger","0","1","1","10","11","9.090909090909090909090909091"
"2021-05-31T00:00:00.000","Bartow","GA","Passenger","0","1","1","3","4","25.00"
"2021-05-31T00:00:00.000","Bryan","GA","Passenger","1","0","1","48","49","2.040816326530612244897959184"
"2021-05-31T00:00:00.000","Columbia","GA","Passenger","1","0","1","117","118","0.8474576271186440677966101695"
"2021-05-31T00:00:00.000","DeKalb","GA","Passenger","1","0","1","51","52","1.923076923076923076923076923"
"2021-05-31T00:00:00.000","Houston","GA","Passenger","1","0","1","47","48","2.083333333333333333333333333"
"2021-05-31T00:00:00.000","Jones","GA","Passenger","1","0","1","1","2","50.0"
"2021-05-31T00:00:00.000","Liberty","GA","Passenger","1","0","1","109","110","0.9090909090909090909090909091"
"2021-05-31T00:00:00.000","Honolulu","HI","Passenger","5","1","6","369","375","1.600"
"2021-05-31T00:00:00.000","Maui","HI","Passenger","1","0","1","23","24","4.166666666666666666666666667"
"2021-05-31T00:00:00.000","Champaign","IL","Passenger","1","0","1","11","12","8.333333333333333333333333333"
"2021-05-31T00:00:00.000","DuPage","IL","Passenger","1","0","1","46","47","2.127659574468085106382978723"
"2021-05-31T00:00:00.000","Lake","IL","Passenger","3","0","3","155","158","1.898734177215189873417721519"
"2021-05-31T00:00:00.000","St. Clair","IL","Passenger","1","0","1","131","132","0.7575757575757575757575757576"
"2021-05-31T00:00:00.000","Hamilton","IN","Passenger","2","0","2","32","34","5.882352941176470588235294118"
"2021-05-31T00:00:00.000","Howard","IN","Passenger","0","1","1","3","4","25.00"
"2021-05-31T00:00:00.000","Vigo","IN","Passenger","1","0","1","4","5","20.0"
"2021-05-31T00:00:00.000","Leavenworth","KS","Passenger","0","1","1","116","117","0.8547008547008547008547008547"
"2021-05-31T00:00:00.000","Oldham","KY","Passenger","0","1","1","4","5","20.0"
"2021-05-31T00:00:00.000","Plaquemines","LA","Passenger","0","1","1","16","17","5.882352941176470588235294118"
"2021-05-31T00:00:00.000","Hampshire","MA","Passenger","1","0","1","4","5","20.0"
"2021-05-31T00:00:00.000","Middlesex","MA","Passenger","1","1","2","89","91","2.197802197802197802197802198"
"2021-05-31T00:00:00.000","Suffolk","MA","Passenger","0","2","2","36","38","5.263157894736842105263157895"
"2021-05-31T00:00:00.000","Anne Arundel","MD","Passenger","4","2","6","377","383","1.566579634464751958224543081"
"2021-05-31T00:00:00.000","Calvert","MD","Passenger","0","2","2","87","89","2.247191011235955056179775281"
"2021-05-31T00:00:00.000","Carroll","MD","Passenger","0","1","1","15","16","6.2500"
"2021-05-31T00:00:00.000","Charles","MD","Passenger","1","1","2","62","64","3.12500"
"2021-05-31T00:00:00.000","Frederick","MD","Passenger","2","1","3","69","72","4.166666666666666666666666667"
"2021-05-31T00:00:00.000","Howard","MD","Passenger","0","1","1","61","62","1.612903225806451612903225806"
"2021-05-31T00:00:00.000","Montgomery","MD","Passenger","1","3","4","223","227","1.762114537444933920704845815"
"2021-05-31T00:00:00.000","Prince George's","MD","Passenger","1","0","1","131","132","0.7575757575757575757575757576"
"2021-05-31T00:00:00.000","St. Mary's","MD","Passenger","1","0","1","186","187","0.5347593582887700534759358289"
"2021-05-31T00:00:00.000","Washington","MD","Passenger","1","0","1","11","12","8.333333333333333333333333333"
"2021-05-31T00:00:00.000","Penobscot","ME","Passenger","0","1","1","10","11","9.090909090909090909090909091"
"2021-05-31T00:00:00.000","Saginaw","MI","Passenger","1","0","1","9","10","10.0"
"2021-05-31T00:00:00.000","Hennepin","MN","Passenger","1","0","1","66","67","1.492537313432835820895522388"
"2021-05-31T00:00:00.000","Kanabec","MN","Passenger","1","0","1","0","1","100"
"2021-05-31T00:00:00.000","Boone","MO","Passenger","0","1","1","7","8","12.500"
"2021-05-31T00:00:00.000","Greene","MO","Passenger","0","1","1","23","24","4.166666666666666666666666667"
"2021-05-31T00:00:00.000","Platte","MO","Passenger","1","0","1","15","16","6.2500"
"2021-05-31T00:00:00.000","Ray","MO","Passenger","0","1","1","0","1","100"
"2021-05-31T00:00:00.000","St. Louis","MO","Passenger","1","0","1","78","79","1.265822784810126582278481013"
"2021-05-31T00:00:00.000","Harrison","MS","Passenger","2","0","2","48","50","4.00"
"2021-05-31T00:00:00.000","Flathead","MT","Passenger","1","0","1","40","41","2.439024390243902439024390244"
"2021-05-31T00:00:00.000","Glacier","MT","Passenger","0","1","1","5","6","16.66666666666666666666666667"
"2021-05-31T00:00:00.000","Missoula","MT","Passenger","1","0","1","52","53","1.886792452830188679245283019"
"2021-05-31T00:00:00.000","Cumberland","NC","Truck","1","0","1","94","95","1.052631578947368421052631579"
"2021-05-31T00:00:00.000","Cumberland","NC","Passenger","0","2","2","427","429","0.4662004662004662004662004662"
"2021-05-31T00:00:00.000","Harnett","NC","Passenger","0","1","1","167","168","0.5952380952380952380952380952"
"2021-05-31T00:00:00.000","Moore","NC","Passenger","0","1","1","136","137","0.7299270072992700729927007299"
"2021-05-31T00:00:00.000","Wilson","NC","Passenger","1","0","1","0","1","100"
"2021-05-31T00:00:00.000","Williams","ND","Passenger","0","1","1","7","8","12.500"
"2021-05-31T00:00:00.000","Douglas","NE","Passenger","1","1","2","50","52","3.846153846153846153846153846"
"2021-05-31T00:00:00.000","Carroll","NH","Passenger","0","1","1","3","4","25.00"
"2021-05-31T00:00:00.000","Burlington","NJ","Passenger","0","1","1","132","133","0.7518796992481203007518796992"
"2021-05-31T00:00:00.000","Camden","NJ","Passenger","0","1","1","12","13","7.692307692307692307692307692"
"2021-05-31T00:00:00.000","Hudson","NJ","Passenger","1","0","1","127","128","0.7812500"
"2021-05-31T00:00:00.000","Hudson","NJ","Truck","1","0","1","14","15","6.666666666666666666666666667"
"2021-05-31T00:00:00.000","Morris","NJ","Passenger","1","0","1","15","16","6.2500"
"2021-05-31T00:00:00.000","Chaves","NM","Passenger","1","0","1","7","8","12.500"
"2021-05-31T00:00:00.000","Carson City","NV","Passenger","1","0","1","11","12","8.333333333333333333333333333"
"2021-05-31T00:00:00.000","Clark","NV","Passenger","4","4","8","591","599","1.335559265442404006677796327"
"2021-05-31T00:00:00.000","Washoe","NV","Passenger","1","0","1","70","71","1.408450704225352112676056338"
"2021-05-31T00:00:00.000","Erie","NY","Passenger","1","0","1","33","34","2.941176470588235294117647059"
"2021-05-31T00:00:00.000","Jefferson","NY","Passenger","0","1","1","207","208","0.4807692307692307692307692308"
"2021-05-31T00:00:00.000","Kings","NY","Passenger","1","0","1","54","55","1.818181818181818181818181818"
"2021-05-31T00:00:00.000","Nassau","NY","Passenger","1","0","1","21","22","4.545454545454545454545454545"
"2021-05-31T00:00:00.000","New York","NY","Passenger","1","0","1","51","52","1.923076923076923076923076923"
"2021-05-31T00:00:00.000","Queens","NY","Passenger","2","0","2","45","47","4.255319148936170212765957447"
"2021-05-31T00:00:00.000","Montgomery","OH","Passenger","0","1","1","50","51","1.960784313725490196078431373"
"2021-05-31T00:00:00.000","Shelby","OH","Passenger","0","1","1","1","2","50.0"
"2021-05-31T00:00:00.000","Rogers","OK","Passenger","1","0","1","3","4","25.00"
"2021-05-31T00:00:00.000","Tulsa","OK","Passenger","1","0","1","35","36","2.777777777777777777777777778"
"2021-05-31T00:00:00.000","Clackamas","OR","Passenger","2","0","2","151","153","1.307189542483660130718954248"
"2021-05-31T00:00:00.000","Deschutes","OR","Passenger","1","0","1","102","103","0.9708737864077669902912621359"
"2021-05-31T00:00:00.000","Klamath","OR","Passenger","1","0","1","23","24","4.166666666666666666666666667"
"2021-05-31T00:00:00.000","Multnomah","OR","Passenger","2","4","6","592","598","1.003344481605351170568561873"
"2021-05-31T00:00:00.000","Washington","OR","Passenger","1","0","1","340","341","0.2932551319648093841642228739"
"2021-05-31T00:00:00.000","Yamhill","OR","Passenger","1","0","1","29","30","3.333333333333333333333333333"
"2021-05-31T00:00:00.000","Allegheny","PA","Passenger","1","1","2","57","59","3.389830508474576271186440678"
"2021-05-31T00:00:00.000","Bucks","PA","Passenger","1","0","1","17","18","5.555555555555555555555555556"
"2021-05-31T00:00:00.000","Montgomery","PA","Passenger","1","0","1","18","19","5.263157894736842105263157895"
"2021-05-31T00:00:00.000","Philadelphia","PA","Passenger","1","0","1","46","47","2.127659574468085106382978723"
"2021-05-31T00:00:00.000","RÃ­o Grande","PR","Passenger","1","0","1","1","2","50.0"
"2021-05-31T00:00:00.000","Newport","RI","Passenger","1","0","1","79","80","1.2500"
"2021-05-31T00:00:00.000","Charleston","SC","Passenger","1","0","1","79","80","1.2500"
"2021-05-31T00:00:00.000","Richland","SC","Passenger","0","1","1","134","135","0.7407407407407407407407407407"
"2021-05-31T00:00:00.000","Spartanburg","SC","Passenger","0","1","1","36","37","2.702702702702702702702702703"
"2021-05-31T00:00:00.000","Sumter","SC","Passenger","0","1","1","37","38","2.631578947368421052631578947"
"2021-05-31T00:00:00.000","Pennington","SD","Passenger","1","0","1","29","30","3.333333333333333333333333333"
"2021-05-31T00:00:00.000","Bradley","TN","Passenger","1","0","1","0","1","100"
"2021-05-31T00:00:00.000","Davidson","TN","Passenger","1","0","1","44","45","2.222222222222222222222222222"
"2021-05-31T00:00:00.000","Montgomery","TN","Passenger","1","0","1","210","211","0.4739336492890995260663507109"
"2021-05-31T00:00:00.000","Tipton","TN","Passenger","1","0","1","13","14","7.142857142857142857142857143"
"2021-05-31T00:00:00.000","Bell","TX","Passenger","0","1","1","352","353","0.2832861189801699716713881020"
"2021-05-31T00:00:00.000","Bexar","TX","Passenger","4","4","8","490","498","1.606425702811244979919678715"
"2021-05-31T00:00:00.000","Dallas","TX","Passenger","1","0","1","144","145","0.6896551724137931034482758621"
"2021-05-31T00:00:00.000","El Paso","TX","Passenger","2","0","2","365","367","0.5449591280653950953678474114"
"2021-05-31T00:00:00.000","Harris","TX","Passenger","1","0","1","188","189","0.5291005291005291005291005291"
"2021-05-31T00:00:00.000","Hidalgo","TX","Passenger","0","1","1","55","56","1.785714285714285714285714286"
"2021-05-31T00:00:00.000","Montgomery","TX","Passenger","1","1","2","35","37","5.405405405405405405405405405"
"2021-05-31T00:00:00.000","Nueces","TX","Passenger","1","0","1","72","73","1.369863013698630136986301370"
"2021-05-31T00:00:00.000","Travis","TX","Passenger","2","2","4","146","150","2.666666666666666666666666667"
"2021-05-31T00:00:00.000","Wichita","TX","Passenger","1","0","1","39","40","2.500"
"2021-05-31T00:00:00.000","Salt Lake","UT","Passenger","0","2","2","154","156","1.282051282051282051282051282"
"2021-05-31T00:00:00.000","Albemarle","VA","Passenger","1","0","1","18","19","5.263157894736842105263157895"
"2021-05-31T00:00:00.000","Alexandria","VA","Passenger","4","0","4","138","142","2.816901408450704225352112676"
"2021-05-31T00:00:00.000","Arlington","VA","Passenger","0","1","1","128","129","0.7751937984496124031007751938"
"2021-05-31T00:00:00.000","Chesapeake","VA","Passenger","0","4","4","381","385","1.038961038961038961038961039"
"2021-05-31T00:00:00.000","Danville","VA","Passenger","1","0","1","0","1","100"
"2021-05-31T00:00:00.000","Fairfax","VA","Passenger","4","5","9","671","680","1.323529411764705882352941176"
"2021-05-31T00:00:00.000","Goochland","VA","Passenger","4","0","4","186","190","2.105263157894736842105263158"
"2021-05-31T00:00:00.000","Loudoun","VA","Passenger","1","0","1","68","69","1.449275362318840579710144928"
"2021-05-31T00:00:00.000","Louisa","VA","Passenger","0","1","1","0","1","100"
"2021-05-31T00:00:00.000","Manassas","VA","Passenger","0","1","1","5","6","16.66666666666666666666666667"
"2021-05-31T00:00:00.000","Norfolk","VA","Passenger","1","1","2","326","328","0.6097560975609756097560975610"
"2021-05-31T00:00:00.000","Portsmouth","VA","Passenger","0","1","1","63","64","1.562500"
"2021-05-31T00:00:00.000","Powhatan","VA","Passenger","1","0","1","1","2","50.0"
"2021-05-31T00:00:00.000","Prince William","VA","Passenger","1","1","2","207","209","0.9569377990430622009569377990"
"2021-05-31T00:00:00.000","Stafford","VA","Passenger","2","1","3","98","101","2.970297029702970297029702970"
"2021-05-31T00:00:00.000","Suffolk","VA","Passenger","1","0","1","109","110","0.9090909090909090909090909091"
"2021-05-31T00:00:00.000","Virginia Beach","VA","Passenger","3","0","3","577","580","0.5172413793103448275862068966"
"2021-05-31T00:00:00.000","Adams","WA","Truck","0","0","0","5376","5376","0"
"2021-05-31T00:00:00.000","Adams","WA","Passenger","11","11","22","13045","13067","0.1683630519629601285681487717"
"2021-05-31T00:00:00.000","Asotin","WA","Passenger","20","15","35","12716","12751","0.2744882754293780879930985805"
"2021-05-31T00:00:00.000","Asotin","WA","Truck","0","0","0","6790","6790","0"
"2021-05-31T00:00:00.000","Benton","WA","Truck","4","0","4","43681","43685","0.009156461027812750371981229255"
"2021-05-31T00:00:00.000","Benton","WA","Passenger","514","394","908","136160","137068","0.6624449178509936673767764905"
"2021-05-31T00:00:00.000","Chelan","WA","Truck","2","0","2","23112","23114","0.008652764558276369299991347235"
"2021-05-31T00:00:00.000","Chelan","WA","Passenger","329","97","426","54738","55164","0.7722427670219708505547095932"
"2021-05-31T00:00:00.000","Clallam","WA","Truck","1","0","1","22014","22015","0.004542357483533954122189416307"
"2021-05-31T00:00:00.000","Clallam","WA","Passenger","333","212","545","50441","50986","1.068920880241634958616090692"
"2021-05-31T00:00:00.000","Clark","WA","Truck","17","0","17","84205","84222","0.02018474982783595735081095201"
"2021-05-31T00:00:00.000","Clark","WA","Passenger","2865","1411","4276","322006","326282","1.310522799296314231247816306"
"2021-05-31T00:00:00.000","Columbia","WA","Truck","1","0","1","1552","1553","0.06439150032195750160978750805"
"2021-05-31T00:00:00.000","Columbia","WA","Passenger","6","3","9","2476","2485","0.3621730382293762575452716298"
"2021-05-31T00:00:00.000","Cowlitz","WA","Passenger","231","146","377","72452","72829","0.5176509357536146315341416194"
"2021-05-31T00:00:00.000","Cowlitz","WA","Truck","2","0","2","29153","29155","0.006859886811867604184530955239"
"2021-05-31T00:00:00.000","Douglas","WA","Passenger","93","48","141","28533","28674","0.4917346725256329776103787403"
"2021-05-31T00:00:00.000","Douglas","WA","Truck","2","0","2","12670","12672","0.01578282828282828282828282828"
"2021-05-31T00:00:00.000","Ferry","WA","Truck","0","0","0","3661","3661","0"
"2021-05-31T00:00:00.000","Ferry","WA","Passenger","9","3","12","4376","4388","0.2734731084776663628076572470"
"2021-05-31T00:00:00.000","Franklin","WA","Truck","0","0","0","20660","20660","0"
"2021-05-31T00:00:00.000","Franklin","WA","Passenger","125","100","225","61976","62201","0.3617305188019485217279464960"
"2021-05-31T00:00:00.000","Garfield","WA","Truck","0","0","0","997","997","0"
"2021-05-31T00:00:00.000","Garfield","WA","Passenger","0","2","2","1373","1375","0.1454545454545454545454545455"
"2021-05-31T00:00:00.000","Grant","WA","Passenger","106","93","199","66879","67078","0.2966695488833894868660365545"
"2021-05-31T00:00:00.000","Grant","WA","Truck","1","0","1","27886","27887","0.003585900240255316097106178506"
"2021-05-31T00:00:00.000","Grays Harbor","WA","Truck","3","0","3","21428","21431","0.01399841351313517801315850870"
"2021-05-31T00:00:00.000","Grays Harbor","WA","Passenger","178","145","323","49370","49693","0.6499909443986074497414122713"
"2021-05-31T00:00:00.000","Island","WA","Passenger","613","326","939","63408","64347","1.459275490698867080050351998"
"2021-05-31T00:00:00.000","Island","WA","Truck","3","0","3","21642","21645","0.01386001386001386001386001386"
"2021-05-31T00:00:00.000","Jefferson","WA","Truck","0","0","0","9621","9621","0"
"2021-05-31T00:00:00.000","Jefferson","WA","Passenger","329","192","521","24891","25412","2.050212498032425625688651031"
"2021-05-31T00:00:00.000","King","WA","Truck","56","1","57","184742","184799","0.03084432275066423519607790085"
"2021-05-31T00:00:00.000","King","WA","Passenger","30460","9224","39684","1369184","1408868","2.816729459395770221198863201"
"2021-05-31T00:00:00.000","Kitsap","WA","Truck","8","0","8","54641","54649","0.01463887719811890428004172080"
"2021-05-31T00:00:00.000","Kitsap","WA","Passenger","1869","869","2738","180664","183402","1.492895388272756022289833262"
"2021-05-31T00:00:00.000","Kittitas","WA","Truck","1","0","1","14773","14774","0.006768647624204683904155949641"
"2021-05-31T00:00:00.000","Kittitas","WA","Passenger","161","65","226","29983","30209","0.7481214207686451057631831573"
"2021-05-31T00:00:00.000","Klickitat","WA","Passenger","68","47","115","15246","15361","0.7486491764859058655035479461"
"2021-05-31T00:00:00.000","Klickitat","WA","Truck","1","0","1","8265","8266","0.01209774981853375272199370917"
"2021-05-31T00:00:00.000","Lewis","WA","Passenger","167","142","309","59806","60115","0.5140148049571654329202362139"
"2021-05-31T00:00:00.000","Lewis","WA","Truck","0","0","0","26909","26909","0"
"2021-05-31T00:00:00.000","Lincoln","WA","Passenger","7","13","20","7736","7756","0.2578648788035069623517276947"
"2021-05-31T00:00:00.000","Lincoln","WA","Truck","0","0","0","4757","4757","0"
"2021-05-31T00:00:00.000","Mason","WA","Passenger","231","144","375","48107","48482","0.7734829421228497174208984778"
"2021-05-31T00:00:00.000","Mason","WA","Truck","2","0","2","21344","21346","0.009369436896842499765764077579"
"2021-05-31T00:00:00.000","Okanogan","WA","Passenger","62","38","100","26425","26525","0.3770028275212064090480678605"
"2021-05-31T00:00:00.000","Okanogan","WA","Truck","2","0","2","16762","16764","0.01193032689095681221665473634"
"2021-05-31T00:00:00.000","Pacific","WA","Truck","0","0","0","7941","7941","0"
"2021-05-31T00:00:00.000","Pacific","WA","Passenger","52","51","103","16061","16164","0.6372185102697352140559267508"
"2021-05-31T00:00:00.000","Pend Oreille","WA","Truck","1","0","1","5749","5750","0.01739130434782608695652173913"
"2021-05-31T00:00:00.000","Pend Oreille","WA","Passenger","14","6","20","9280","9300","0.2150537634408602150537634409"
"2021-05-31T00:00:00.000","Pierce","WA","Passenger","3593","2044","5637","560495","566132","0.9957041820635470173033850763"
"2021-05-31T00:00:00.000","Pierce","WA","Truck","22","0","22","146027","146049","0.01506343761340372066909051072"
"2021-05-31T00:00:00.000","San Juan","WA","Truck","0","0","0","5927","5927","0"
"2021-05-31T00:00:00.000","San Juan","WA","Passenger","424","132","556","14220","14776","3.762858689767190037899296156"
"2021-05-31T00:00:00.000","Skagit","WA","Passenger","604","287","891","91966","92857","0.9595399377537503903852159773"
"2021-05-31T00:00:00.000","Skagit","WA","Truck","3","0","3","33079","33082","0.009068375551659512725953690829"
"2021-05-31T00:00:00.000","Skamania","WA","Truck","0","0","0","4031","4031","0"
"2021-05-31T00:00:00.000","Skamania","WA","Passenger","47","33","80","8395","8475","0.9439528023598820058997050147"
"2021-05-31T00:00:00.000","Snohomish","WA","Passenger","5879","2102","7981","540470","548451","1.455189251181965207466118213"
"2021-05-31T00:00:00.000","Snohomish","WA","Truck","26","0","26","126399","126425","0.02056555269922879177377892031"
"2021-05-31T00:00:00.000","Spokane","WA","Passenger","1071","662","1733","325796","327529","0.5291134525492399146335133683"
"2021-05-31T00:00:00.000","Spokane","WA","Truck","16","0","16","102164","102180","0.01565864161284008612252887062"
"2021-05-31T00:00:00.000","Stevens","WA","Truck","0","0","0","18965","18965","0"
"2021-05-31T00:00:00.000","Stevens","WA","Passenger","45","45","90","30572","30662","0.2935229274019959559063335725"
"2021-05-31T00:00:00.000","Thurston","WA","Passenger","1629","903","2532","198332","200864","1.260554404970527321969093516"
"2021-05-31T00:00:00.000","Thurston","WA","Truck","17","0","17","56692","56709","0.02997760496570209314218201696"
"2021-05-31T00:00:00.000","Wahkiakum","WA","Truck","0","0","0","1800","1800","0"
"2021-05-31T00:00:00.000","Wahkiakum","WA","Passenger","13","8","21","3115","3136","0.6696428571428571428571428571"
"2021-05-31T00:00:00.000","Walla Walla","WA","Truck","1","0","1","14053","14054","0.007115411982353778283762629856"
"2021-05-31T00:00:00.000","Walla Walla","WA","Passenger","110","76","186","36579","36765","0.5059159526723786209710322317"
"2021-05-31T00:00:00.000","Whatcom","WA","Passenger","1442","616","2058","151035","153093","1.344280927279496776469204993"
"2021-05-31T00:00:00.000","Whatcom","WA","Truck","9","0","9","43890","43899","0.02050160595913346545479395886"
"2021-05-31T00:00:00.000","Whitman","WA","Truck","2","0","2","8579","8581","0.02330730684069455774385269782"
"2021-05-31T00:00:00.000","Whitman","WA","Passenger","63","47","110","22045","22155","0.4965019183028661701647483638"
"2021-05-31T00:00:00.000","Yakima","WA","Passenger","227","154","381","169353","169734","0.2244688748276715331047403584"
"2021-05-31T00:00:00.000","Yakima","WA","Truck","2","0","2","61700","61702","0.003241386016660724125636122006"
"2021-05-31T00:00:00.000","Milwaukee","WI","Passenger","1","0","1","37","38","2.631578947368421052631578947"
"2021-05-31T00:00:00.000","Ozaukee","WI","Passenger","0","1","1","3","4","25.00"
"2021-06-30T00:00:00.000","Anchorage","AK","Passenger","1","0","1","129","130","0.7692307692307692307692307692"
"2021-06-30T00:00:00.000","Fairbanks North Star","AK","Passenger","0","1","1","84","85","1.176470588235294117647058824"
"2021-06-30T00:00:00.000","Juneau","AK","Passenger","0","1","1","24","25","4.00"
"2021-06-30T00:00:00.000","Sevier","AR","Passenger","0","1","1","0","1","100"
"2021-06-30T00:00:00.000","Maricopa","AZ","Passenger","5","3","8","959","967","0.8273009307135470527404343330"
"2021-06-30T00:00:00.000","Pima","AZ","Passenger","2","1","3","245","248","1.209677419354838709677419355"
"2021-06-30T00:00:00.000","Pinal","AZ","Passenger","1","0","1","116","117","0.8547008547008547008547008547"
"2021-06-30T00:00:00.000","Alameda","CA","Passenger","3","0","3","217","220","1.363636363636363636363636364"
"2021-06-30T00:00:00.000","Contra Costa","CA","Passenger","2","4","6","302","308","1.948051948051948051948051948"
"2021-06-30T00:00:00.000","El Dorado","CA","Passenger","1","0","1","30","31","3.225806451612903225806451613"
"2021-06-30T00:00:00.000","Fresno","CA","Passenger","1","0","1","162","163","0.6134969325153374233128834356"
"2021-06-30T00:00:00.000","Kern","CA","Passenger","1","1","2","201","203","0.9852216748768472906403940887"
"2021-06-30T00:00:00.000","Los Angeles","CA","Passenger","9","9","18","800","818","2.200488997555012224938875306"
"2021-06-30T00:00:00.000","Monterey","CA","Passenger","1","1","2","142","144","1.388888888888888888888888889"
"2021-06-30T00:00:00.000","Orange","CA","Passenger","3","3","6","401","407","1.474201474201474201474201474"
"2021-06-30T00:00:00.000","Placer","CA","Passenger","1","0","1","68","69","1.449275362318840579710144928"
"2021-06-30T00:00:00.000","Riverside","CA","Passenger","6","1","7","497","504","1.388888888888888888888888889"
"2021-06-30T00:00:00.000","Sacramento","CA","Passenger","2","0","2","209","211","0.9478672985781990521327014218"
"2021-06-30T00:00:00.000","San Bernardino","CA","Passenger","0","1","1","361","362","0.2762430939226519337016574586"
"2021-06-30T00:00:00.000","San Diego","CA","Passenger","17","7","24","2549","2573","0.9327633113097551496307811893"
"2021-06-30T00:00:00.000","San Francisco","CA","Passenger","0","1","1","74","75","1.333333333333333333333333333"
"2021-06-30T00:00:00.000","Santa Barbara","CA","Passenger","2","0","2","73","75","2.666666666666666666666666667"
"2021-06-30T00:00:00.000","Santa Clara","CA","Passenger","7","2","9","223","232","3.879310344827586206896551724"
"2021-06-30T00:00:00.000","Santa Cruz","CA","Passenger","1","0","1","22","23","4.347826086956521739130434783"
"2021-06-30T00:00:00.000","Ventura","CA","Passenger","1","2","3","254","257","1.167315175097276264591439689"
"2021-06-30T00:00:00.000","Arapahoe","CO","Passenger","1","0","1","105","106","0.9433962264150943396226415094"
"2021-06-30T00:00:00.000","Boulder","CO","Passenger","0","1","1","34","35","2.857142857142857142857142857"
"2021-06-30T00:00:00.000","Denver","CO","Passenger","1","0","1","106","107","0.9345794392523364485981308411"
"2021-06-30T00:00:00.000","El Paso","CO","Passenger","3","0","3","624","627","0.4784688995215311004784688995"
"2021-06-30T00:00:00.000","Larimer","CO","Passenger","1","0","1","42","43","2.325581395348837209302325581"
"2021-06-30T00:00:00.000","New London","CT","Passenger","0","2","2","228","230","0.8695652173913043478260869565"
"2021-06-30T00:00:00.000","District of Columbia","DC","Passenger","4","3","7","199","206","3.398058252427184466019417476"
"2021-06-30T00:00:00.000","Kent","DE","Passenger","0","1","1","66","67","1.492537313432835820895522388"
"2021-06-30T00:00:00.000","New Castle","DE","Passenger","1","0","1","21","22","4.545454545454545454545454545"
"2021-06-30T00:00:00.000","Broward","FL","Passenger","1","0","1","97","98","1.020408163265306122448979592"
"2021-06-30T00:00:00.000","Duval","FL","Passenger","0","1","1","303","304","0.3289473684210526315789473684"
"2021-06-30T00:00:00.000","Hillsborough","FL","Passenger","0","1","1","134","135","0.7407407407407407407407407407"
"2021-06-30T00:00:00.000","Lake","FL","Passenger","1","0","1","18","19","5.263157894736842105263157895"
"2021-06-30T00:00:00.000","Okaloosa","FL","Passenger","0","1","1","105","106","0.9433962264150943396226415094"
"2021-06-30T00:00:00.000","Orange","FL","Passenger","1","0","1","100","101","0.9900990099009900990099009901"
"2021-06-30T00:00:00.000","Palm Beach","FL","Passenger","1","0","1","55","56","1.785714285714285714285714286"
"2021-06-30T00:00:00.000","Pinellas","FL","Passenger","0","1","1","77","78","1.282051282051282051282051282"
"2021-06-30T00:00:00.000","Polk","FL","Passenger","1","0","1","52","53","1.886792452830188679245283019"
"2021-06-30T00:00:00.000","Sarasota","FL","Passenger","2","0","2","26","28","7.142857142857142857142857143"
"2021-06-30T00:00:00.000","St. Johns","FL","Passenger","0","1","1","35","36","2.777777777777777777777777778"
"2021-06-30T00:00:00.000","Sumter","FL","Passenger","0","1","1","8","9","11.11111111111111111111111111"
"2021-06-30T00:00:00.000","Bartow","GA","Passenger","0","1","1","2","3","33.33333333333333333333333333"
"2021-06-30T00:00:00.000","Bryan","GA","Passenger","1","0","1","49","50","2.00"
"2021-06-30T00:00:00.000","Columbia","GA","Passenger","1","0","1","117","118","0.8474576271186440677966101695"
"2021-06-30T00:00:00.000","DeKalb","GA","Passenger","1","0","1","52","53","1.886792452830188679245283019"
"2021-06-30T00:00:00.000","Houston","GA","Passenger","1","0","1","45","46","2.173913043478260869565217391"
"2021-06-30T00:00:00.000","Jones","GA","Passenger","1","0","1","1","2","50.0"
"2021-06-30T00:00:00.000","Liberty","GA","Passenger","1","0","1","104","105","0.9523809523809523809523809524"
"2021-06-30T00:00:00.000","Honolulu","HI","Passenger","5","1","6","363","369","1.626016260162601626016260163"
"2021-06-30T00:00:00.000","Maui","HI","Passenger","1","0","1","23","24","4.166666666666666666666666667"
"2021-06-30T00:00:00.000","Champaign","IL","Passenger","1","0","1","10","11","9.090909090909090909090909091"
"2021-06-30T00:00:00.000","Cook","IL","Passenger","1","0","1","171","172","0.5813953488372093023255813953"
"2021-06-30T00:00:00.000","DuPage","IL","Passenger","1","0","1","44","45","2.222222222222222222222222222"
"2021-06-30T00:00:00.000","Lake","IL","Passenger","3","0","3","158","161","1.863354037267080745341614907"
"2021-06-30T00:00:00.000","St. Clair","IL","Passenger","2","0","2","131","133","1.503759398496240601503759398"
"2021-06-30T00:00:00.000","Hamilton","IN","Passenger","2","0","2","31","33","6.060606060606060606060606061"
"2021-06-30T00:00:00.000","Howard","IN","Passenger","0","1","1","5","6","16.66666666666666666666666667"
"2021-06-30T00:00:00.000","Vigo","IN","Passenger","1","0","1","4","5","20.0"
"2021-06-30T00:00:00.000","Leavenworth","KS","Passenger","0","1","1","114","115","0.8695652173913043478260869565"
"2021-06-30T00:00:00.000","Oldham","KY","Passenger","0","1","1","4","5","20.0"
"2021-06-30T00:00:00.000","Plaquemines","LA","Passenger","0","1","1","15","16","6.2500"
"2021-06-30T00:00:00.000","Hampshire","MA","Passenger","1","0","1","3","4","25.00"
"2021-06-30T00:00:00.000","Middlesex","MA","Passenger","1","1","2","88","90","2.222222222222222222222222222"
"2021-06-30T00:00:00.000","Suffolk","MA","Passenger","0","2","2","34","36","5.555555555555555555555555556"
"2021-06-30T00:00:00.000","Anne Arundel","MD","Passenger","4","2","6","372","378","1.587301587301587301587301587"
"2021-06-30T00:00:00.000","Calvert","MD","Passenger","0","2","2","88","90","2.222222222222222222222222222"
"2021-06-30T00:00:00.000","Carroll","MD","Passenger","0","1","1","15","16","6.2500"
"2021-06-30T00:00:00.000","Charles","MD","Truck","1","0","1","9","10","10.0"
"2021-06-30T00:00:00.000","Charles","MD","Passenger","1","1","2","63","65","3.076923076923076923076923077"
"2021-06-30T00:00:00.000","Frederick","MD","Passenger","2","1","3","69","72","4.166666666666666666666666667"
"2021-06-30T00:00:00.000","Howard","MD","Passenger","0","1","1","59","60","1.666666666666666666666666667"
"2021-06-30T00:00:00.000","Montgomery","MD","Passenger","2","3","5","215","220","2.272727272727272727272727273"
"2021-06-30T00:00:00.000","Prince George's","MD","Passenger","1","0","1","130","131","0.7633587786259541984732824427"
"2021-06-30T00:00:00.000","St. Mary's","MD","Passenger","1","0","1","183","184","0.5434782608695652173913043478"
"2021-06-30T00:00:00.000","Washington","MD","Passenger","1","0","1","11","12","8.333333333333333333333333333"
"2021-06-30T00:00:00.000","Penobscot","ME","Passenger","0","1","1","9","10","10.0"
"2021-06-30T00:00:00.000","Saginaw","MI","Passenger","1","0","1","7","8","12.500"
"2021-06-30T00:00:00.000","Hennepin","MN","Passenger","1","0","1","65","66","1.515151515151515151515151515"
"2021-06-30T00:00:00.000","Kanabec","MN","Passenger","1","0","1","0","1","100"
"2021-06-30T00:00:00.000","Boone","MO","Passenger","0","1","1","8","9","11.11111111111111111111111111"
"2021-06-30T00:00:00.000","Greene","MO","Passenger","0","1","1","22","23","4.347826086956521739130434783"
"2021-06-30T00:00:00.000","Platte","MO","Passenger","1","0","1","14","15","6.666666666666666666666666667"
"2021-06-30T00:00:00.000","Ray","MO","Passenger","0","1","1","0","1","100"
"2021-06-30T00:00:00.000","St. Louis","MO","Passenger","1","0","1","78","79","1.265822784810126582278481013"
"2021-06-30T00:00:00.000","Harrison","MS","Passenger","2","0","2","50","52","3.846153846153846153846153846"
"2021-06-30T00:00:00.000","Flathead","MT","Passenger","1","0","1","38","39","2.564102564102564102564102564"
"2021-06-30T00:00:00.000","Glacier","MT","Passenger","0","1","1","5","6","16.66666666666666666666666667"
"2021-06-30T00:00:00.000","Missoula","MT","Passenger","1","0","1","51","52","1.923076923076923076923076923"
"2021-06-30T00:00:00.000","Cumberland","NC","Passenger","0","2","2","419","421","0.4750593824228028503562945368"
"2021-06-30T00:00:00.000","Cumberland","NC","Truck","1","0","1","92","93","1.075268817204301075268817204"
"2021-06-30T00:00:00.000","Harnett","NC","Passenger","0","1","1","162","163","0.6134969325153374233128834356"
"2021-06-30T00:00:00.000","Moore","NC","Passenger","0","1","1","132","133","0.7518796992481203007518796992"
"2021-06-30T00:00:00.000","Wilson","NC","Passenger","1","0","1","0","1","100"
"2021-06-30T00:00:00.000","Williams","ND","Passenger","0","1","1","7","8","12.500"
"2021-06-30T00:00:00.000","Douglas","NE","Passenger","1","1","2","51","53","3.773584905660377358490566038"
"2021-06-30T00:00:00.000","Carroll","NH","Passenger","0","1","1","3","4","25.00"
"2021-06-30T00:00:00.000","Burlington","NJ","Passenger","0","1","1","132","133","0.7518796992481203007518796992"
"2021-06-30T00:00:00.000","Camden","NJ","Passenger","0","1","1","12","13","7.692307692307692307692307692"
"2021-06-30T00:00:00.000","Hudson","NJ","Truck","1","0","1","14","15","6.666666666666666666666666667"
"2021-06-30T00:00:00.000","Hudson","NJ","Passenger","1","0","1","121","122","0.8196721311475409836065573770"
"2021-06-30T00:00:00.000","Morris","NJ","Passenger","1","0","1","16","17","5.882352941176470588235294118"
"2021-06-30T00:00:00.000","Chaves","NM","Passenger","1","0","1","7","8","12.500"
"2021-06-30T00:00:00.000","Carson City","NV","Passenger","1","0","1","11","12","8.333333333333333333333333333"
"2021-06-30T00:00:00.000","Clark","NV","Passenger","5","4","9","584","593","1.517706576728499156829679595"
"2021-06-30T00:00:00.000","Washoe","NV","Passenger","1","0","1","66","67","1.492537313432835820895522388"
"2021-06-30T00:00:00.000","Erie","NY","Passenger","1","0","1","31","32","3.12500"
"2021-06-30T00:00:00.000","Jefferson","NY","Passenger","0","1","1","210","211","0.4739336492890995260663507109"
"2021-06-30T00:00:00.000","Kings","NY","Passenger","1","0","1","55","56","1.785714285714285714285714286"
"2021-06-30T00:00:00.000","New York","NY","Passenger","1","0","1","48","49","2.040816326530612244897959184"
"2021-06-30T00:00:00.000","Queens","NY","Passenger","2","0","2","45","47","4.255319148936170212765957447"
"2021-06-30T00:00:00.000","Montgomery","OH","Passenger","0","1","1","49","50","2.00"
"2021-06-30T00:00:00.000","Shelby","OH","Passenger","0","1","1","1","2","50.0"
"2021-06-30T00:00:00.000","Rogers","OK","Passenger","1","0","1","3","4","25.00"
"2021-06-30T00:00:00.000","Clackamas","OR","Passenger","2","0","2","148","150","1.333333333333333333333333333"
"2021-06-30T00:00:00.000","Klamath","OR","Passenger","1","0","1","21","22","4.545454545454545454545454545"
"2021-06-30T00:00:00.000","Multnomah","OR","Passenger","2","4","6","580","586","1.023890784982935153583617747"
"2021-06-30T00:00:00.000","Washington","OR","Passenger","1","0","1","335","336","0.2976190476190476190476190476"
"2021-06-30T00:00:00.000","Yamhill","OR","Passenger","1","0","1","28","29","3.448275862068965517241379310"
"2021-06-30T00:00:00.000","Allegheny","PA","Passenger","1","1","2","54","56","3.571428571428571428571428571"
"2021-06-30T00:00:00.000","Bucks","PA","Passenger","1","0","1","17","18","5.555555555555555555555555556"
"2021-06-30T00:00:00.000","Montgomery","PA","Passenger","1","0","1","18","19","5.263157894736842105263157895"
"2021-06-30T00:00:00.000","Philadelphia","PA","Passenger","1","0","1","45","46","2.173913043478260869565217391"
"2021-06-30T00:00:00.000","RÃ­o Grande","PR","Passenger","1","0","1","0","1","100"
"2021-06-30T00:00:00.000","Newport","RI","Passenger","1","0","1","80","81","1.234567901234567901234567901"
"2021-06-30T00:00:00.000","Newport","RI","Truck","1","0","1","10","11","9.090909090909090909090909091"
"2021-06-30T00:00:00.000","Richland","SC","Passenger","0","1","1","128","129","0.7751937984496124031007751938"
"2021-06-30T00:00:00.000","Spartanburg","SC","Passenger","0","1","1","34","35","2.857142857142857142857142857"
"2021-06-30T00:00:00.000","Sumter","SC","Passenger","0","1","1","36","37","2.702702702702702702702702703"
"2021-06-30T00:00:00.000","Pennington","SD","Passenger","1","0","1","28","29","3.448275862068965517241379310"
"2021-06-30T00:00:00.000","Davidson","TN","Passenger","1","0","1","41","42","2.380952380952380952380952381"
"2021-06-30T00:00:00.000","Montgomery","TN","Passenger","1","0","1","208","209","0.4784688995215311004784688995"
"2021-06-30T00:00:00.000","Tipton","TN","Passenger","1","0","1","13","14","7.142857142857142857142857143"
"2021-06-30T00:00:00.000","Bell","TX","Passenger","0","1","1","346","347","0.2881844380403458213256484150"
"2021-06-30T00:00:00.000","Bexar","TX","Passenger","4","4","8","484","492","1.626016260162601626016260163"
"2021-06-30T00:00:00.000","Dallas","TX","Passenger","1","0","1","144","145","0.6896551724137931034482758621"
"2021-06-30T00:00:00.000","El Paso","TX","Passenger","2","0","2","359","361","0.5540166204986149584487534626"
"2021-06-30T00:00:00.000","Harris","TX","Passenger","1","0","1","186","187","0.5347593582887700534759358289"
"2021-06-30T00:00:00.000","Hidalgo","TX","Passenger","0","1","1","55","56","1.785714285714285714285714286"
"2021-06-30T00:00:00.000","Montgomery","TX","Passenger","1","1","2","31","33","6.060606060606060606060606061"
"2021-06-30T00:00:00.000","Nueces","TX","Passenger","1","0","1","68","69","1.449275362318840579710144928"
"2021-06-30T00:00:00.000","Travis","TX","Passenger","2","2","4","145","149","2.684563758389261744966442953"
"2021-06-30T00:00:00.000","Wichita","TX","Passenger","1","0","1","39","40","2.500"
"2021-06-30T00:00:00.000","Salt Lake","UT","Passenger","0","2","2","148","150","1.333333333333333333333333333"
"2021-06-30T00:00:00.000","Albemarle","VA","Passenger","1","0","1","18","19","5.263157894736842105263157895"
"2021-06-30T00:00:00.000","Alexandria","VA","Passenger","4","0","4","132","136","2.941176470588235294117647059"
"2021-06-30T00:00:00.000","Arlington","VA","Passenger","0","1","1","128","129","0.7751937984496124031007751938"
"2021-06-30T00:00:00.000","Chesapeake","VA","Passenger","0","4","4","383","387","1.033591731266149870801033592"
"2021-06-30T00:00:00.000","Danville","VA","Passenger","1","0","1","0","1","100"
"2021-06-30T00:00:00.000","Fairfax","VA","Passenger","4","5","9","670","679","1.325478645066273932253313697"
"2021-06-30T00:00:00.000","Goochland","VA","Passenger","4","0","4","177","181","2.209944751381215469613259669"
"2021-06-30T00:00:00.000","Loudoun","VA","Passenger","1","0","1","67","68","1.470588235294117647058823529"
"2021-06-30T00:00:00.000","Louisa","VA","Passenger","0","1","1","0","1","100"
"2021-06-30T00:00:00.000","Manassas","VA","Passenger","0","1","1","5","6","16.66666666666666666666666667"
"2021-06-30T00:00:00.000","Norfolk","VA","Passenger","1","1","2","318","320","0.62500"
"2021-06-30T00:00:00.000","Portsmouth","VA","Passenger","0","1","1","62","63","1.587301587301587301587301587"
"2021-06-30T00:00:00.000","Powhatan","VA","Passenger","1","0","1","1","2","50.0"
"2021-06-30T00:00:00.000","Prince William","VA","Passenger","1","1","2","204","206","0.9708737864077669902912621359"
"2021-06-30T00:00:00.000","Stafford","VA","Passenger","2","1","3","99","102","2.941176470588235294117647059"
"2021-06-30T00:00:00.000","Suffolk","VA","Passenger","1","0","1","108","109","0.9174311926605504587155963303"
"2021-06-30T00:00:00.000","Virginia Beach","VA","Passenger","3","0","3","569","572","0.5244755244755244755244755245"
"2021-06-30T00:00:00.000","Adams","WA","Passenger","16","13","29","13037","13066","0.2219500994948721873564977805"
"2021-06-30T00:00:00.000","Adams","WA","Truck","0","0","0","5388","5388","0"
"2021-06-30T00:00:00.000","Asotin","WA","Truck","1","0","1","6798","6799","0.01470804530077952640094131490"
"2021-06-30T00:00:00.000","Asotin","WA","Passenger","21","18","39","12747","12786","0.3050211168465509150633505397"
"2021-06-30T00:00:00.000","Benton","WA","Passenger","527","403","930","136460","137390","0.6769051604920299876264648082"
"2021-06-30T00:00:00.000","Benton","WA","Truck","6","0","6","43645","43651","0.01374538956724931845776729055"
"2021-06-30T00:00:00.000","Chelan","WA","Truck","2","0","2","23137","23139","0.008643415877954967803275854618"
"2021-06-30T00:00:00.000","Chelan","WA","Passenger","343","98","441","54754","55195","0.7989854153455928979074191503"
"2021-06-30T00:00:00.000","Clallam","WA","Truck","3","0","3","22033","22036","0.01361408604102377927028498820"
"2021-06-30T00:00:00.000","Clallam","WA","Passenger","340","221","561","50507","51068","1.098535286284953395472703063"
"2021-06-30T00:00:00.000","Clark","WA","Passenger","2950","1467","4417","322615","327032","1.350632354020401673230754177"
"2021-06-30T00:00:00.000","Clark","WA","Truck","20","0","20","84360","84380","0.02370229912301493244844749941"
"2021-06-30T00:00:00.000","Columbia","WA","Passenger","6","2","8","2468","2476","0.3231017770597738287560581583"
"2021-06-30T00:00:00.000","Columbia","WA","Truck","1","0","1","1546","1547","0.06464124111182934712346477052"
"2021-06-30T00:00:00.000","Cowlitz","WA","Passenger","237","153","390","72357","72747","0.5361045816322322570002886717"
"2021-06-30T00:00:00.000","Cowlitz","WA","Truck","3","0","3","29135","29138","0.01029583361932871164801976800"
"2021-06-30T00:00:00.000","Douglas","WA","Passenger","94","49","143","28531","28674","0.4987096324196135872218734742"
"2021-06-30T00:00:00.000","Douglas","WA","Truck","2","0","2","12691","12693","0.01575671630032301268415662176"
"2021-06-30T00:00:00.000","Ferry","WA","Passenger","9","3","12","4376","4388","0.2734731084776663628076572470"
"2021-06-30T00:00:00.000","Ferry","WA","Truck","0","0","0","3642","3642","0"
"2021-06-30T00:00:00.000","Franklin","WA","Passenger","131","102","233","62035","62268","0.3741889895291321384981049656"
"2021-06-30T00:00:00.000","Franklin","WA","Truck","0","0","0","20706","20706","0"
"2021-06-30T00:00:00.000","Garfield","WA","Passenger","0","3","3","1378","1381","0.2172338884866039102099927589"
"2021-06-30T00:00:00.000","Garfield","WA","Truck","0","0","0","996","996","0"
"2021-06-30T00:00:00.000","Grant","WA","Passenger","111","95","206","66988","67194","0.3065749918147453641694198887"
"2021-06-30T00:00:00.000","Grant","WA","Truck","1","0","1","27926","27927","0.003580764135066423174705482150"
"2021-06-30T00:00:00.000","Grays Harbor","WA","Passenger","184","150","334","49454","49788","0.6708443801719289788704105407"
"2021-06-30T00:00:00.000","Grays Harbor","WA","Truck","4","0","4","21449","21453","0.01864541089824267002284062835"
"2021-06-30T00:00:00.000","Island","WA","Passenger","631","333","964","63428","64392","1.497080382656230587650639831"
"2021-06-30T00:00:00.000","Island","WA","Truck","4","0","4","21660","21664","0.01846381093057607090103397341"
"2021-06-30T00:00:00.000","Jefferson","WA","Truck","0","0","0","9631","9631","0"
"2021-06-30T00:00:00.000","Jefferson","WA","Passenger","339","195","534","24890","25424","2.100377595972309628697293896"
"2021-06-30T00:00:00.000","King","WA","Passenger","30913","9461","40374","1369078","1409452","2.864517557178250837914309959"
"2021-06-30T00:00:00.000","King","WA","Truck","74","1","75","184669","184744","0.04059671762005802624171826961"
"2021-06-30T00:00:00.000","Kitsap","WA","Passenger","1925","895","2820","180784","183604","1.535914250234199690638548180"
"2021-06-30T00:00:00.000","Kitsap","WA","Truck","11","0","11","54567","54578","0.02015464106416504818791454432"
"2021-06-30T00:00:00.000","Kittitas","WA","Passenger","166","69","235","29992","30227","0.7774506236146491547292156019"
"2021-06-30T00:00:00.000","Kittitas","WA","Truck","1","0","1","14790","14791","0.006760868095463457507944020012"
"2021-06-30T00:00:00.000","Klickitat","WA","Truck","1","0","1","8303","8304","0.01204238921001926782273603083"
"2021-06-30T00:00:00.000","Klickitat","WA","Passenger","72","51","123","15290","15413","0.7980276390060338675144358658"
"2021-06-30T00:00:00.000","Lewis","WA","Truck","0","0","0","26872","26872","0"
"2021-06-30T00:00:00.000","Lewis","WA","Passenger","173","146","319","59678","59997","0.5316932513292331283230828208"
"2021-06-30T00:00:00.000","Lincoln","WA","Truck","0","0","0","4757","4757","0"
"2021-06-30T00:00:00.000","Lincoln","WA","Passenger","7","13","20","7741","7761","0.2576987501610617188506635743"
"2021-06-30T00:00:00.000","Mason","WA","Passenger","237","148","385","48172","48557","0.7928825915933850938072780444"
"2021-06-30T00:00:00.000","Mason","WA","Truck","2","0","2","21340","21342","0.009371192952862899447099615781"
"2021-06-30T00:00:00.000","Okanogan","WA","Passenger","64","39","103","26525","26628","0.3868108757698663061439086676"
"2021-06-30T00:00:00.000","Okanogan","WA","Truck","2","0","2","16764","16766","0.01192890373374686866276989145"
"2021-06-30T00:00:00.000","Pacific","WA","Truck","0","0","0","7968","7968","0"
"2021-06-30T00:00:00.000","Pacific","WA","Passenger","54","56","110","16050","16160","0.6806930693069306930693069307"
"2021-06-30T00:00:00.000","Pend Oreille","WA","Truck","1","0","1","5750","5751","0.01738828029907842114414884368"
"2021-06-30T00:00:00.000","Pend Oreille","WA","Passenger","14","7","21","9275","9296","0.2259036144578313253012048193"
"2021-06-30T00:00:00.000","Pierce","WA","Passenger","3685","2101","5786","561024","566810","1.020800621019389213316631676"
"2021-06-30T00:00:00.000","Pierce","WA","Truck","28","0","28","146206","146234","0.01914739390292271291218184554"
"2021-06-30T00:00:00.000","San Juan","WA","Truck","0","0","0","5944","5944","0"
"2021-06-30T00:00:00.000","San Juan","WA","Passenger","432","136","568","14260","14828","3.830590774210952252495279202"
"2021-06-30T00:00:00.000","Skagit","WA","Passenger","616","295","911","91983","92894","0.9806876655112278510991022025"
"2021-06-30T00:00:00.000","Skagit","WA","Truck","6","0","6","33048","33054","0.01815211472136503902704665093"
"2021-06-30T00:00:00.000","Skamania","WA","Truck","0","0","0","4030","4030","0"
"2021-06-30T00:00:00.000","Skamania","WA","Passenger","48","35","83","8406","8489","0.9777358935092472611615031217"
"2021-06-30T00:00:00.000","Snohomish","WA","Truck","30","0","30","126309","126339","0.02374563673924916296630494147"
"2021-06-30T00:00:00.000","Snohomish","WA","Passenger","6033","2148","8181","540501","548682","1.491027589751440725228821066"
"2021-06-30T00:00:00.000","Spokane","WA","Truck","19","0","19","102415","102434","0.01854852880879395513208504989"
"2021-06-30T00:00:00.000","Spokane","WA","Passenger","1110","685","1795","326691","328486","0.5464464238962999945203144122"
"2021-06-30T00:00:00.000","Stevens","WA","Passenger","48","45","93","30492","30585","0.3040706228543403629230014713"
"2021-06-30T00:00:00.000","Stevens","WA","Truck","0","0","0","18955","18955","0"
"2021-06-30T00:00:00.000","Thurston","WA","Truck","20","0","20","56636","56656","0.03530076249646992375035300762"
"2021-06-30T00:00:00.000","Thurston","WA","Passenger","1674","923","2597","198394","200991","1.292097656113955351234632396"
"2021-06-30T00:00:00.000","Wahkiakum","WA","Truck","0","0","0","1798","1798","0"
"2021-06-30T00:00:00.000","Wahkiakum","WA","Passenger","15","9","24","3111","3135","0.7655502392344497607655502392"
"2021-06-30T00:00:00.000","Walla Walla","WA","Truck","1","0","1","14089","14090","0.007097232079488999290276792051"
"2021-06-30T00:00:00.000","Walla Walla","WA","Passenger","113","78","191","36639","36830","0.5185989682324192234591365734"
"2021-06-30T00:00:00.000","Whatcom","WA","Passenger","1474","624","2098","150896","152994","1.371295606363648247643698446"
"2021-06-30T00:00:00.000","Whatcom","WA","Truck","11","0","11","43927","43938","0.02503527698120078292138923028"
"2021-06-30T00:00:00.000","Whitman","WA","Passenger","61","50","111","22027","22138","0.5014003071641521365977053031"
"2021-06-30T00:00:00.000","Whitman","WA","Truck","2","0","2","8592","8594","0.02327205026762857807772864789"
"2021-06-30T00:00:00.000","Yakima","WA","Passenger","241","165","406","169393","169799","0.2391062373747784144782949252"
"2021-06-30T00:00:00.000","Yakima","WA","Truck","2","0","2","61745","61747","0.003239023758239266685021134630"
"2021-06-30T00:00:00.000","Douglas","WI","Passenger","1","0","1","2","3","33.33333333333333333333333333"
"2021-06-30T00:00:00.000","Milwaukee","WI","Passenger","1","0","1","36","37","2.702702702702702702702702703"
"2021-06-30T00:00:00.000","Ozaukee","WI","Passenger","0","1","1","3","4","25.00"
"2021-07-31T00:00:00.000","Anchorage","AK","Passenger","1","0","1","126","127","0.7874015748031496062992125984"
"2021-07-31T00:00:00.000","Fairbanks North Star","AK","Passenger","0","1","1","82","83","1.204819277108433734939759036"
"2021-07-31T00:00:00.000","Juneau","AK","Passenger","0","1","1","24","25","4.00"
"2021-07-31T00:00:00.000","Sevier","AR","Passenger","0","1","1","0","1","100"
"2021-07-31T00:00:00.000","Maricopa","AZ","Passenger","5","3","8","925","933","0.8574490889603429796355841372"
"2021-07-31T00:00:00.000","Pima","AZ","Passenger","2","1","3","238","241","1.244813278008298755186721992"
"2021-07-31T00:00:00.000","Pinal","AZ","Passenger","1","0","1","114","115","0.8695652173913043478260869565"
"2021-07-31T00:00:00.000","Alameda","CA","Passenger","4","0","4","212","216","1.851851851851851851851851852"
"2021-07-31T00:00:00.000","Contra Costa","CA","Passenger","2","4","6","303","309","1.941747572815533980582524272"
"2021-07-31T00:00:00.000","El Dorado","CA","Passenger","1","0","1","29","30","3.333333333333333333333333333"
"2021-07-31T00:00:00.000","Fresno","CA","Passenger","1","0","1","158","159","0.6289308176100628930817610063"
"2021-07-31T00:00:00.000","Kern","CA","Passenger","1","1","2","200","202","0.9900990099009900990099009901"
"2021-07-31T00:00:00.000","Los Angeles","CA","Passenger","9","9","18","788","806","2.233250620347394540942928040"
"2021-07-31T00:00:00.000","Monterey","CA","Passenger","1","1","2","138","140","1.428571428571428571428571429"
"2021-07-31T00:00:00.000","Orange","CA","Passenger","5","3","8","392","400","2.00"
"2021-07-31T00:00:00.000","Placer","CA","Passenger","1","0","1","66","67","1.492537313432835820895522388"
"2021-07-31T00:00:00.000","Riverside","CA","Passenger","6","1","7","488","495","1.414141414141414141414141414"
"2021-07-31T00:00:00.000","Sacramento","CA","Passenger","2","0","2","206","208","0.9615384615384615384615384615"
"2021-07-31T00:00:00.000","San Bernardino","CA","Passenger","0","1","1","359","360","0.2777777777777777777777777778"
"2021-07-31T00:00:00.000","San Diego","CA","Passenger","17","8","25","2512","2537","0.9854158454867954276704769413"
"2021-07-31T00:00:00.000","San Francisco","CA","Passenger","0","1","1","72","73","1.369863013698630136986301370"
"2021-07-31T00:00:00.000","Santa Barbara","CA","Passenger","2","0","2","74","76","2.631578947368421052631578947"
"2021-07-31T00:00:00.000","Santa Clara","CA","Passenger","7","2","9","223","232","3.879310344827586206896551724"
"2021-07-31T00:00:00.000","Santa Cruz","CA","Passenger","1","0","1","21","22","4.545454545454545454545454545"
"2021-07-31T00:00:00.000","Sonoma","CA","Passenger","0","1","1","74","75","1.333333333333333333333333333"
"2021-07-31T00:00:00.000","Ventura","CA","Passenger","1","2","3","249","252","1.190476190476190476190476190"
"2021-07-31T00:00:00.000","Arapahoe","CO","Passenger","1","0","1","102","103","0.9708737864077669902912621359"
"2021-07-31T00:00:00.000","Boulder","CO","Passenger","0","1","1","29","30","3.333333333333333333333333333"
"2021-07-31T00:00:00.000","Denver","CO","Passenger","1","0","1","104","105","0.9523809523809523809523809524"
"2021-07-31T00:00:00.000","El Paso","CO","Passenger","3","0","3","621","624","0.4807692307692307692307692308"
"2021-07-31T00:00:00.000","Larimer","CO","Passenger","1","0","1","41","42","2.380952380952380952380952381"
"2021-07-31T00:00:00.000","Las Animas","CO","Passenger","1","0","1","0","1","100"
"2021-07-31T00:00:00.000","New London","CT","Passenger","0","2","2","223","225","0.8888888888888888888888888889"
"2021-07-31T00:00:00.000","District of Columbia","DC","Passenger","4","3","7","200","207","3.381642512077294685990338164"
"2021-07-31T00:00:00.000","Kent","DE","Passenger","0","1","1","63","64","1.562500"
"2021-07-31T00:00:00.000","New Castle","DE","Passenger","1","0","1","21","22","4.545454545454545454545454545"
"2021-07-31T00:00:00.000","Broward","FL","Passenger","1","0","1","97","98","1.020408163265306122448979592"
"2021-07-31T00:00:00.000","Duval","FL","Passenger","0","1","1","298","299","0.3344481605351170568561872910"
"2021-07-31T00:00:00.000","Hillsborough","FL","Passenger","0","1","1","134","135","0.7407407407407407407407407407"
"2021-07-31T00:00:00.000","Lake","FL","Passenger","1","0","1","18","19","5.263157894736842105263157895"
"2021-07-31T00:00:00.000","Okaloosa","FL","Passenger","0","1","1","104","105","0.9523809523809523809523809524"
"2021-07-31T00:00:00.000","Orange","FL","Passenger","1","0","1","96","97","1.030927835051546391752577320"
"2021-07-31T00:00:00.000","Palm Beach","FL","Passenger","1","0","1","52","53","1.886792452830188679245283019"
"2021-07-31T00:00:00.000","Pinellas","FL","Passenger","0","1","1","77","78","1.282051282051282051282051282"
"2021-07-31T00:00:00.000","Polk","FL","Passenger","1","0","1","53","54","1.851851851851851851851851852"
"2021-07-31T00:00:00.000","Sarasota","FL","Passenger","2","0","2","25","27","7.407407407407407407407407407"
"2021-07-31T00:00:00.000","St. Johns","FL","Passenger","0","1","1","35","36","2.777777777777777777777777778"
"2021-07-31T00:00:00.000","Bartow","GA","Passenger","0","1","1","2","3","33.33333333333333333333333333"
"2021-07-31T00:00:00.000","Bryan","GA","Passenger","1","0","1","49","50","2.00"
"2021-07-31T00:00:00.000","Columbia","GA","Passenger","1","0","1","114","115","0.8695652173913043478260869565"
"2021-07-31T00:00:00.000","DeKalb","GA","Passenger","1","0","1","51","52","1.923076923076923076923076923"
"2021-07-31T00:00:00.000","Houston","GA","Passenger","1","0","1","44","45","2.222222222222222222222222222"
"2021-07-31T00:00:00.000","Jones","GA","Passenger","1","0","1","1","2","50.0"
"2021-07-31T00:00:00.000","Liberty","GA","Passenger","1","0","1","101","102","0.9803921568627450980392156863"
"2021-07-31T00:00:00.000","Rockdale","GA","Passenger","1","0","1","8","9","11.11111111111111111111111111"
"2021-07-31T00:00:00.000","Honolulu","HI","Passenger","5","1","6","353","359","1.671309192200557103064066852"
"2021-07-31T00:00:00.000","Champaign","IL","Passenger","1","0","1","10","11","9.090909090909090909090909091"
"2021-07-31T00:00:00.000","Cook","IL","Passenger","1","0","1","164","165","0.6060606060606060606060606061"
"2021-07-31T00:00:00.000","DuPage","IL","Passenger","1","0","1","45","46","2.173913043478260869565217391"
"2021-07-31T00:00:00.000","Lake","IL","Passenger","3","0","3","158","161","1.863354037267080745341614907"
"2021-07-31T00:00:00.000","St. Clair","IL","Passenger","2","0","2","129","131","1.526717557251908396946564885"
"2021-07-31T00:00:00.000","Hamilton","IN","Passenger","2","0","2","30","32","6.2500"
"2021-07-31T00:00:00.000","Howard","IN","Passenger","0","1","1","5","6","16.66666666666666666666666667"
"2021-07-31T00:00:00.000","Vigo","IN","Passenger","1","0","1","4","5","20.0"
"2021-07-31T00:00:00.000","Leavenworth","KS","Passenger","0","1","1","113","114","0.8771929824561403508771929825"
"2021-07-31T00:00:00.000","Oldham","KY","Passenger","0","1","1","4","5","20.0"
"2021-07-31T00:00:00.000","Plaquemines","LA","Passenger","0","1","1","15","16","6.2500"
"2021-07-31T00:00:00.000","Hampshire","MA","Passenger","1","0","1","4","5","20.0"
"2021-07-31T00:00:00.000","Middlesex","MA","Passenger","1","1","2","88","90","2.222222222222222222222222222"
"2021-07-31T00:00:00.000","Suffolk","MA","Passenger","0","2","2","34","36","5.555555555555555555555555556"
"2021-07-31T00:00:00.000","Anne Arundel","MD","Passenger","4","3","7","371","378","1.851851851851851851851851852"
"2021-07-31T00:00:00.000","Baltimore","MD","Passenger","1","0","1","85","86","1.162790697674418604651162791"
"2021-07-31T00:00:00.000","Calvert","MD","Passenger","0","2","2","86","88","2.272727272727272727272727273"
"2021-07-31T00:00:00.000","Carroll","MD","Passenger","0","1","1","15","16","6.2500"
"2021-07-31T00:00:00.000","Charles","MD","Truck","1","0","1","9","10","10.0"
"2021-07-31T00:00:00.000","Charles","MD","Passenger","1","1","2","63","65","3.076923076923076923076923077"
"2021-07-31T00:00:00.000","Frederick","MD","Passenger","2","1","3","69","72","4.166666666666666666666666667"
"2021-07-31T00:00:00.000","Howard","MD","Passenger","0","1","1","58","59","1.694915254237288135593220339"
"2021-07-31T00:00:00.000","Montgomery","MD","Passenger","2","3","5","209","214","2.336448598130841121495327103"
"2021-07-31T00:00:00.000","Prince George's","MD","Passenger","1","0","1","129","130","0.7692307692307692307692307692"
"2021-07-31T00:00:00.000","St. Mary's","MD","Passenger","1","0","1","183","184","0.5434782608695652173913043478"
"2021-07-31T00:00:00.000","Washington","MD","Passenger","2","0","2","11","13","15.38461538461538461538461538"
"2021-07-31T00:00:00.000","Penobscot","ME","Passenger","0","1","1","9","10","10.0"
"2021-07-31T00:00:00.000","Saginaw","MI","Passenger","1","0","1","7","8","12.500"
"2021-07-31T00:00:00.000","Hennepin","MN","Passenger","1","0","1","62","63","1.587301587301587301587301587"
"2021-07-31T00:00:00.000","Kanabec","MN","Passenger","1","0","1","0","1","100"
"2021-07-31T00:00:00.000","Boone","MO","Passenger","0","1","1","8","9","11.11111111111111111111111111"
"2021-07-31T00:00:00.000","Greene","MO","Passenger","0","1","1","22","23","4.347826086956521739130434783"
"2021-07-31T00:00:00.000","Platte","MO","Passenger","1","0","1","15","16","6.2500"
"2021-07-31T00:00:00.000","Ray","MO","Passenger","0","1","1","0","1","100"
"2021-07-31T00:00:00.000","St. Louis","MO","Passenger","1","0","1","77","78","1.282051282051282051282051282"
"2021-07-31T00:00:00.000","Harrison","MS","Passenger","2","0","2","51","53","3.773584905660377358490566038"
"2021-07-31T00:00:00.000","Flathead","MT","Passenger","1","0","1","37","38","2.631578947368421052631578947"
"2021-07-31T00:00:00.000","Glacier","MT","Passenger","0","1","1","5","6","16.66666666666666666666666667"
"2021-07-31T00:00:00.000","Missoula","MT","Passenger","1","0","1","45","46","2.173913043478260869565217391"
"2021-07-31T00:00:00.000","Cumberland","NC","Passenger","0","2","2","415","417","0.4796163069544364508393285372"
"2021-07-31T00:00:00.000","Cumberland","NC","Truck","1","0","1","92","93","1.075268817204301075268817204"
"2021-07-31T00:00:00.000","Harnett","NC","Passenger","0","1","1","162","163","0.6134969325153374233128834356"
"2021-07-31T00:00:00.000","Moore","NC","Passenger","0","1","1","132","133","0.7518796992481203007518796992"
"2021-07-31T00:00:00.000","Onslow","NC","Passenger","0","1","1","165","166","0.6024096385542168674698795181"
"2021-07-31T00:00:00.000","Wayne","NC","Passenger","1","0","1","28","29","3.448275862068965517241379310"
"2021-07-31T00:00:00.000","Wilson","NC","Passenger","1","0","1","1","2","50.0"
"2021-07-31T00:00:00.000","Williams","ND","Passenger","0","1","1","7","8","12.500"
"2021-07-31T00:00:00.000","Douglas","NE","Passenger","1","1","2","52","54","3.703703703703703703703703704"
"2021-07-31T00:00:00.000","Carroll","NH","Passenger","0","1","1","3","4","25.00"
"2021-07-31T00:00:00.000","Burlington","NJ","Passenger","0","1","1","129","130","0.7692307692307692307692307692"
"2021-07-31T00:00:00.000","Camden","NJ","Passenger","0","1","1","11","12","8.333333333333333333333333333"
"2021-07-31T00:00:00.000","Hudson","NJ","Truck","1","0","1","12","13","7.692307692307692307692307692"
"2021-07-31T00:00:00.000","Hudson","NJ","Passenger","1","0","1","118","119","0.8403361344537815126050420168"
"2021-07-31T00:00:00.000","Chaves","NM","Passenger","1","0","1","6","7","14.28571428571428571428571429"
"2021-07-31T00:00:00.000","Carson City","NV","Passenger","1","0","1","11","12","8.333333333333333333333333333"
"2021-07-31T00:00:00.000","Clark","NV","Passenger","5","4","9","570","579","1.554404145077720207253886010"
"2021-07-31T00:00:00.000","Washoe","NV","Passenger","1","0","1","66","67","1.492537313432835820895522388"
"2021-07-31T00:00:00.000","Erie","NY","Passenger","1","0","1","31","32","3.12500"
"2021-07-31T00:00:00.000","Jefferson","NY","Passenger","0","1","1","209","210","0.4761904761904761904761904762"
"2021-07-31T00:00:00.000","Kings","NY","Passenger","1","0","1","54","55","1.818181818181818181818181818"
"2021-07-31T00:00:00.000","New York","NY","Passenger","1","0","1","46","47","2.127659574468085106382978723"
"2021-07-31T00:00:00.000","Queens","NY","Passenger","2","0","2","43","45","4.444444444444444444444444444"
"2021-07-31T00:00:00.000","Saratoga","NY","Passenger","1","0","1","40","41","2.439024390243902439024390244"
"2021-07-31T00:00:00.000","Montgomery","OH","Passenger","0","1","1","48","49","2.040816326530612244897959184"
"2021-07-31T00:00:00.000","Shelby","OH","Passenger","0","1","1","1","2","50.0"
"2021-07-31T00:00:00.000","Rogers","OK","Passenger","1","0","1","3","4","25.00"
"2021-07-31T00:00:00.000","Clackamas","OR","Passenger","2","0","2","150","152","1.315789473684210526315789474"
"2021-07-31T00:00:00.000","Klamath","OR","Passenger","1","0","1","20","21","4.761904761904761904761904762"
"2021-07-31T00:00:00.000","Multnomah","OR","Passenger","2","5","7","571","578","1.211072664359861591695501730"
"2021-07-31T00:00:00.000","Washington","OR","Passenger","1","0","1","328","329","0.3039513677811550151975683891"
"2021-07-31T00:00:00.000","Yamhill","OR","Passenger","1","0","1","27","28","3.571428571428571428571428571"
"2021-07-31T00:00:00.000","Allegheny","PA","Passenger","1","1","2","54","56","3.571428571428571428571428571"
"2021-07-31T00:00:00.000","Bucks","PA","Passenger","1","0","1","17","18","5.555555555555555555555555556"
"2021-07-31T00:00:00.000","Montgomery","PA","Passenger","1","0","1","18","19","5.263157894736842105263157895"
"2021-07-31T00:00:00.000","Philadelphia","PA","Passenger","1","0","1","42","43","2.325581395348837209302325581"
"2021-07-31T00:00:00.000","RÃ­o Grande","PR","Passenger","1","0","1","0","1","100"
"2021-07-31T00:00:00.000","Newport","RI","Truck","1","0","1","10","11","9.090909090909090909090909091"
"2021-07-31T00:00:00.000","Newport","RI","Passenger","1","0","1","80","81","1.234567901234567901234567901"
"2021-07-31T00:00:00.000","Richland","SC","Passenger","0","1","1","128","129","0.7751937984496124031007751938"
"2021-07-31T00:00:00.000","Spartanburg","SC","Passenger","0","1","1","34","35","2.857142857142857142857142857"
"2021-07-31T00:00:00.000","Sumter","SC","Passenger","0","1","1","34","35","2.857142857142857142857142857"
"2021-07-31T00:00:00.000","Pennington","SD","Passenger","1","0","1","29","30","3.333333333333333333333333333"
"2021-07-31T00:00:00.000","Davidson","TN","Passenger","1","0","1","43","44","2.272727272727272727272727273"
"2021-07-31T00:00:00.000","Montgomery","TN","Passenger","1","0","1","206","207","0.4830917874396135265700483092"
"2021-07-31T00:00:00.000","Tipton","TN","Passenger","1","0","1","12","13","7.692307692307692307692307692"
"2021-07-31T00:00:00.000","Bell","TX","Passenger","0","1","1","341","342","0.2923976608187134502923976608"
"2021-07-31T00:00:00.000","Bexar","TX","Passenger","4","4","8","473","481","1.663201663201663201663201663"
"2021-07-31T00:00:00.000","Dallas","TX","Passenger","1","0","1","134","135","0.7407407407407407407407407407"
"2021-07-31T00:00:00.000","Denton","TX","Passenger","1","0","1","62","63","1.587301587301587301587301587"
"2021-07-31T00:00:00.000","El Paso","TX","Passenger","2","0","2","350","352","0.5681818181818181818181818182"
"2021-07-31T00:00:00.000","Harris","TX","Passenger","1","0","1","177","178","0.5617977528089887640449438202"
"2021-07-31T00:00:00.000","Hidalgo","TX","Passenger","0","1","1","54","55","1.818181818181818181818181818"
"2021-07-31T00:00:00.000","Montgomery","TX","Passenger","1","1","2","30","32","6.2500"
"2021-07-31T00:00:00.000","Nueces","TX","Passenger","1","0","1","64","65","1.538461538461538461538461538"
"2021-07-31T00:00:00.000","Travis","TX","Passenger","2","2","4","140","144","2.777777777777777777777777778"
"2021-07-31T00:00:00.000","Wichita","TX","Passenger","1","0","1","38","39","2.564102564102564102564102564"
"2021-07-31T00:00:00.000","Salt Lake","UT","Passenger","0","2","2","144","146","1.369863013698630136986301370"
"2021-07-31T00:00:00.000","Albemarle","VA","Passenger","1","0","1","19","20","5.00"
"2021-07-31T00:00:00.000","Alexandria","VA","Passenger","4","0","4","130","134","2.985074626865671641791044776"
"2021-07-31T00:00:00.000","Arlington","VA","Passenger","0","1","1","126","127","0.7874015748031496062992125984"
"2021-07-31T00:00:00.000","Chesapeake","VA","Passenger","0","4","4","382","386","1.036269430051813471502590674"
"2021-07-31T00:00:00.000","Danville","VA","Passenger","1","0","1","0","1","100"
"2021-07-31T00:00:00.000","Fairfax","VA","Passenger","4","5","9","664","673","1.337295690936106983655274889"
"2021-07-31T00:00:00.000","Goochland","VA","Passenger","4","0","4","174","178","2.247191011235955056179775281"
"2021-07-31T00:00:00.000","Loudoun","VA","Passenger","1","0","1","66","67","1.492537313432835820895522388"
"2021-07-31T00:00:00.000","Louisa","VA","Passenger","0","1","1","0","1","100"
"2021-07-31T00:00:00.000","Manassas","VA","Passenger","0","1","1","5","6","16.66666666666666666666666667"
"2021-07-31T00:00:00.000","Norfolk","VA","Passenger","1","1","2","312","314","0.6369426751592356687898089172"
"2021-07-31T00:00:00.000","Portsmouth","VA","Passenger","1","1","2","63","65","3.076923076923076923076923077"
"2021-07-31T00:00:00.000","Powhatan","VA","Passenger","1","0","1","1","2","50.0"
"2021-07-31T00:00:00.000","Prince William","VA","Passenger","1","1","2","195","197","1.015228426395939086294416244"
"2021-07-31T00:00:00.000","Stafford","VA","Passenger","2","1","3","98","101","2.970297029702970297029702970"
"2021-07-31T00:00:00.000","Suffolk","VA","Passenger","1","0","1","108","109","0.9174311926605504587155963303"
"2021-07-31T00:00:00.000","Virginia Beach","VA","Passenger","2","0","2","563","565","0.3539823008849557522123893805"
"2021-07-31T00:00:00.000","Adams","WA","Passenger","16","14","30","13039","13069","0.2295508455122809702349070319"
"2021-07-31T00:00:00.000","Adams","WA","Truck","0","0","0","5394","5394","0"
"2021-07-31T00:00:00.000","Asotin","WA","Truck","1","0","1","6772","6773","0.01476450612727004281706776908"
"2021-07-31T00:00:00.000","Asotin","WA","Passenger","22","18","40","12729","12769","0.3132586733495183647897251155"
"2021-07-31T00:00:00.000","Benton","WA","Passenger","551","406","957","136342","137299","0.6970189149229054836524665147"
"2021-07-31T00:00:00.000","Benton","WA","Truck","10","0","10","43660","43670","0.02289901534234027936798717655"
"2021-07-31T00:00:00.000","Chelan","WA","Passenger","357","100","457","54727","55184","0.8281385908959118585097129603"
"2021-07-31T00:00:00.000","Chelan","WA","Truck","4","0","4","23110","23114","0.01730552911655273859998269447"
"2021-07-31T00:00:00.000","Clallam","WA","Passenger","352","224","576","50477","51053","1.128239280747458523495191272"
"2021-07-31T00:00:00.000","Clallam","WA","Truck","3","0","3","22045","22048","0.01360667634252539912917271408"
"2021-07-31T00:00:00.000","Clark","WA","Passenger","3085","1504","4589","322452","327041","1.403187979488810271495011329"
"2021-07-31T00:00:00.000","Clark","WA","Truck","31","0","31","84277","84308","0.03676993879584381078901171894"
"2021-07-31T00:00:00.000","Columbia","WA","Passenger","6","2","8","2472","2480","0.3225806451612903225806451613"
"2021-07-31T00:00:00.000","Columbia","WA","Truck","1","0","1","1555","1556","0.06426735218508997429305912596"
"2021-07-31T00:00:00.000","Cowlitz","WA","Truck","4","0","4","29128","29132","0.01373060551970341892077440615"
"2021-07-31T00:00:00.000","Cowlitz","WA","Passenger","243","157","400","72253","72653","0.5505622617097711037396941627"
"2021-07-31T00:00:00.000","Douglas","WA","Passenger","101","52","153","28520","28673","0.5336030411885746172357269905"
"2021-07-31T00:00:00.000","Douglas","WA","Truck","2","0","2","12704","12706","0.01574059499449079175192822289"
"2021-07-31T00:00:00.000","Ferry","WA","Passenger","9","3","12","4382","4394","0.2730996813837050523441055985"
"2021-07-31T00:00:00.000","Ferry","WA","Truck","0","0","0","3648","3648","0"
"2021-07-31T00:00:00.000","Franklin","WA","Passenger","141","102","243","62077","62320","0.3899229781771501925545571245"
"2021-07-31T00:00:00.000","Franklin","WA","Truck","3","0","3","20730","20733","0.01446968600781363044421936044"
"2021-07-31T00:00:00.000","Garfield","WA","Passenger","0","3","3","1378","1381","0.2172338884866039102099927589"
"2021-07-31T00:00:00.000","Garfield","WA","Truck","0","0","0","1002","1002","0"
"2021-07-31T00:00:00.000","Grant","WA","Passenger","125","96","221","66930","67151","0.3291090229482807404208425787"
"2021-07-31T00:00:00.000","Grant","WA","Truck","1","0","1","27949","27950","0.003577817531305903398926654741"
"2021-07-31T00:00:00.000","Grays Harbor","WA","Passenger","190","153","343","49530","49873","0.6877468770677520903093858400"
"2021-07-31T00:00:00.000","Grays Harbor","WA","Truck","8","0","8","21412","21420","0.03734827264239028944911297852"
"2021-07-31T00:00:00.000","Island","WA","Truck","7","0","7","21606","21613","0.03238791468097904039235645214"
"2021-07-31T00:00:00.000","Island","WA","Passenger","639","333","972","63407","64379","1.509809099240435545752496932"
"2021-07-31T00:00:00.000","Jefferson","WA","Truck","0","0","0","9624","9624","0"
"2021-07-31T00:00:00.000","Jefferson","WA","Passenger","347","194","541","24892","25433","2.127157629850981008925411866"
"2021-07-31T00:00:00.000","King","WA","Passenger","31976","9639","41615","1367572","1409187","2.953121196831932170819060920"
"2021-07-31T00:00:00.000","King","WA","Truck","96","1","97","184375","184472","0.05258250574612949390693438571"
"2021-07-31T00:00:00.000","Kitsap","WA","Passenger","1983","907","2890","180928","183818","1.572207291995343219924055316"
"2021-07-31T00:00:00.000","Kitsap","WA","Truck","17","0","17","54520","54537","0.03117149824889524542970827145"
"2021-07-31T00:00:00.000","Kittitas","WA","Passenger","172","70","242","29984","30226","0.8006352147158075828756699530"
"2021-07-31T00:00:00.000","Kittitas","WA","Truck","2","0","2","14796","14798","0.01351533991079875658872820651"
"2021-07-31T00:00:00.000","Klickitat","WA","Passenger","78","50","128","15354","15482","0.8267665676269215863583516342"
"2021-07-31T00:00:00.000","Klickitat","WA","Truck","1","0","1","8315","8316","0.01202501202501202501202501203"
"2021-07-31T00:00:00.000","Lewis","WA","Passenger","175","151","326","59657","59983","0.5434873214077321907873897604"
"2021-07-31T00:00:00.000","Lewis","WA","Truck","2","0","2","26778","26780","0.007468259895444361463778939507"
"2021-07-31T00:00:00.000","Lincoln","WA","Truck","0","0","0","4762","4762","0"
"2021-07-31T00:00:00.000","Lincoln","WA","Passenger","8","15","23","7726","7749","0.2968124919344431539553490773"
"2021-07-31T00:00:00.000","Mason","WA","Passenger","239","147","386","48090","48476","0.7962703193332783232940011552"
"2021-07-31T00:00:00.000","Mason","WA","Truck","4","0","4","21344","21348","0.01873711823121603897320592093"
"2021-07-31T00:00:00.000","Okanogan","WA","Truck","2","0","2","16759","16761","0.01193246226358809140266093908"
"2021-07-31T00:00:00.000","Okanogan","WA","Passenger","66","44","110","26555","26665","0.4125257828614288393024564035"
"2021-07-31T00:00:00.000","Pacific","WA","Truck","0","0","0","7963","7963","0"
"2021-07-31T00:00:00.000","Pacific","WA","Passenger","55","56","111","16023","16134","0.6879880996653030866493120119"
"2021-07-31T00:00:00.000","Pend Oreille","WA","Truck","1","0","1","5749","5750","0.01739130434782608695652173913"
"2021-07-31T00:00:00.000","Pend Oreille","WA","Passenger","15","7","22","9274","9296","0.2366609294320137693631669535"
"2021-07-31T00:00:00.000","Pierce","WA","Passenger","3853","2121","5974","560191","566165","1.055169429406621744544434926"
"2021-07-31T00:00:00.000","Pierce","WA","Truck","35","0","35","145994","146029","0.02396784200398550972751987619"
"2021-07-31T00:00:00.000","San Juan","WA","Passenger","444","140","584","14247","14831","3.937698064864135931494841885"
"2021-07-31T00:00:00.000","San Juan","WA","Truck","0","0","0","5958","5958","0"
"2021-07-31T00:00:00.000","Skagit","WA","Passenger","633","302","935","91898","92833","1.007184945008779205670397380"
"2021-07-31T00:00:00.000","Skagit","WA","Truck","6","0","6","33046","33052","0.01815321311872201379644197023"
"2021-07-31T00:00:00.000","Skamania","WA","Truck","0","0","0","4028","4028","0"
"2021-07-31T00:00:00.000","Skamania","WA","Passenger","55","37","92","8409","8501","1.082225620515233501940948124"
"2021-07-31T00:00:00.000","Snohomish","WA","Passenger","6274","2201","8475","539957","548432","1.545314642471628205502231817"
"2021-07-31T00:00:00.000","Snohomish","WA","Truck","39","0","39","126235","126274","0.03088521785957520946513138097"
"2021-07-31T00:00:00.000","Spokane","WA","Passenger","1159","692","1851","326312","328163","0.5640489634724207177530678352"
"2021-07-31T00:00:00.000","Spokane","WA","Truck","24","0","24","102382","102406","0.02343612678944593090248618245"
"2021-07-31T00:00:00.000","Stevens","WA","Passenger","52","46","98","30416","30514","0.3211640558432195058006161106"
"2021-07-31T00:00:00.000","Stevens","WA","Truck","1","0","1","18928","18929","0.005282899255111205029320090866"
"2021-07-31T00:00:00.000","Thurston","WA","Truck","23","0","23","56567","56590","0.04064322318430818165753666726"
"2021-07-31T00:00:00.000","Thurston","WA","Passenger","1747","942","2689","198132","200821","1.339003391079618167422729695"
"2021-07-31T00:00:00.000","Wahkiakum","WA","Passenger","15","9","24","3093","3117","0.7699711260827718960538979788"
"2021-07-31T00:00:00.000","Wahkiakum","WA","Truck","0","0","0","1796","1796","0"
"2021-07-31T00:00:00.000","Walla Walla","WA","Passenger","115","80","195","36595","36790","0.5300353356890459363957597173"
"2021-07-31T00:00:00.000","Walla Walla","WA","Truck","1","0","1","14067","14068","0.007108330963889678703440432187"
"2021-07-31T00:00:00.000","Whatcom","WA","Truck","12","0","12","43885","43897","0.02733672004920609608857097296"
"2021-07-31T00:00:00.000","Whatcom","WA","Passenger","1530","642","2172","150721","152893","1.420601335574552137769551255"
"2021-07-31T00:00:00.000","Whitman","WA","Passenger","64","52","116","21977","22093","0.5250531842665097542207939166"
"2021-07-31T00:00:00.000","Whitman","WA","Truck","2","0","2","8598","8600","0.02325581395348837209302325581"
"2021-07-31T00:00:00.000","Yakima","WA","Truck","3","0","3","61743","61746","0.004858614323195024778933048295"
"2021-07-31T00:00:00.000","Yakima","WA","Passenger","251","171","422","169377","169799","0.2485291432811736229306415232"
"2021-07-31T00:00:00.000","Douglas","WI","Passenger","1","0","1","2","3","33.33333333333333333333333333"
"2021-07-31T00:00:00.000","Milwaukee","WI","Passenger","1","0","1","36","37","2.702702702702702702702702703"
"2021-07-31T00:00:00.000","Ozaukee","WI","Passenger","0","1","1","3","4","25.00"
"2021-08-31T00:00:00.000","Anchorage","AK","Passenger","1","0","1","127","128","0.7812500"
"2021-08-31T00:00:00.000","Fairbanks North Star","AK","Passenger","0","1","1","78","79","1.265822784810126582278481013"
"2021-08-31T00:00:00.000","Juneau","AK","Passenger","0","1","1","24","25","4.00"
"2021-08-31T00:00:00.000","Sevier","AR","Passenger","0","1","1","0","1","100"
"2021-08-31T00:00:00.000","Maricopa","AZ","Passenger","5","3","8","903","911","0.8781558726673984632272228321"
"2021-08-31T00:00:00.000","Pima","AZ","Passenger","1","1","2","231","233","0.8583690987124463519313304721"
"2021-08-31T00:00:00.000","Pinal","AZ","Passenger","1","0","1","110","111","0.9009009009009009009009009009"
"2021-08-31T00:00:00.000","Alameda","CA","Passenger","4","0","4","208","212","1.886792452830188679245283019"
"2021-08-31T00:00:00.000","Contra Costa","CA","Passenger","2","5","7","301","308","2.272727272727272727272727273"
"2021-08-31T00:00:00.000","Fresno","CA","Passenger","1","0","1","153","154","0.6493506493506493506493506494"
"2021-08-31T00:00:00.000","Kern","CA","Passenger","1","1","2","193","195","1.025641025641025641025641026"
"2021-08-31T00:00:00.000","Los Angeles","CA","Passenger","9","7","16","768","784","2.040816326530612244897959184"
"2021-08-31T00:00:00.000","Monterey","CA","Passenger","1","1","2","139","141","1.418439716312056737588652482"
"2021-08-31T00:00:00.000","Orange","CA","Passenger","5","2","7","388","395","1.772151898734177215189873418"
"2021-08-31T00:00:00.000","Placer","CA","Passenger","1","0","1","61","62","1.612903225806451612903225806"
"2021-08-31T00:00:00.000","Riverside","CA","Passenger","6","1","7","476","483","1.449275362318840579710144928"
"2021-08-31T00:00:00.000","Sacramento","CA","Passenger","2","0","2","206","208","0.9615384615384615384615384615"
"2021-08-31T00:00:00.000","San Bernardino","CA","Passenger","0","1","1","356","357","0.2801120448179271708683473389"
"2021-08-31T00:00:00.000","San Diego","CA","Passenger","17","8","25","2490","2515","0.9940357852882703777335984095"
"2021-08-31T00:00:00.000","San Francisco","CA","Passenger","0","1","1","69","70","1.428571428571428571428571429"
"2021-08-31T00:00:00.000","San Luis Obispo","CA","Passenger","1","0","1","50","51","1.960784313725490196078431373"
"2021-08-31T00:00:00.000","Santa Barbara","CA","Passenger","2","0","2","72","74","2.702702702702702702702702703"
"2021-08-31T00:00:00.000","Santa Clara","CA","Passenger","7","2","9","217","226","3.982300884955752212389380531"
"2021-08-31T00:00:00.000","Santa Cruz","CA","Passenger","1","0","1","22","23","4.347826086956521739130434783"
"2021-08-31T00:00:00.000","Sonoma","CA","Passenger","0","1","1","77","78","1.282051282051282051282051282"
"2021-08-31T00:00:00.000","Ventura","CA","Passenger","1","2","3","248","251","1.195219123505976095617529880"
"2021-08-31T00:00:00.000","Arapahoe","CO","Passenger","1","0","1","99","100","1.00"
"2021-08-31T00:00:00.000","Boulder","CO","Passenger","0","1","1","28","29","3.448275862068965517241379310"
"2021-08-31T00:00:00.000","Denver","CO","Passenger","1","0","1","104","105","0.9523809523809523809523809524"
"2021-08-31T00:00:00.000","El Paso","CO","Passenger","2","0","2","611","613","0.3262642740619902120717781403"
"2021-08-31T00:00:00.000","Larimer","CO","Passenger","1","0","1","40","41","2.439024390243902439024390244"
"2021-08-31T00:00:00.000","Las Animas","CO","Passenger","1","0","1","0","1","100"
"2021-08-31T00:00:00.000","New London","CT","Passenger","0","3","3","221","224","1.339285714285714285714285714"
"2021-08-31T00:00:00.000","District of Columbia","DC","Passenger","4","3","7","196","203","3.448275862068965517241379310"
"2021-08-31T00:00:00.000","Kent","DE","Passenger","0","1","1","63","64","1.562500"
"2021-08-31T00:00:00.000","New Castle","DE","Passenger","1","0","1","19","20","5.00"
"2021-08-31T00:00:00.000","Broward","FL","Passenger","1","0","1","94","95","1.052631578947368421052631579"
"2021-08-31T00:00:00.000","Duval","FL","Passenger","0","1","1","294","295","0.3389830508474576271186440678"
"2021-08-31T00:00:00.000","Hillsborough","FL","Passenger","0","1","1","133","134","0.7462686567164179104477611940"
"2021-08-31T00:00:00.000","Lake","FL","Passenger","1","0","1","18","19","5.263157894736842105263157895"
"2021-08-31T00:00:00.000","Okaloosa","FL","Passenger","0","1","1","101","102","0.9803921568627450980392156863"
"2021-08-31T00:00:00.000","Orange","FL","Passenger","1","0","1","97","98","1.020408163265306122448979592"
"2021-08-31T00:00:00.000","Palm Beach","FL","Passenger","1","0","1","51","52","1.923076923076923076923076923"
"2021-08-31T00:00:00.000","Pinellas","FL","Passenger","0","1","1","75","76","1.315789473684210526315789474"
"2021-08-31T00:00:00.000","Polk","FL","Passenger","1","0","1","53","54","1.851851851851851851851851852"
"2021-08-31T00:00:00.000","Sarasota","FL","Passenger","2","0","2","25","27","7.407407407407407407407407407"
"2021-08-31T00:00:00.000","St. Johns","FL","Passenger","0","1","1","34","35","2.857142857142857142857142857"
"2021-08-31T00:00:00.000","Bartow","GA","Passenger","0","1","1","2","3","33.33333333333333333333333333"
"2021-08-31T00:00:00.000","Bryan","GA","Passenger","1","0","1","46","47","2.127659574468085106382978723"
"2021-08-31T00:00:00.000","Columbia","GA","Passenger","1","0","1","109","110","0.9090909090909090909090909091"
"2021-08-31T00:00:00.000","DeKalb","GA","Passenger","1","0","1","51","52","1.923076923076923076923076923"
"2021-08-31T00:00:00.000","Houston","GA","Passenger","1","0","1","44","45","2.222222222222222222222222222"
"2021-08-31T00:00:00.000","Liberty","GA","Passenger","1","0","1","104","105","0.9523809523809523809523809524"
"2021-08-31T00:00:00.000","Rockdale","GA","Passenger","1","0","1","7","8","12.500"
"2021-08-31T00:00:00.000","Honolulu","HI","Passenger","5","2","7","340","347","2.017291066282420749279538905"
"2021-08-31T00:00:00.000","Champaign","IL","Passenger","1","0","1","10","11","9.090909090909090909090909091"
"2021-08-31T00:00:00.000","Cook","IL","Passenger","1","0","1","167","168","0.5952380952380952380952380952"
"2021-08-31T00:00:00.000","DuPage","IL","Passenger","1","0","1","44","45","2.222222222222222222222222222"
"2021-08-31T00:00:00.000","Lake","IL","Passenger","3","0","3","158","161","1.863354037267080745341614907"
"2021-08-31T00:00:00.000","St. Clair","IL","Passenger","2","0","2","126","128","1.562500"
"2021-08-31T00:00:00.000","Hamilton","IN","Passenger","2","0","2","28","30","6.666666666666666666666666667"
"2021-08-31T00:00:00.000","Howard","IN","Passenger","0","1","1","5","6","16.66666666666666666666666667"
"2021-08-31T00:00:00.000","Vigo","IN","Passenger","1","0","1","4","5","20.0"
"2021-08-31T00:00:00.000","Geary","KS","Passenger","1","0","1","88","89","1.123595505617977528089887640"
"2021-08-31T00:00:00.000","Leavenworth","KS","Passenger","0","1","1","111","112","0.8928571428571428571428571429"
"2021-08-31T00:00:00.000","Oldham","KY","Passenger","0","1","1","4","5","20.0"
"2021-08-31T00:00:00.000","Plaquemines","LA","Passenger","0","1","1","15","16","6.2500"
"2021-08-31T00:00:00.000","Hampshire","MA","Passenger","1","0","1","4","5","20.0"
"2021-08-31T00:00:00.000","Middlesex","MA","Passenger","1","1","2","88","90","2.222222222222222222222222222"
"2021-08-31T00:00:00.000","Suffolk","MA","Passenger","0","2","2","31","33","6.060606060606060606060606061"
"2021-08-31T00:00:00.000","Anne Arundel","MD","Passenger","4","3","7","361","368","1.902173913043478260869565217"
"2021-08-31T00:00:00.000","Baltimore","MD","Passenger","1","0","1","81","82","1.219512195121951219512195122"
"2021-08-31T00:00:00.000","Calvert","MD","Passenger","0","2","2","84","86","2.325581395348837209302325581"
"2021-08-31T00:00:00.000","Carroll","MD","Passenger","0","1","1","13","14","7.142857142857142857142857143"
"2021-08-31T00:00:00.000","Charles","MD","Truck","1","0","1","9","10","10.0"
"2021-08-31T00:00:00.000","Charles","MD","Passenger","1","1","2","63","65","3.076923076923076923076923077"
"2021-08-31T00:00:00.000","Frederick","MD","Passenger","2","1","3","69","72","4.166666666666666666666666667"
"2021-08-31T00:00:00.000","Howard","MD","Passenger","0","1","1","57","58","1.724137931034482758620689655"
"2021-08-31T00:00:00.000","Montgomery","MD","Passenger","2","3","5","203","208","2.403846153846153846153846154"
"2021-08-31T00:00:00.000","Prince George's","MD","Passenger","1","0","1","126","127","0.7874015748031496062992125984"
"2021-08-31T00:00:00.000","St. Mary's","MD","Passenger","1","0","1","180","181","0.5524861878453038674033149171"
"2021-08-31T00:00:00.000","Washington","MD","Passenger","2","0","2","11","13","15.38461538461538461538461538"
"2021-08-31T00:00:00.000","Penobscot","ME","Passenger","0","1","1","9","10","10.0"
"2021-08-31T00:00:00.000","Saginaw","MI","Passenger","1","0","1","7","8","12.500"
"2021-08-31T00:00:00.000","Hennepin","MN","Passenger","1","0","1","62","63","1.587301587301587301587301587"
"2021-08-31T00:00:00.000","Kanabec","MN","Passenger","1","0","1","0","1","100"
"2021-08-31T00:00:00.000","Boone","MO","Passenger","0","1","1","9","10","10.0"
"2021-08-31T00:00:00.000","Greene","MO","Passenger","0","1","1","21","22","4.545454545454545454545454545"
"2021-08-31T00:00:00.000","Platte","MO","Passenger","1","0","1","14","15","6.666666666666666666666666667"
"2021-08-31T00:00:00.000","Ray","MO","Passenger","0","1","1","0","1","100"
"2021-08-31T00:00:00.000","St. Louis","MO","Passenger","1","0","1","75","76","1.315789473684210526315789474"
"2021-08-31T00:00:00.000","Harrison","MS","Passenger","2","0","2","50","52","3.846153846153846153846153846"
"2021-08-31T00:00:00.000","Flathead","MT","Passenger","1","0","1","36","37","2.702702702702702702702702703"
"2021-08-31T00:00:00.000","Glacier","MT","Passenger","0","1","1","5","6","16.66666666666666666666666667"
"2021-08-31T00:00:00.000","Missoula","MT","Passenger","1","0","1","42","43","2.325581395348837209302325581"
"2021-08-31T00:00:00.000","Cumberland","NC","Truck","1","0","1","94","95","1.052631578947368421052631579"
"2021-08-31T00:00:00.000","Cumberland","NC","Passenger","0","2","2","411","413","0.4842615012106537530266343826"
"2021-08-31T00:00:00.000","Harnett","NC","Passenger","0","1","1","159","160","0.62500"
"2021-08-31T00:00:00.000","Mecklenburg","NC","Passenger","1","0","1","71","72","1.388888888888888888888888889"
"2021-08-31T00:00:00.000","Moore","NC","Passenger","0","1","1","125","126","0.7936507936507936507936507937"
"2021-08-31T00:00:00.000","Onslow","NC","Passenger","0","1","1","163","164","0.6097560975609756097560975610"
"2021-08-31T00:00:00.000","Wake","NC","Passenger","1","0","1","100","101","0.9900990099009900990099009901"
"2021-08-31T00:00:00.000","Wayne","NC","Passenger","1","0","1","29","30","3.333333333333333333333333333"
"2021-08-31T00:00:00.000","Wilson","NC","Passenger","1","0","1","1","2","50.0"
"2021-08-31T00:00:00.000","Williams","ND","Passenger","0","1","1","7","8","12.500"
"2021-08-31T00:00:00.000","Douglas","NE","Passenger","1","1","2","51","53","3.773584905660377358490566038"
"2021-08-31T00:00:00.000","Carroll","NH","Passenger","0","1","1","3","4","25.00"
"2021-08-31T00:00:00.000","Burlington","NJ","Passenger","0","1","1","127","128","0.7812500"
"2021-08-31T00:00:00.000","Camden","NJ","Passenger","0","1","1","11","12","8.333333333333333333333333333"
"2021-08-31T00:00:00.000","Hudson","NJ","Truck","1","0","1","12","13","7.692307692307692307692307692"
"2021-08-31T00:00:00.000","Hudson","NJ","Passenger","1","0","1","110","111","0.9009009009009009009009009009"
"2021-08-31T00:00:00.000","Chaves","NM","Passenger","1","0","1","5","6","16.66666666666666666666666667"
"2021-08-31T00:00:00.000","Carson City","NV","Passenger","1","0","1","11","12","8.333333333333333333333333333"
"2021-08-31T00:00:00.000","Clark","NV","Passenger","5","4","9","560","569","1.581722319859402460456942004"
"2021-08-31T00:00:00.000","Washoe","NV","Passenger","1","0","1","63","64","1.562500"
"2021-08-31T00:00:00.000","Erie","NY","Passenger","1","0","1","30","31","3.225806451612903225806451613"
"2021-08-31T00:00:00.000","Jefferson","NY","Passenger","0","1","1","205","206","0.4854368932038834951456310680"
"2021-08-31T00:00:00.000","Kings","NY","Passenger","1","0","1","56","57","1.754385964912280701754385965"
"2021-08-31T00:00:00.000","New York","NY","Passenger","1","0","1","43","44","2.272727272727272727272727273"
"2021-08-31T00:00:00.000","Queens","NY","Passenger","2","0","2","44","46","4.347826086956521739130434783"
"2021-08-31T00:00:00.000","Saratoga","NY","Passenger","1","0","1","40","41","2.439024390243902439024390244"
"2021-08-31T00:00:00.000","Montgomery","OH","Passenger","0","1","1","48","49","2.040816326530612244897959184"
"2021-08-31T00:00:00.000","Shelby","OH","Passenger","0","1","1","2","3","33.33333333333333333333333333"
"2021-08-31T00:00:00.000","Rogers","OK","Passenger","1","0","1","3","4","25.00"
"2021-08-31T00:00:00.000","Clackamas","OR","Passenger","2","0","2","145","147","1.360544217687074829931972789"
"2021-08-31T00:00:00.000","Klamath","OR","Passenger","1","0","1","20","21","4.761904761904761904761904762"
"2021-08-31T00:00:00.000","Multnomah","OR","Passenger","2","6","8","562","570","1.403508771929824561403508772"
"2021-08-31T00:00:00.000","Washington","OR","Passenger","1","0","1","319","320","0.312500"
"2021-08-31T00:00:00.000","Yamhill","OR","Passenger","1","0","1","26","27","3.703703703703703703703703704"
"2021-08-31T00:00:00.000","Allegheny","PA","Passenger","1","1","2","53","55","3.636363636363636363636363636"
"2021-08-31T00:00:00.000","Bucks","PA","Passenger","1","0","1","16","17","5.882352941176470588235294118"
"2021-08-31T00:00:00.000","Montgomery","PA","Passenger","2","0","2","16","18","11.11111111111111111111111111"
"2021-08-31T00:00:00.000","Philadelphia","PA","Passenger","1","0","1","42","43","2.325581395348837209302325581"
"2021-08-31T00:00:00.000","RÃ­o Grande","PR","Passenger","1","0","1","0","1","100"
"2021-08-31T00:00:00.000","Newport","RI","Passenger","1","0","1","78","79","1.265822784810126582278481013"
"2021-08-31T00:00:00.000","Newport","RI","Truck","1","0","1","10","11","9.090909090909090909090909091"
"2021-08-31T00:00:00.000","Richland","SC","Passenger","0","1","1","126","127","0.7874015748031496062992125984"
"2021-08-31T00:00:00.000","Spartanburg","SC","Passenger","0","1","1","33","34","2.941176470588235294117647059"
"2021-08-31T00:00:00.000","Sumter","SC","Passenger","0","1","1","33","34","2.941176470588235294117647059"
"2021-08-31T00:00:00.000","Pennington","SD","Passenger","1","0","1","29","30","3.333333333333333333333333333"
"2021-08-31T00:00:00.000","Davidson","TN","Passenger","1","0","1","40","41","2.439024390243902439024390244"
"2021-08-31T00:00:00.000","Montgomery","TN","Passenger","1","0","1","202","203","0.4926108374384236453201970443"
"2021-08-31T00:00:00.000","Tipton","TN","Passenger","1","0","1","12","13","7.692307692307692307692307692"
"2021-08-31T00:00:00.000","Bell","TX","Passenger","0","1","1","336","337","0.2967359050445103857566765579"
"2021-08-31T00:00:00.000","Bexar","TX","Passenger","4","4","8","466","474","1.687763713080168776371308017"
"2021-08-31T00:00:00.000","Dallas","TX","Passenger","1","0","1","127","128","0.7812500"
"2021-08-31T00:00:00.000","Denton","TX","Passenger","1","0","1","59","60","1.666666666666666666666666667"
"2021-08-31T00:00:00.000","El Paso","TX","Passenger","2","0","2","342","344","0.5813953488372093023255813953"
"2021-08-31T00:00:00.000","Harris","TX","Passenger","1","0","1","171","172","0.5813953488372093023255813953"
"2021-08-31T00:00:00.000","Hidalgo","TX","Passenger","0","1","1","52","53","1.886792452830188679245283019"
"2021-08-31T00:00:00.000","Montgomery","TX","Passenger","1","1","2","29","31","6.451612903225806451612903226"
"2021-08-31T00:00:00.000","Nueces","TX","Passenger","1","0","1","63","64","1.562500"
"2021-08-31T00:00:00.000","Travis","TX","Passenger","2","2","4","128","132","3.030303030303030303030303030"
"2021-08-31T00:00:00.000","Wichita","TX","Passenger","1","0","1","38","39","2.564102564102564102564102564"
"2021-08-31T00:00:00.000","Salt Lake","UT","Passenger","0","2","2","141","143","1.398601398601398601398601399"
"2021-08-31T00:00:00.000","Albemarle","VA","Passenger","1","0","1","20","21","4.761904761904761904761904762"
"2021-08-31T00:00:00.000","Alexandria","VA","Passenger","4","0","4","130","134","2.985074626865671641791044776"
"2021-08-31T00:00:00.000","Arlington","VA","Passenger","0","1","1","124","125","0.800"
"2021-08-31T00:00:00.000","Chesapeake","VA","Passenger","0","4","4","379","383","1.044386422976501305483028721"
"2021-08-31T00:00:00.000","Danville","VA","Passenger","1","0","1","0","1","100"
"2021-08-31T00:00:00.000","Fairfax","VA","Passenger","5","5","10","658","668","1.497005988023952095808383234"
"2021-08-31T00:00:00.000","Goochland","VA","Passenger","4","0","4","170","174","2.298850574712643678160919540"
"2021-08-31T00:00:00.000","Loudoun","VA","Passenger","1","0","1","65","66","1.515151515151515151515151515"
"2021-08-31T00:00:00.000","Louisa","VA","Passenger","0","1","1","0","1","100"
"2021-08-31T00:00:00.000","Manassas","VA","Passenger","0","1","1","5","6","16.66666666666666666666666667"
"2021-08-31T00:00:00.000","Norfolk","VA","Passenger","1","1","2","308","310","0.6451612903225806451612903226"
"2021-08-31T00:00:00.000","Portsmouth","VA","Passenger","1","1","2","61","63","3.174603174603174603174603175"
"2021-08-31T00:00:00.000","Powhatan","VA","Passenger","1","0","1","1","2","50.0"
"2021-08-31T00:00:00.000","Prince William","VA","Passenger","1","1","2","196","198","1.010101010101010101010101010"
"2021-08-31T00:00:00.000","Stafford","VA","Passenger","2","1","3","97","100","3.00"
"2021-08-31T00:00:00.000","Suffolk","VA","Passenger","1","0","1","106","107","0.9345794392523364485981308411"
"2021-08-31T00:00:00.000","Virginia Beach","VA","Passenger","2","0","2","554","556","0.3597122302158273381294964029"
"2021-08-31T00:00:00.000","Adams","WA","Passenger","16","16","32","13042","13074","0.2447605935444393452654122686"
"2021-08-31T00:00:00.000","Adams","WA","Truck","0","0","0","5416","5416","0"
"2021-08-31T00:00:00.000","Asotin","WA","Passenger","22","18","40","12746","12786","0.3128421711246676051931800407"
"2021-08-31T00:00:00.000","Asotin","WA","Truck","2","0","2","6757","6759","0.02959017606154756620801893771"
"2021-08-31T00:00:00.000","Benton","WA","Passenger","578","418","996","136269","137265","0.7256037591520052453283794121"
"2021-08-31T00:00:00.000","Benton","WA","Truck","16","0","16","43618","43634","0.03666865288536462391712884448"
"2021-08-31T00:00:00.000","Chelan","WA","Passenger","371","101","472","54732","55204","0.8550105064850373161365118470"
"2021-08-31T00:00:00.000","Chelan","WA","Truck","6","0","6","23095","23101","0.02597290160599108263711527639"
"2021-08-31T00:00:00.000","Clallam","WA","Truck","3","0","3","22031","22034","0.01361532177543795951710992103"
"2021-08-31T00:00:00.000","Clallam","WA","Passenger","361","224","585","50524","51109","1.144612494863918292277289714"
"2021-08-31T00:00:00.000","Clark","WA","Passenger","3181","1516","4697","322166","326863","1.436993480448995450693409777"
"2021-08-31T00:00:00.000","Clark","WA","Truck","35","0","35","84182","84217","0.04155930512841825284681240130"
"2021-08-31T00:00:00.000","Columbia","WA","Truck","1","0","1","1539","1540","0.06493506493506493506493506494"
"2021-08-31T00:00:00.000","Columbia","WA","Passenger","7","2","9","2458","2467","0.3648155654641264693960275638"
"2021-08-31T00:00:00.000","Cowlitz","WA","Truck","7","1","8","29099","29107","0.02748479747139863263132579792"
"2021-08-31T00:00:00.000","Cowlitz","WA","Passenger","251","162","413","72126","72539","0.5693489019699747721915107735"
"2021-08-31T00:00:00.000","Douglas","WA","Passenger","104","52","156","28586","28742","0.5427597244450629740449516387"
"2021-08-31T00:00:00.000","Douglas","WA","Truck","2","0","2","12689","12691","0.01575919943266882042392246474"
"2021-08-31T00:00:00.000","Ferry","WA","Passenger","9","3","12","4392","4404","0.2724795640326975476839237057"
"2021-08-31T00:00:00.000","Ferry","WA","Truck","0","0","0","3635","3635","0"
"2021-08-31T00:00:00.000","Franklin","WA","Truck","5","0","5","20720","20725","0.02412545235223160434258142340"
"2021-08-31T00:00:00.000","Franklin","WA","Passenger","146","104","250","61977","62227","0.4017548652514181946743375062"
"2021-08-31T00:00:00.000","Garfield","WA","Passenger","0","3","3","1373","1376","0.2180232558139534883720930233"
"2021-08-31T00:00:00.000","Garfield","WA","Truck","0","0","0","1001","1001","0"
"2021-08-31T00:00:00.000","Grant","WA","Passenger","128","102","230","66876","67106","0.3427413346049533573748994129"
"2021-08-31T00:00:00.000","Grant","WA","Truck","2","0","2","28010","28012","0.007139797229758674853634156790"
"2021-08-31T00:00:00.000","Grays Harbor","WA","Truck","9","0","9","21388","21397","0.04206197130438846567275786325"
"2021-08-31T00:00:00.000","Grays Harbor","WA","Passenger","192","154","346","49516","49862","0.6939152059684729854398138863"
"2021-08-31T00:00:00.000","Island","WA","Passenger","659","336","995","63428","64423","1.544479456094872949102028779"
"2021-08-31T00:00:00.000","Island","WA","Truck","9","0","9","21625","21634","0.04160118332254784136082093002"
"2021-08-31T00:00:00.000","Jefferson","WA","Passenger","358","194","552","24863","25415","2.171945701357466063348416290"
"2021-08-31T00:00:00.000","Jefferson","WA","Truck","0","0","0","9618","9618","0"
"2021-08-31T00:00:00.000","King","WA","Truck","127","1","128","184048","184176","0.06949874033533142211797411172"
"2021-08-31T00:00:00.000","King","WA","Passenger","32713","9839","42552","1366613","1409165","3.019660579137290523111204153"
"2021-08-31T00:00:00.000","Kitsap","WA","Passenger","2026","923","2949","180984","183933","1.603301202068144378659620623"
"2021-08-31T00:00:00.000","Kitsap","WA","Truck","19","0","19","54491","54510","0.03485598972665565951201614383"
"2021-08-31T00:00:00.000","Kittitas","WA","Truck","4","0","4","14781","14785","0.02705444707473791004396347650"
"2021-08-31T00:00:00.000","Kittitas","WA","Passenger","180","74","254","29878","30132","0.8429576529934952874020974379"
"2021-08-31T00:00:00.000","Klickitat","WA","Truck","1","0","1","8334","8335","0.01199760047990401919616076785"
"2021-08-31T00:00:00.000","Klickitat","WA","Passenger","83","51","134","15374","15508","0.8640701573381480526180036110"
"2021-08-31T00:00:00.000","Lewis","WA","Passenger","192","159","351","59646","59997","0.5850292514625731286564328216"
"2021-08-31T00:00:00.000","Lewis","WA","Truck","4","0","4","26758","26762","0.01494656602645542186682609670"
"2021-08-31T00:00:00.000","Lincoln","WA","Truck","0","0","0","4775","4775","0"
"2021-08-31T00:00:00.000","Lincoln","WA","Passenger","9","15","24","7701","7725","0.3106796116504854368932038835"
"2021-08-31T00:00:00.000","Mason","WA","Passenger","250","155","405","48075","48480","0.8353960396039603960396039604"
"2021-08-31T00:00:00.000","Mason","WA","Truck","6","0","6","21322","21328","0.02813203300825206301575393848"
"2021-08-31T00:00:00.000","Okanogan","WA","Truck","2","0","2","16764","16766","0.01192890373374686866276989145"
"2021-08-31T00:00:00.000","Okanogan","WA","Passenger","67","46","113","26492","26605","0.4247321931967675249013343357"
"2021-08-31T00:00:00.000","Pacific","WA","Truck","0","0","0","7976","7976","0"
"2021-08-31T00:00:00.000","Pacific","WA","Passenger","57","57","114","16063","16177","0.7047042096804104592940594671"
"2021-08-31T00:00:00.000","Pend Oreille","WA","Truck","1","0","1","5727","5728","0.01745810055865921787709497207"
"2021-08-31T00:00:00.000","Pend Oreille","WA","Passenger","16","7","23","9254","9277","0.2479249757464697639323057023"
"2021-08-31T00:00:00.000","Pierce","WA","Passenger","3993","2132","6125","559706","565831","1.082478690633775809384780968"
"2021-08-31T00:00:00.000","Pierce","WA","Truck","41","0","41","145814","145855","0.02811010935518151588906790991"
"2021-08-31T00:00:00.000","San Juan","WA","Truck","0","0","0","5979","5979","0"
"2021-08-31T00:00:00.000","San Juan","WA","Passenger","453","142","595","14215","14810","4.017555705604321404456448346"
"2021-08-31T00:00:00.000","Skagit","WA","Passenger","646","308","954","91743","92697","1.029159519725557461406518010"
"2021-08-31T00:00:00.000","Skagit","WA","Truck","9","0","9","32997","33006","0.02726776949645518996546082530"
"2021-08-31T00:00:00.000","Skamania","WA","Passenger","56","39","95","8388","8483","1.119886832488506424613933750"
"2021-08-31T00:00:00.000","Skamania","WA","Truck","0","0","0","4036","4036","0"
"2021-08-31T00:00:00.000","Snohomish","WA","Passenger","6457","2237","8694","539624","548318","1.585576253196138007506592890"
"2021-08-31T00:00:00.000","Snohomish","WA","Truck","57","0","57","126041","126098","0.04520293739789687386001364018"
"2021-08-31T00:00:00.000","Spokane","WA","Passenger","1201","723","1924","326310","328234","0.5861671856053912757362125800"
"2021-08-31T00:00:00.000","Spokane","WA","Truck","29","0","29","102532","102561","0.02827585534462417488129015903"
"2021-08-31T00:00:00.000","Stevens","WA","Passenger","51","44","95","30296","30391","0.3125925438452173340791681748"
"2021-08-31T00:00:00.000","Stevens","WA","Truck","2","0","2","18918","18920","0.01057082452431289640591966173"
"2021-08-31T00:00:00.000","Thurston","WA","Truck","27","0","27","56483","56510","0.04777915413201203326844806229"
"2021-08-31T00:00:00.000","Thurston","WA","Passenger","1800","957","2757","198079","200836","1.372761855444243063992511303"
"2021-08-31T00:00:00.000","Wahkiakum","WA","Passenger","16","9","25","3080","3105","0.8051529790660225442834138486"
"2021-08-31T00:00:00.000","Wahkiakum","WA","Truck","0","0","0","1804","1804","0"
"2021-08-31T00:00:00.000","Walla Walla","WA","Passenger","121","86","207","36510","36717","0.5637715499632322902197891985"
"2021-08-31T00:00:00.000","Walla Walla","WA","Truck","3","0","3","14089","14092","0.02128867442520579051944365598"
"2021-08-31T00:00:00.000","Whatcom","WA","Truck","15","0","15","43886","43901","0.03416778661078335345436322635"
"2021-08-31T00:00:00.000","Whatcom","WA","Passenger","1574","652","2226","150554","152780","1.456996989134703495221887682"
"2021-08-31T00:00:00.000","Whitman","WA","Passenger","66","56","122","21970","22092","0.5522361035669020459894984610"
"2021-08-31T00:00:00.000","Whitman","WA","Truck","2","0","2","8580","8582","0.02330459100442787229084129574"
"2021-08-31T00:00:00.000","Yakima","WA","Passenger","262","174","436","168987","169423","0.2573440441970688749461407247"
"2021-08-31T00:00:00.000","Yakima","WA","Truck","5","0","5","61791","61796","0.008091138585021684251407858114"
"2021-08-31T00:00:00.000","Douglas","WI","Passenger","1","0","1","2","3","33.33333333333333333333333333"
"2021-08-31T00:00:00.000","Milwaukee","WI","Passenger","1","0","1","36","37","2.702702702702702702702702703"
"2021-08-31T00:00:00.000","Ozaukee","WI","Passenger","0","1","1","3","4","25.00"
"2021-09-30T00:00:00.000","Anchorage","AK","Passenger","1","0","1","127","128","0.7812500"
"2021-09-30T00:00:00.000","Fairbanks North Star","AK","Passenger","0","1","1","78","79","1.265822784810126582278481013"
"2021-09-30T00:00:00.000","Juneau","AK","Passenger","0","1","1","24","25","4.00"
"2021-09-30T00:00:00.000","Sevier","AR","Passenger","0","1","1","0","1","100"
"2021-09-30T00:00:00.000","Maricopa","AZ","Passenger","5","4","9","893","902","0.9977827050997782705099778271"
"2021-09-30T00:00:00.000","Pima","AZ","Passenger","1","1","2","227","229","0.8733624454148471615720524017"
"2021-09-30T00:00:00.000","Pinal","AZ","Passenger","1","0","1","108","109","0.9174311926605504587155963303"
"2021-09-30T00:00:00.000","Alameda","CA","Passenger","4","0","4","202","206","1.941747572815533980582524272"
"2021-09-30T00:00:00.000","Contra Costa","CA","Passenger","2","5","7","304","311","2.250803858520900321543408360"
"2021-09-30T00:00:00.000","Fresno","CA","Passenger","1","0","1","153","154","0.6493506493506493506493506494"
"2021-09-30T00:00:00.000","Kern","CA","Passenger","1","1","2","186","188","1.063829787234042553191489362"
"2021-09-30T00:00:00.000","Los Angeles","CA","Passenger","6","7","13","763","776","1.675257731958762886597938144"
"2021-09-30T00:00:00.000","Monterey","CA","Passenger","1","1","2","139","141","1.418439716312056737588652482"
"2021-09-30T00:00:00.000","Orange","CA","Passenger","5","2","7","384","391","1.790281329923273657289002558"
"2021-09-30T00:00:00.000","Placer","CA","Passenger","1","0","1","61","62","1.612903225806451612903225806"
"2021-09-30T00:00:00.000","Riverside","CA","Passenger","5","1","6","468","474","1.265822784810126582278481013"
"2021-09-30T00:00:00.000","Sacramento","CA","Passenger","2","0","2","208","210","0.9523809523809523809523809524"
"2021-09-30T00:00:00.000","San Bernardino","CA","Passenger","0","1","1","354","355","0.2816901408450704225352112676"
"2021-09-30T00:00:00.000","San Diego","CA","Passenger","16","9","25","2456","2481","1.007658202337767029423619508"
"2021-09-30T00:00:00.000","San Francisco","CA","Passenger","0","1","1","67","68","1.470588235294117647058823529"
"2021-09-30T00:00:00.000","San Joaquin","CA","Passenger","0","1","1","94","95","1.052631578947368421052631579"
"2021-09-30T00:00:00.000","San Luis Obispo","CA","Passenger","1","0","1","51","52","1.923076923076923076923076923"
"2021-09-30T00:00:00.000","Santa Barbara","CA","Passenger","2","0","2","69","71","2.816901408450704225352112676"
"2021-09-30T00:00:00.000","Santa Clara","CA","Passenger","6","2","8","214","222","3.603603603603603603603603604"
"2021-09-30T00:00:00.000","Santa Cruz","CA","Passenger","1","0","1","22","23","4.347826086956521739130434783"
"2021-09-30T00:00:00.000","Sonoma","CA","Passenger","0","1","1","78","79","1.265822784810126582278481013"
"2021-09-30T00:00:00.000","Ventura","CA","Passenger","1","2","3","249","252","1.190476190476190476190476190"
"2021-09-30T00:00:00.000","Boulder","CO","Passenger","0","1","1","28","29","3.448275862068965517241379310"
"2021-09-30T00:00:00.000","El Paso","CO","Passenger","2","0","2","607","609","0.3284072249589490968801313629"
"2021-09-30T00:00:00.000","Larimer","CO","Passenger","1","0","1","39","40","2.500"
"2021-09-30T00:00:00.000","Las Animas","CO","Passenger","1","0","1","0","1","100"
"2021-09-30T00:00:00.000","New London","CT","Passenger","0","4","4","216","220","1.818181818181818181818181818"
"2021-09-30T00:00:00.000","District of Columbia","DC","Passenger","4","2","6","196","202","2.970297029702970297029702970"
"2021-09-30T00:00:00.000","Kent","DE","Passenger","0","1","1","60","61","1.639344262295081967213114754"
"2021-09-30T00:00:00.000","New Castle","DE","Passenger","1","0","1","20","21","4.761904761904761904761904762"
"2021-09-30T00:00:00.000","Broward","FL","Passenger","1","0","1","89","90","1.111111111111111111111111111"
"2021-09-30T00:00:00.000","Duval","FL","Passenger","0","1","1","289","290","0.3448275862068965517241379310"
"2021-09-30T00:00:00.000","Hillsborough","FL","Passenger","0","1","1","132","133","0.7518796992481203007518796992"
"2021-09-30T00:00:00.000","Lake","FL","Passenger","1","0","1","18","19","5.263157894736842105263157895"
"2021-09-30T00:00:00.000","Okaloosa","FL","Passenger","0","1","1","99","100","1.00"
"2021-09-30T00:00:00.000","Orange","FL","Passenger","1","0","1","97","98","1.020408163265306122448979592"
"2021-09-30T00:00:00.000","Palm Beach","FL","Passenger","1","0","1","50","51","1.960784313725490196078431373"
"2021-09-30T00:00:00.000","Pinellas","FL","Passenger","0","1","1","75","76","1.315789473684210526315789474"
"2021-09-30T00:00:00.000","Polk","FL","Passenger","1","0","1","52","53","1.886792452830188679245283019"
"2021-09-30T00:00:00.000","Sarasota","FL","Passenger","2","0","2","25","27","7.407407407407407407407407407"
"2021-09-30T00:00:00.000","St. Johns","FL","Passenger","0","1","1","34","35","2.857142857142857142857142857"
"2021-09-30T00:00:00.000","Bartow","GA","Passenger","0","1","1","2","3","33.33333333333333333333333333"
"2021-09-30T00:00:00.000","Bryan","GA","Passenger","1","0","1","44","45","2.222222222222222222222222222"
"2021-09-30T00:00:00.000","Columbia","GA","Passenger","1","0","1","107","108","0.9259259259259259259259259259"
"2021-09-30T00:00:00.000","DeKalb","GA","Passenger","1","0","1","48","49","2.040816326530612244897959184"
"2021-09-30T00:00:00.000","Houston","GA","Passenger","1","0","1","42","43","2.325581395348837209302325581"
"2021-09-30T00:00:00.000","Liberty","GA","Passenger","1","0","1","104","105","0.9523809523809523809523809524"
"2021-09-30T00:00:00.000","Rockdale","GA","Passenger","1","0","1","6","7","14.28571428571428571428571429"
"2021-09-30T00:00:00.000","Honolulu","HI","Passenger","5","2","7","337","344","2.034883720930232558139534884"
"2021-09-30T00:00:00.000","Champaign","IL","Passenger","1","0","1","10","11","9.090909090909090909090909091"
"2021-09-30T00:00:00.000","Cook","IL","Passenger","2","0","2","166","168","1.190476190476190476190476190"
"2021-09-30T00:00:00.000","DuPage","IL","Passenger","1","0","1","45","46","2.173913043478260869565217391"
"2021-09-30T00:00:00.000","Lake","IL","Passenger","3","0","3","157","160","1.87500"
"2021-09-30T00:00:00.000","St. Clair","IL","Passenger","2","0","2","122","124","1.612903225806451612903225806"
"2021-09-30T00:00:00.000","Hamilton","IN","Passenger","2","0","2","27","29","6.896551724137931034482758621"
"2021-09-30T00:00:00.000","Howard","IN","Passenger","0","1","1","6","7","14.28571428571428571428571429"
"2021-09-30T00:00:00.000","Vigo","IN","Passenger","1","0","1","4","5","20.0"
"2021-09-30T00:00:00.000","Geary","KS","Passenger","1","0","1","90","91","1.098901098901098901098901099"
"2021-09-30T00:00:00.000","Leavenworth","KS","Passenger","0","1","1","109","110","0.9090909090909090909090909091"
"2021-09-30T00:00:00.000","Oldham","KY","Passenger","0","1","1","4","5","20.0"
"2021-09-30T00:00:00.000","Plaquemines","LA","Passenger","0","1","1","15","16","6.2500"
"2021-09-30T00:00:00.000","Middlesex","MA","Passenger","1","1","2","84","86","2.325581395348837209302325581"
"2021-09-30T00:00:00.000","Suffolk","MA","Passenger","0","2","2","30","32","6.2500"
"2021-09-30T00:00:00.000","Anne Arundel","MD","Passenger","4","3","7","354","361","1.939058171745152354570637119"
"2021-09-30T00:00:00.000","Baltimore","MD","Passenger","1","0","1","79","80","1.2500"
"2021-09-30T00:00:00.000","Calvert","MD","Passenger","0","2","2","83","85","2.352941176470588235294117647"
"2021-09-30T00:00:00.000","Carroll","MD","Passenger","0","1","1","12","13","7.692307692307692307692307692"
"2021-09-30T00:00:00.000","Charles","MD","Passenger","1","1","2","61","63","3.174603174603174603174603175"
"2021-09-30T00:00:00.000","Charles","MD","Truck","1","0","1","9","10","10.0"
"2021-09-30T00:00:00.000","Frederick","MD","Passenger","2","1","3","69","72","4.166666666666666666666666667"
"2021-09-30T00:00:00.000","Howard","MD","Passenger","0","1","1","55","56","1.785714285714285714285714286"
"2021-09-30T00:00:00.000","Montgomery","MD","Passenger","2","4","6","202","208","2.884615384615384615384615385"
"2021-09-30T00:00:00.000","Prince George's","MD","Passenger","1","0","1","126","127","0.7874015748031496062992125984"
"2021-09-30T00:00:00.000","St. Mary's","MD","Truck","1","0","1","42","43","2.325581395348837209302325581"
"2021-09-30T00:00:00.000","St. Mary's","MD","Passenger","1","0","1","179","180","0.5555555555555555555555555556"
"2021-09-30T00:00:00.000","Washington","MD","Passenger","2","0","2","11","13","15.38461538461538461538461538"
"2021-09-30T00:00:00.000","Penobscot","ME","Passenger","0","1","1","9","10","10.0"
"2021-09-30T00:00:00.000","Saginaw","MI","Passenger","1","0","1","6","7","14.28571428571428571428571429"
"2021-09-30T00:00:00.000","Hennepin","MN","Passenger","1","0","1","61","62","1.612903225806451612903225806"
"2021-09-30T00:00:00.000","Kanabec","MN","Passenger","1","0","1","0","1","100"
"2021-09-30T00:00:00.000","Boone","MO","Passenger","0","1","1","9","10","10.0"
"2021-09-30T00:00:00.000","Greene","MO","Passenger","0","1","1","20","21","4.761904761904761904761904762"
"2021-09-30T00:00:00.000","Platte","MO","Passenger","1","0","1","14","15","6.666666666666666666666666667"
"2021-09-30T00:00:00.000","Ray","MO","Passenger","0","1","1","0","1","100"
"2021-09-30T00:00:00.000","St. Louis","MO","Passenger","1","0","1","76","77","1.298701298701298701298701299"
"2021-09-30T00:00:00.000","Harrison","MS","Passenger","2","0","2","49","51","3.921568627450980392156862745"
"2021-09-30T00:00:00.000","Flathead","MT","Passenger","1","0","1","37","38","2.631578947368421052631578947"
"2021-09-30T00:00:00.000","Glacier","MT","Passenger","0","1","1","5","6","16.66666666666666666666666667"
"2021-09-30T00:00:00.000","Missoula","MT","Passenger","1","0","1","42","43","2.325581395348837209302325581"
"2021-09-30T00:00:00.000","Cumberland","NC","Passenger","0","2","2","400","402","0.4975124378109452736318407960"
"2021-09-30T00:00:00.000","Cumberland","NC","Truck","1","0","1","92","93","1.075268817204301075268817204"
"2021-09-30T00:00:00.000","Harnett","NC","Passenger","0","1","1","154","155","0.6451612903225806451612903226"
"2021-09-30T00:00:00.000","Mecklenburg","NC","Passenger","1","0","1","70","71","1.408450704225352112676056338"
"2021-09-30T00:00:00.000","Moore","NC","Passenger","0","1","1","125","126","0.7936507936507936507936507937"
"2021-09-30T00:00:00.000","Onslow","NC","Passenger","0","1","1","159","160","0.62500"
"2021-09-30T00:00:00.000","Wake","NC","Passenger","1","0","1","96","97","1.030927835051546391752577320"
"2021-09-30T00:00:00.000","Wayne","NC","Passenger","1","0","1","27","28","3.571428571428571428571428571"
"2021-09-30T00:00:00.000","Wilson","NC","Passenger","1","0","1","1","2","50.0"
"2021-09-30T00:00:00.000","Williams","ND","Passenger","0","1","1","8","9","11.11111111111111111111111111"
"2021-09-30T00:00:00.000","Douglas","NE","Passenger","1","1","2","49","51","3.921568627450980392156862745"
"2021-09-30T00:00:00.000","Carroll","NH","Passenger","0","1","1","3","4","25.00"
"2021-09-30T00:00:00.000","Burlington","NJ","Passenger","0","1","1","122","123","0.8130081300813008130081300813"
"2021-09-30T00:00:00.000","Camden","NJ","Passenger","0","1","1","11","12","8.333333333333333333333333333"
"2021-09-30T00:00:00.000","Hudson","NJ","Truck","1","0","1","10","11","9.090909090909090909090909091"
"2021-09-30T00:00:00.000","Hudson","NJ","Passenger","1","0","1","103","104","0.9615384615384615384615384615"
"2021-09-30T00:00:00.000","Chaves","NM","Passenger","1","0","1","5","6","16.66666666666666666666666667"
"2021-09-30T00:00:00.000","Carson City","NV","Passenger","1","0","1","11","12","8.333333333333333333333333333"
"2021-09-30T00:00:00.000","Clark","NV","Passenger","5","4","9","548","557","1.615798922800718132854578097"
"2021-09-30T00:00:00.000","Washoe","NV","Passenger","1","0","1","63","64","1.562500"
"2021-09-30T00:00:00.000","Erie","NY","Passenger","1","0","1","26","27","3.703703703703703703703703704"
"2021-09-30T00:00:00.000","Jefferson","NY","Passenger","0","1","1","202","203","0.4926108374384236453201970443"
"2021-09-30T00:00:00.000","Kings","NY","Passenger","1","0","1","56","57","1.754385964912280701754385965"
"2021-09-30T00:00:00.000","New York","NY","Passenger","1","0","1","42","43","2.325581395348837209302325581"
"2021-09-30T00:00:00.000","Queens","NY","Passenger","2","0","2","40","42","4.761904761904761904761904762"
"2021-09-30T00:00:00.000","Saratoga","NY","Passenger","1","0","1","40","41","2.439024390243902439024390244"
"2021-09-30T00:00:00.000","Montgomery","OH","Passenger","0","1","1","49","50","2.00"
"2021-09-30T00:00:00.000","Shelby","OH","Passenger","0","1","1","2","3","33.33333333333333333333333333"
"2021-09-30T00:00:00.000","Rogers","OK","Passenger","1","0","1","3","4","25.00"
"2021-09-30T00:00:00.000","Clackamas","OR","Passenger","2","0","2","141","143","1.398601398601398601398601399"
"2021-09-30T00:00:00.000","Klamath","OR","Passenger","1","0","1","20","21","4.761904761904761904761904762"
"2021-09-30T00:00:00.000","Multnomah","OR","Passenger","2","5","7","550","557","1.256732495511669658886894075"
"2021-09-30T00:00:00.000","Washington","OR","Passenger","1","0","1","311","312","0.3205128205128205128205128205"
"2021-09-30T00:00:00.000","Yamhill","OR","Passenger","1","0","1","24","25","4.00"
"2021-09-30T00:00:00.000","Allegheny","PA","Passenger","1","1","2","54","56","3.571428571428571428571428571"
"2021-09-30T00:00:00.000","Montgomery","PA","Passenger","2","0","2","16","18","11.11111111111111111111111111"
"2021-09-30T00:00:00.000","Philadelphia","PA","Passenger","1","0","1","42","43","2.325581395348837209302325581"
"2021-09-30T00:00:00.000","RÃ­o Grande","PR","Passenger","1","0","1","0","1","100"
"2021-09-30T00:00:00.000","Newport","RI","Truck","1","0","1","10","11","9.090909090909090909090909091"
"2021-09-30T00:00:00.000","Newport","RI","Passenger","1","0","1","77","78","1.282051282051282051282051282"
"2021-09-30T00:00:00.000","Charleston","SC","Passenger","1","0","1","76","77","1.298701298701298701298701299"
"2021-09-30T00:00:00.000","Richland","SC","Passenger","0","1","1","126","127","0.7874015748031496062992125984"
"2021-09-30T00:00:00.000","Spartanburg","SC","Passenger","0","1","1","32","33","3.030303030303030303030303030"
"2021-09-30T00:00:00.000","Sumter","SC","Passenger","0","1","1","32","33","3.030303030303030303030303030"
"2021-09-30T00:00:00.000","Pennington","SD","Passenger","1","0","1","29","30","3.333333333333333333333333333"
"2021-09-30T00:00:00.000","Davidson","TN","Passenger","1","0","1","41","42","2.380952380952380952380952381"
"2021-09-30T00:00:00.000","Montgomery","TN","Passenger","1","0","1","199","200","0.500"
"2021-09-30T00:00:00.000","Tipton","TN","Passenger","1","0","1","13","14","7.142857142857142857142857143"
"2021-09-30T00:00:00.000","Bell","TX","Passenger","0","1","1","321","322","0.3105590062111801242236024845"
"2021-09-30T00:00:00.000","Bexar","TX","Passenger","4","4","8","456","464","1.724137931034482758620689655"
"2021-09-30T00:00:00.000","Dallas","TX","Passenger","1","0","1","128","129","0.7751937984496124031007751938"
"2021-09-30T00:00:00.000","Denton","TX","Passenger","1","0","1","56","57","1.754385964912280701754385965"
"2021-09-30T00:00:00.000","El Paso","TX","Passenger","2","0","2","338","340","0.5882352941176470588235294118"
"2021-09-30T00:00:00.000","Harris","TX","Passenger","1","0","1","165","166","0.6024096385542168674698795181"
"2021-09-30T00:00:00.000","Hidalgo","TX","Passenger","0","1","1","54","55","1.818181818181818181818181818"
"2021-09-30T00:00:00.000","Montgomery","TX","Passenger","1","1","2","27","29","6.896551724137931034482758621"
"2021-09-30T00:00:00.000","Nueces","TX","Passenger","1","0","1","60","61","1.639344262295081967213114754"
"2021-09-30T00:00:00.000","Travis","TX","Passenger","2","2","4","121","125","3.200"
"2021-09-30T00:00:00.000","Wichita","TX","Passenger","1","0","1","39","40","2.500"
"2021-09-30T00:00:00.000","Williamson","TX","Passenger","1","0","1","86","87","1.149425287356321839080459770"
"2021-09-30T00:00:00.000","Salt Lake","UT","Passenger","0","2","2","140","142","1.408450704225352112676056338"
"2021-09-30T00:00:00.000","Albemarle","VA","Passenger","1","0","1","19","20","5.00"
"2021-09-30T00:00:00.000","Alexandria","VA","Passenger","4","0","4","130","134","2.985074626865671641791044776"
"2021-09-30T00:00:00.000","Arlington","VA","Passenger","0","1","1","123","124","0.8064516129032258064516129032"
"2021-09-30T00:00:00.000","Chesapeake","VA","Passenger","1","3","4","376","380","1.052631578947368421052631579"
"2021-09-30T00:00:00.000","Danville","VA","Passenger","1","0","1","0","1","100"
"2021-09-30T00:00:00.000","Fairfax","VA","Passenger","5","5","10","654","664","1.506024096385542168674698795"
"2021-09-30T00:00:00.000","Goochland","VA","Passenger","3","0","3","161","164","1.829268292682926829268292683"
"2021-09-30T00:00:00.000","Loudoun","VA","Passenger","1","0","1","62","63","1.587301587301587301587301587"
"2021-09-30T00:00:00.000","Louisa","VA","Passenger","0","1","1","0","1","100"
"2021-09-30T00:00:00.000","Manassas","VA","Passenger","0","1","1","5","6","16.66666666666666666666666667"
"2021-09-30T00:00:00.000","Norfolk","VA","Passenger","1","1","2","305","307","0.6514657980456026058631921824"
"2021-09-30T00:00:00.000","Portsmouth","VA","Passenger","1","1","2","62","64","3.12500"
"2021-09-30T00:00:00.000","Powhatan","VA","Passenger","1","0","1","1","2","50.0"
"2021-09-30T00:00:00.000","Prince William","VA","Passenger","1","1","2","197","199","1.005025125628140703517587940"
"2021-09-30T00:00:00.000","Stafford","VA","Passenger","2","1","3","94","97","3.092783505154639175257731959"
"2021-09-30T00:00:00.000","Suffolk","VA","Passenger","1","0","1","108","109","0.9174311926605504587155963303"
"2021-09-30T00:00:00.000","Virginia Beach","VA","Passenger","2","0","2","544","546","0.3663003663003663003663003663"
"2021-09-30T00:00:00.000","Adams","WA","Passenger","16","16","32","13046","13078","0.2446857317632665545190396085"
"2021-09-30T00:00:00.000","Adams","WA","Truck","0","0","0","5406","5406","0"
"2021-09-30T00:00:00.000","Asotin","WA","Truck","2","0","2","6758","6760","0.02958579881656804733727810651"
"2021-09-30T00:00:00.000","Asotin","WA","Passenger","21","18","39","12757","12796","0.3047827446076899030947170991"
"2021-09-30T00:00:00.000","Benton","WA","Passenger","592","423","1015","136334","137349","0.7389933672615017218909493334"
"2021-09-30T00:00:00.000","Benton","WA","Truck","19","0","19","43685","43704","0.04347428153029470986637378730"
"2021-09-30T00:00:00.000","Chelan","WA","Passenger","382","103","485","54776","55261","0.8776533178914605236966395831"
"2021-09-30T00:00:00.000","Chelan","WA","Truck","8","0","8","23110","23118","0.03460506964270265593909507743"
"2021-09-30T00:00:00.000","Clallam","WA","Passenger","369","234","603","50571","51174","1.178332747098135772071755188"
"2021-09-30T00:00:00.000","Clallam","WA","Truck","3","0","3","22028","22031","0.01361717579773954881757523490"
"2021-09-30T00:00:00.000","Clark","WA","Passenger","3260","1530","4790","321902","326692","1.466212824311583999608193650"
"2021-09-30T00:00:00.000","Clark","WA","Truck","38","0","38","84159","84197","0.04513224936755466346781951851"
"2021-09-30T00:00:00.000","Columbia","WA","Passenger","7","2","9","2451","2460","0.3658536585365853658536585366"
"2021-09-30T00:00:00.000","Columbia","WA","Truck","1","0","1","1538","1539","0.06497725795971410006497725796"
"2021-09-30T00:00:00.000","Cowlitz","WA","Truck","8","1","9","29053","29062","0.03096827472300598719977978116"
"2021-09-30T00:00:00.000","Cowlitz","WA","Passenger","259","164","423","72044","72467","0.5837139663571004733188899775"
"2021-09-30T00:00:00.000","Douglas","WA","Truck","2","0","2","12722","12724","0.01571832756994655768626218170"
"2021-09-30T00:00:00.000","Douglas","WA","Passenger","104","52","156","28585","28741","0.5427786089558470477714762882"
"2021-09-30T00:00:00.000","Ferry","WA","Passenger","10","3","13","4409","4422","0.2939846223428312980551786522"
"2021-09-30T00:00:00.000","Ferry","WA","Truck","0","0","0","3596","3596","0"
"2021-09-30T00:00:00.000","Franklin","WA","Passenger","145","105","250","62153","62403","0.4006217649792477925740749643"
"2021-09-30T00:00:00.000","Franklin","WA","Truck","7","0","7","20718","20725","0.03377563329312424607961399276"
"2021-09-30T00:00:00.000","Garfield","WA","Passenger","0","3","3","1370","1373","0.2184996358339402767662053897"
"2021-09-30T00:00:00.000","Garfield","WA","Truck","0","0","0","996","996","0"
"2021-09-30T00:00:00.000","Grant","WA","Truck","2","0","2","28024","28026","0.007136230642974380931991721972"
"2021-09-30T00:00:00.000","Grant","WA","Passenger","130","103","233","66896","67129","0.3470929106645414053538709053"
"2021-09-30T00:00:00.000","Grays Harbor","WA","Passenger","198","158","356","49507","49863","0.7139562400978681587549886690"
"2021-09-30T00:00:00.000","Grays Harbor","WA","Truck","9","0","9","21393","21402","0.04205214465937762825904121110"
"2021-09-30T00:00:00.000","Island","WA","Truck","9","0","9","21611","21620","0.04162812210915818686401480111"
"2021-09-30T00:00:00.000","Island","WA","Passenger","675","347","1022","63425","64447","1.585799183825468990022809440"
"2021-09-30T00:00:00.000","Jefferson","WA","Passenger","366","197","563","24815","25378","2.218456931200252186933564505"
"2021-09-30T00:00:00.000","Jefferson","WA","Truck","1","0","1","9626","9627","0.01038745195803469408953983588"
"2021-09-30T00:00:00.000","King","WA","Truck","149","1","150","183884","184034","0.08150667811382679287522957714"
"2021-09-30T00:00:00.000","King","WA","Passenger","33306","9973","43279","1366319","1409598","3.070307988518712427231026151"
"2021-09-30T00:00:00.000","Kitsap","WA","Passenger","2070","943","3013","181137","184150","1.636166168884061906054846592"
"2021-09-30T00:00:00.000","Kitsap","WA","Truck","24","0","24","54428","54452","0.04407551605083376184529493866"
"2021-09-30T00:00:00.000","Kittitas","WA","Passenger","187","74","261","29870","30131","0.8662175168431183830606352262"
"2021-09-30T00:00:00.000","Kittitas","WA","Truck","4","0","4","14780","14784","0.02705627705627705627705627706"
"2021-09-30T00:00:00.000","Klickitat","WA","Truck","1","0","1","8345","8346","0.01198178768272226216151449796"
"2021-09-30T00:00:00.000","Klickitat","WA","Passenger","84","51","135","15405","15540","0.8687258687258687258687258687"
"2021-09-30T00:00:00.000","Lewis","WA","Truck","4","0","4","26716","26720","0.01497005988023952095808383234"
"2021-09-30T00:00:00.000","Lewis","WA","Passenger","196","157","353","59590","59943","0.5888927814757352818510918706"
"2021-09-30T00:00:00.000","Lincoln","WA","Truck","0","0","0","4786","4786","0"
"2021-09-30T00:00:00.000","Lincoln","WA","Passenger","9","16","25","7688","7713","0.3241280954233112926228445482"
"2021-09-30T00:00:00.000","Mason","WA","Truck","6","0","6","21292","21298","0.02817165931073340219738942624"
"2021-09-30T00:00:00.000","Mason","WA","Passenger","261","157","418","47987","48405","0.8635471542196054126639809937"
"2021-09-30T00:00:00.000","Okanogan","WA","Passenger","68","45","113","26560","26673","0.4236493832714730251565253252"
"2021-09-30T00:00:00.000","Okanogan","WA","Truck","2","0","2","16713","16715","0.01196530062817828297935985642"
"2021-09-30T00:00:00.000","Pacific","WA","Passenger","58","60","118","16068","16186","0.7290250834054120845174842456"
"2021-09-30T00:00:00.000","Pacific","WA","Truck","0","0","0","7998","7998","0"
"2021-09-30T00:00:00.000","Pend Oreille","WA","Passenger","17","7","24","9251","9275","0.2587601078167115902964959569"
"2021-09-30T00:00:00.000","Pend Oreille","WA","Truck","1","0","1","5691","5692","0.01756851721714687280393534786"
"2021-09-30T00:00:00.000","Pierce","WA","Truck","49","0","49","145607","145656","0.03364090734332948865820838139"
"2021-09-30T00:00:00.000","Pierce","WA","Passenger","4097","2166","6263","559703","565966","1.106603576893311612358339547"
"2021-09-30T00:00:00.000","San Juan","WA","Passenger","463","144","607","14195","14802","4.100797189568977165247939468"
"2021-09-30T00:00:00.000","San Juan","WA","Truck","0","0","0","5986","5986","0"
"2021-09-30T00:00:00.000","Skagit","WA","Truck","10","0","10","32959","32969","0.03033152355242803846037186448"
"2021-09-30T00:00:00.000","Skagit","WA","Passenger","668","312","980","91702","92682","1.057378994842580004747415895"
"2021-09-30T00:00:00.000","Skamania","WA","Passenger","57","40","97","8385","8482","1.143598207969818439047394482"
"2021-09-30T00:00:00.000","Skamania","WA","Truck","0","0","0","4043","4043","0"
"2021-09-30T00:00:00.000","Snohomish","WA","Truck","68","0","68","125975","126043","0.05394984251406266115532000984"
"2021-09-30T00:00:00.000","Snohomish","WA","Passenger","6602","2263","8865","539722","548587","1.615969755025182878923488891"
"2021-09-30T00:00:00.000","Spokane","WA","Truck","36","0","36","102643","102679","0.03506072322480740949950817597"
"2021-09-30T00:00:00.000","Spokane","WA","Passenger","1230","742","1972","326487","328459","0.6003793471940181270721764360"
"2021-09-30T00:00:00.000","Stevens","WA","Passenger","54","42","96","30343","30439","0.3153848680968494365780741811"
"2021-09-30T00:00:00.000","Stevens","WA","Truck","2","0","2","18899","18901","0.01058145071689328606952013121"
"2021-09-30T00:00:00.000","Thurston","WA","Truck","31","0","31","56407","56438","0.05492753109607002374286828024"
"2021-09-30T00:00:00.000","Thurston","WA","Passenger","1836","959","2795","197866","200661","1.392896477143042245379022331"
"2021-09-30T00:00:00.000","Wahkiakum","WA","Passenger","16","9","25","3072","3097","0.8072328059412334517274782047"
"2021-09-30T00:00:00.000","Wahkiakum","WA","Truck","0","0","0","1818","1818","0"
"2021-09-30T00:00:00.000","Walla Walla","WA","Passenger","128","86","214","36470","36684","0.5833605931741358630465598081"
"2021-09-30T00:00:00.000","Walla Walla","WA","Truck","3","0","3","14086","14089","0.02129320746681808503087515083"
"2021-09-30T00:00:00.000","Whatcom","WA","Truck","19","0","19","43833","43852","0.04332755632582322357019064125"
"2021-09-30T00:00:00.000","Whatcom","WA","Passenger","1593","665","2258","150616","152874","1.477033373889608435705221293"
"2021-09-30T00:00:00.000","Whitman","WA","Truck","2","0","2","8567","8569","0.02333994631812346831602287315"
"2021-09-30T00:00:00.000","Whitman","WA","Passenger","67","60","127","21970","22097","0.5747386523057428610218581708"
"2021-09-30T00:00:00.000","Yakima","WA","Truck","5","0","5","61756","61761","0.008095723838668415343015819044"
"2021-09-30T00:00:00.000","Yakima","WA","Passenger","272","175","447","169046","169493","0.2637277055689615500345146997"
"2021-09-30T00:00:00.000","Douglas","WI","Passenger","1","0","1","2","3","33.33333333333333333333333333"
"2021-09-30T00:00:00.000","Milwaukee","WI","Passenger","1","0","1","36","37","2.702702702702702702702702703"
"2021-09-30T00:00:00.000","Ozaukee","WI","Passenger","0","1","1","3","4","25.00"
"2021-10-31T00:00:00.000","Anchorage","AK","Passenger","1","0","1","124","125","0.800"
"2021-10-31T00:00:00.000","Fairbanks North Star","AK","Passenger","0","1","1","75","76","1.315789473684210526315789474"
"2021-10-31T00:00:00.000","Juneau","AK","Passenger","0","1","1","25","26","3.846153846153846153846153846"
"2021-10-31T00:00:00.000","Sevier","AR","Passenger","0","1","1","0","1","100"
"2021-10-31T00:00:00.000","Maricopa","AZ","Passenger","5","3","8","875","883","0.9060022650056625141562853907"
"2021-10-31T00:00:00.000","Pima","AZ","Passenger","1","1","2","223","225","0.8888888888888888888888888889"
"2021-10-31T00:00:00.000","Pinal","AZ","Passenger","1","0","1","105","106","0.9433962264150943396226415094"
"2021-10-31T00:00:00.000","Alameda","CA","Passenger","4","0","4","193","197","2.030456852791878172588832487"
"2021-10-31T00:00:00.000","Contra Costa","CA","Passenger","1","5","6","304","310","1.935483870967741935483870968"
"2021-10-31T00:00:00.000","Fresno","CA","Passenger","1","0","1","149","150","0.6666666666666666666666666667"
"2021-10-31T00:00:00.000","Kern","CA","Passenger","1","1","2","183","185","1.081081081081081081081081081"
"2021-10-31T00:00:00.000","Kings","CA","Passenger","1","0","1","316","317","0.3154574132492113564668769716"
"2021-10-31T00:00:00.000","Los Angeles","CA","Passenger","6","7","13","747","760","1.710526315789473684210526316"
"2021-10-31T00:00:00.000","Monterey","CA","Passenger","1","1","2","137","139","1.438848920863309352517985612"
"2021-10-31T00:00:00.000","Orange","CA","Passenger","5","2","7","378","385","1.818181818181818181818181818"
"2021-10-31T00:00:00.000","Placer","CA","Passenger","1","0","1","62","63","1.587301587301587301587301587"
"2021-10-31T00:00:00.000","Riverside","CA","Passenger","6","1","7","458","465","1.505376344086021505376344086"
"2021-10-31T00:00:00.000","Sacramento","CA","Passenger","2","0","2","204","206","0.9708737864077669902912621359"
"2021-10-31T00:00:00.000","San Bernardino","CA","Passenger","0","1","1","349","350","0.2857142857142857142857142857"
"2021-10-31T00:00:00.000","San Diego","CA","Passenger","16","9","25","2420","2445","1.022494887525562372188139059"
"2021-10-31T00:00:00.000","San Francisco","CA","Passenger","0","1","1","66","67","1.492537313432835820895522388"
"2021-10-31T00:00:00.000","San Joaquin","CA","Passenger","0","1","1","91","92","1.086956521739130434782608696"
"2021-10-31T00:00:00.000","San Luis Obispo","CA","Passenger","1","0","1","50","51","1.960784313725490196078431373"
"2021-10-31T00:00:00.000","Santa Barbara","CA","Passenger","1","0","1","68","69","1.449275362318840579710144928"
"2021-10-31T00:00:00.000","Santa Clara","CA","Passenger","5","2","7","208","215","3.255813953488372093023255814"
"2021-10-31T00:00:00.000","Santa Cruz","CA","Passenger","1","0","1","22","23","4.347826086956521739130434783"
"2021-10-31T00:00:00.000","Solano","CA","Passenger","1","0","1","176","177","0.5649717514124293785310734463"
"2021-10-31T00:00:00.000","Sonoma","CA","Passenger","0","1","1","78","79","1.265822784810126582278481013"
"2021-10-31T00:00:00.000","Ventura","CA","Passenger","2","1","3","242","245","1.224489795918367346938775510"
"2021-10-31T00:00:00.000","Boulder","CO","Passenger","1","1","2","25","27","7.407407407407407407407407407"
"2021-10-31T00:00:00.000","El Paso","CO","Passenger","2","0","2","605","607","0.3294892915980230642504118616"
"2021-10-31T00:00:00.000","Larimer","CO","Passenger","1","0","1","40","41","2.439024390243902439024390244"
"2021-10-31T00:00:00.000","Las Animas","CO","Passenger","1","0","1","0","1","100"
"2021-10-31T00:00:00.000","New London","CT","Passenger","0","4","4","218","222","1.801801801801801801801801802"
"2021-10-31T00:00:00.000","District of Columbia","DC","Passenger","4","2","6","192","198","3.030303030303030303030303030"
"2021-10-31T00:00:00.000","Kent","DE","Passenger","0","1","1","58","59","1.694915254237288135593220339"
"2021-10-31T00:00:00.000","New Castle","DE","Passenger","1","0","1","19","20","5.00"
"2021-10-31T00:00:00.000","Broward","FL","Passenger","1","0","1","87","88","1.136363636363636363636363636"
"2021-10-31T00:00:00.000","Duval","FL","Passenger","0","1","1","285","286","0.3496503496503496503496503497"
"2021-10-31T00:00:00.000","Hillsborough","FL","Passenger","0","1","1","130","131","0.7633587786259541984732824427"
"2021-10-31T00:00:00.000","Lake","FL","Passenger","1","0","1","18","19","5.263157894736842105263157895"
"2021-10-31T00:00:00.000","Okaloosa","FL","Passenger","0","1","1","100","101","0.9900990099009900990099009901"
"2021-10-31T00:00:00.000","Orange","FL","Passenger","1","0","1","94","95","1.052631578947368421052631579"
"2021-10-31T00:00:00.000","Palm Beach","FL","Passenger","1","0","1","47","48","2.083333333333333333333333333"
"2021-10-31T00:00:00.000","Pinellas","FL","Passenger","0","1","1","74","75","1.333333333333333333333333333"
"2021-10-31T00:00:00.000","Polk","FL","Passenger","1","0","1","50","51","1.960784313725490196078431373"
"2021-10-31T00:00:00.000","Sarasota","FL","Passenger","2","0","2","27","29","6.896551724137931034482758621"
"2021-10-31T00:00:00.000","St. Johns","FL","Passenger","0","1","1","33","34","2.941176470588235294117647059"
"2021-10-31T00:00:00.000","Bartow","GA","Passenger","0","1","1","2","3","33.33333333333333333333333333"
"2021-10-31T00:00:00.000","Bryan","GA","Passenger","1","0","1","46","47","2.127659574468085106382978723"
"2021-10-31T00:00:00.000","Columbia","GA","Passenger","1","0","1","103","104","0.9615384615384615384615384615"
"2021-10-31T00:00:00.000","DeKalb","GA","Passenger","1","0","1","46","47","2.127659574468085106382978723"
"2021-10-31T00:00:00.000","Houston","GA","Passenger","1","0","1","42","43","2.325581395348837209302325581"
"2021-10-31T00:00:00.000","Liberty","GA","Passenger","1","0","1","102","103","0.9708737864077669902912621359"
"2021-10-31T00:00:00.000","Rockdale","GA","Passenger","1","0","1","6","7","14.28571428571428571428571429"
"2021-10-31T00:00:00.000","Honolulu","HI","Passenger","5","2","7","334","341","2.052785923753665689149560117"
"2021-10-31T00:00:00.000","Champaign","IL","Passenger","1","0","1","10","11","9.090909090909090909090909091"
"2021-10-31T00:00:00.000","Cook","IL","Passenger","2","0","2","160","162","1.234567901234567901234567901"
"2021-10-31T00:00:00.000","DuPage","IL","Passenger","1","0","1","43","44","2.272727272727272727272727273"
"2021-10-31T00:00:00.000","Lake","IL","Passenger","4","0","4","156","160","2.500"
"2021-10-31T00:00:00.000","St. Clair","IL","Passenger","2","0","2","118","120","1.666666666666666666666666667"
"2021-10-31T00:00:00.000","Hamilton","IN","Passenger","2","0","2","27","29","6.896551724137931034482758621"
"2021-10-31T00:00:00.000","Howard","IN","Passenger","0","1","1","6","7","14.28571428571428571428571429"
"2021-10-31T00:00:00.000","Vigo","IN","Passenger","1","0","1","4","5","20.0"
"2021-10-31T00:00:00.000","Geary","KS","Passenger","1","0","1","88","89","1.123595505617977528089887640"
"2021-10-31T00:00:00.000","Leavenworth","KS","Passenger","0","1","1","105","106","0.9433962264150943396226415094"
"2021-10-31T00:00:00.000","Oldham","KY","Passenger","0","1","1","4","5","20.0"
"2021-10-31T00:00:00.000","Plaquemines","LA","Passenger","0","1","1","15","16","6.2500"
"2021-10-31T00:00:00.000","Middlesex","MA","Passenger","1","1","2","83","85","2.352941176470588235294117647"
"2021-10-31T00:00:00.000","Suffolk","MA","Passenger","0","2","2","30","32","6.2500"
"2021-10-31T00:00:00.000","Anne Arundel","MD","Passenger","4","3","7","349","356","1.966292134831460674157303371"
"2021-10-31T00:00:00.000","Baltimore","MD","Passenger","1","0","1","75","76","1.315789473684210526315789474"
"2021-10-31T00:00:00.000","Calvert","MD","Passenger","0","2","2","82","84","2.380952380952380952380952381"
"2021-10-31T00:00:00.000","Carroll","MD","Passenger","0","1","1","12","13","7.692307692307692307692307692"
"2021-10-31T00:00:00.000","Charles","MD","Passenger","1","1","2","62","64","3.12500"
"2021-10-31T00:00:00.000","Charles","MD","Truck","1","0","1","9","10","10.0"
"2021-10-31T00:00:00.000","Frederick","MD","Passenger","2","1","3","70","73","4.109589041095890410958904110"
"2021-10-31T00:00:00.000","Howard","MD","Passenger","0","1","1","54","55","1.818181818181818181818181818"
"2021-10-31T00:00:00.000","Montgomery","MD","Passenger","2","4","6","203","209","2.870813397129186602870813397"
"2021-10-31T00:00:00.000","Prince George's","MD","Passenger","1","0","1","127","128","0.7812500"
"2021-10-31T00:00:00.000","St. Mary's","MD","Passenger","1","0","1","178","179","0.5586592178770949720670391061"
"2021-10-31T00:00:00.000","St. Mary's","MD","Truck","1","0","1","41","42","2.380952380952380952380952381"
"2021-10-31T00:00:00.000","Washington","MD","Passenger","2","0","2","11","13","15.38461538461538461538461538"
"2021-10-31T00:00:00.000","Penobscot","ME","Passenger","0","1","1","9","10","10.0"
"2021-10-31T00:00:00.000","Saginaw","MI","Passenger","1","0","1","6","7","14.28571428571428571428571429"
"2021-10-31T00:00:00.000","Hennepin","MN","Passenger","1","0","1","58","59","1.694915254237288135593220339"
"2021-10-31T00:00:00.000","Kanabec","MN","Passenger","1","0","1","0","1","100"
"2021-10-31T00:00:00.000","Boone","MO","Passenger","0","1","1","9","10","10.0"
"2021-10-31T00:00:00.000","Greene","MO","Passenger","0","1","1","19","20","5.00"
"2021-10-31T00:00:00.000","Platte","MO","Passenger","1","0","1","15","16","6.2500"
"2021-10-31T00:00:00.000","Ray","MO","Passenger","0","1","1","0","1","100"
"2021-10-31T00:00:00.000","St. Louis","MO","Passenger","1","0","1","72","73","1.369863013698630136986301370"
"2021-10-31T00:00:00.000","Harrison","MS","Passenger","2","0","2","48","50","4.00"
"2021-10-31T00:00:00.000","Flathead","MT","Passenger","1","0","1","37","38","2.631578947368421052631578947"
"2021-10-31T00:00:00.000","Glacier","MT","Passenger","0","1","1","5","6","16.66666666666666666666666667"
"2021-10-31T00:00:00.000","Missoula","MT","Passenger","1","0","1","42","43","2.325581395348837209302325581"
"2021-10-31T00:00:00.000","Cumberland","NC","Passenger","0","2","2","395","397","0.5037783375314861460957178841"
"2021-10-31T00:00:00.000","Cumberland","NC","Truck","1","0","1","92","93","1.075268817204301075268817204"
"2021-10-31T00:00:00.000","Harnett","NC","Passenger","0","1","1","151","152","0.6578947368421052631578947368"
"2021-10-31T00:00:00.000","Mecklenburg","NC","Passenger","1","0","1","70","71","1.408450704225352112676056338"
"2021-10-31T00:00:00.000","Moore","NC","Passenger","0","1","1","124","125","0.800"
"2021-10-31T00:00:00.000","Onslow","NC","Passenger","0","1","1","154","155","0.6451612903225806451612903226"
"2021-10-31T00:00:00.000","Wake","NC","Passenger","1","0","1","95","96","1.041666666666666666666666667"
"2021-10-31T00:00:00.000","Wayne","NC","Passenger","1","0","1","27","28","3.571428571428571428571428571"
"2021-10-31T00:00:00.000","Wilson","NC","Passenger","1","0","1","1","2","50.0"
"2021-10-31T00:00:00.000","Williams","ND","Passenger","0","1","1","8","9","11.11111111111111111111111111"
"2021-10-31T00:00:00.000","Douglas","NE","Passenger","1","1","2","49","51","3.921568627450980392156862745"
"2021-10-31T00:00:00.000","Sarpy","NE","Passenger","1","0","1","52","53","1.886792452830188679245283019"
"2021-10-31T00:00:00.000","Carroll","NH","Passenger","0","1","1","3","4","25.00"
"2021-10-31T00:00:00.000","Burlington","NJ","Passenger","0","1","1","122","123","0.8130081300813008130081300813"
"2021-10-31T00:00:00.000","Camden","NJ","Passenger","0","1","1","11","12","8.333333333333333333333333333"
"2021-10-31T00:00:00.000","Hudson","NJ","Truck","1","0","1","10","11","9.090909090909090909090909091"
"2021-10-31T00:00:00.000","Hudson","NJ","Passenger","1","0","1","100","101","0.9900990099009900990099009901"
"2021-10-31T00:00:00.000","Bernalillo","NM","Passenger","1","0","1","105","106","0.9433962264150943396226415094"
"2021-10-31T00:00:00.000","Chaves","NM","Passenger","1","0","1","5","6","16.66666666666666666666666667"
"2021-10-31T00:00:00.000","Carson City","NV","Passenger","1","0","1","11","12","8.333333333333333333333333333"
"2021-10-31T00:00:00.000","Clark","NV","Passenger","5","4","9","532","541","1.663585951940850277264325323"
"2021-10-31T00:00:00.000","Washoe","NV","Passenger","1","0","1","61","62","1.612903225806451612903225806"
"2021-10-31T00:00:00.000","Erie","NY","Passenger","1","0","1","25","26","3.846153846153846153846153846"
"2021-10-31T00:00:00.000","Jefferson","NY","Passenger","0","1","1","198","199","0.5025125628140703517587939698"
"2021-10-31T00:00:00.000","Kings","NY","Passenger","1","0","1","58","59","1.694915254237288135593220339"
"2021-10-31T00:00:00.000","New York","NY","Passenger","1","0","1","41","42","2.380952380952380952380952381"
"2021-10-31T00:00:00.000","Queens","NY","Passenger","1","0","1","40","41","2.439024390243902439024390244"
"2021-10-31T00:00:00.000","Saratoga","NY","Passenger","1","0","1","39","40","2.500"
"2021-10-31T00:00:00.000","Hamilton","OH","Passenger","1","0","1","29","30","3.333333333333333333333333333"
"2021-10-31T00:00:00.000","Montgomery","OH","Passenger","0","1","1","46","47","2.127659574468085106382978723"
"2021-10-31T00:00:00.000","Shelby","OH","Passenger","0","1","1","2","3","33.33333333333333333333333333"
"2021-10-31T00:00:00.000","Rogers","OK","Passenger","1","0","1","3","4","25.00"
"2021-10-31T00:00:00.000","Clackamas","OR","Passenger","2","0","2","143","145","1.379310344827586206896551724"
"2021-10-31T00:00:00.000","Klamath","OR","Passenger","1","0","1","20","21","4.761904761904761904761904762"
"2021-10-31T00:00:00.000","Multnomah","OR","Passenger","2","5","7","547","554","1.263537906137184115523465704"
"2021-10-31T00:00:00.000","Washington","OR","Passenger","1","0","1","301","302","0.3311258278145695364238410596"
"2021-10-31T00:00:00.000","Yamhill","OR","Passenger","1","0","1","25","26","3.846153846153846153846153846"
"2021-10-31T00:00:00.000","Allegheny","PA","Passenger","1","1","2","51","53","3.773584905660377358490566038"
"2021-10-31T00:00:00.000","Montgomery","PA","Passenger","2","0","2","16","18","11.11111111111111111111111111"
"2021-10-31T00:00:00.000","Philadelphia","PA","Passenger","1","0","1","39","40","2.500"
"2021-10-31T00:00:00.000","RÃ­o Grande","PR","Passenger","1","0","1","0","1","100"
"2021-10-31T00:00:00.000","Newport","RI","Passenger","1","0","1","75","76","1.315789473684210526315789474"
"2021-10-31T00:00:00.000","Newport","RI","Truck","1","0","1","10","11","9.090909090909090909090909091"
"2021-10-31T00:00:00.000","Charleston","SC","Passenger","1","0","1","75","76","1.315789473684210526315789474"
"2021-10-31T00:00:00.000","Richland","SC","Passenger","0","1","1","122","123","0.8130081300813008130081300813"
"2021-10-31T00:00:00.000","Spartanburg","SC","Passenger","0","1","1","31","32","3.12500"
"2021-10-31T00:00:00.000","Sumter","SC","Passenger","0","1","1","32","33","3.030303030303030303030303030"
"2021-10-31T00:00:00.000","Pennington","SD","Passenger","1","0","1","28","29","3.448275862068965517241379310"
"2021-10-31T00:00:00.000","Davidson","TN","Passenger","1","0","1","39","40","2.500"
"2021-10-31T00:00:00.000","Montgomery","TN","Passenger","1","0","1","189","190","0.5263157894736842105263157895"
"2021-10-31T00:00:00.000","Tipton","TN","Passenger","1","0","1","13","14","7.142857142857142857142857143"
"2021-10-31T00:00:00.000","Bell","TX","Passenger","0","1","1","315","316","0.3164556962025316455696202532"
"2021-10-31T00:00:00.000","Bexar","TX","Passenger","4","4","8","447","455","1.758241758241758241758241758"
"2021-10-31T00:00:00.000","Coryell","TX","Passenger","1","0","1","105","106","0.9433962264150943396226415094"
"2021-10-31T00:00:00.000","Dallas","TX","Passenger","1","0","1","126","127","0.7874015748031496062992125984"
"2021-10-31T00:00:00.000","Denton","TX","Passenger","1","0","1","57","58","1.724137931034482758620689655"
"2021-10-31T00:00:00.000","El Paso","TX","Passenger","2","0","2","331","333","0.6006006006006006006006006006"
"2021-10-31T00:00:00.000","Harris","TX","Passenger","1","0","1","161","162","0.6172839506172839506172839506"
"2021-10-31T00:00:00.000","Hidalgo","TX","Passenger","0","1","1","55","56","1.785714285714285714285714286"
"2021-10-31T00:00:00.000","Montgomery","TX","Passenger","1","1","2","27","29","6.896551724137931034482758621"
"2021-10-31T00:00:00.000","Nueces","TX","Passenger","1","0","1","59","60","1.666666666666666666666666667"
"2021-10-31T00:00:00.000","Tarrant","TX","Passenger","1","0","1","114","115","0.8695652173913043478260869565"
"2021-10-31T00:00:00.000","Travis","TX","Passenger","2","2","4","119","123","3.252032520325203252032520325"
"2021-10-31T00:00:00.000","Wichita","TX","Passenger","1","0","1","40","41","2.439024390243902439024390244"
"2021-10-31T00:00:00.000","Williamson","TX","Passenger","1","0","1","85","86","1.162790697674418604651162791"
"2021-10-31T00:00:00.000","Salt Lake","UT","Passenger","0","2","2","140","142","1.408450704225352112676056338"
"2021-10-31T00:00:00.000","Albemarle","VA","Passenger","1","0","1","19","20","5.00"
"2021-10-31T00:00:00.000","Alexandria","VA","Passenger","4","0","4","130","134","2.985074626865671641791044776"
"2021-10-31T00:00:00.000","Arlington","VA","Passenger","0","1","1","120","121","0.8264462809917355371900826446"
"2021-10-31T00:00:00.000","Chesapeake","VA","Passenger","1","3","4","370","374","1.069518716577540106951871658"
"2021-10-31T00:00:00.000","Danville","VA","Passenger","1","0","1","0","1","100"
"2021-10-31T00:00:00.000","Fairfax","VA","Passenger","4","4","8","646","654","1.223241590214067278287461774"
"2021-10-31T00:00:00.000","Goochland","VA","Passenger","3","0","3","155","158","1.898734177215189873417721519"
"2021-10-31T00:00:00.000","Loudoun","VA","Passenger","1","0","1","58","59","1.694915254237288135593220339"
"2021-10-31T00:00:00.000","Louisa","VA","Passenger","0","1","1","0","1","100"
"2021-10-31T00:00:00.000","Manassas","VA","Passenger","0","1","1","5","6","16.66666666666666666666666667"
"2021-10-31T00:00:00.000","Norfolk","VA","Passenger","1","1","2","305","307","0.6514657980456026058631921824"
"2021-10-31T00:00:00.000","Portsmouth","VA","Passenger","1","1","2","63","65","3.076923076923076923076923077"
"2021-10-31T00:00:00.000","Powhatan","VA","Passenger","1","0","1","1","2","50.0"
"2021-10-31T00:00:00.000","Prince William","VA","Passenger","1","1","2","193","195","1.025641025641025641025641026"
"2021-10-31T00:00:00.000","Stafford","VA","Passenger","2","1","3","93","96","3.12500"
"2021-10-31T00:00:00.000","Suffolk","VA","Passenger","1","0","1","104","105","0.9523809523809523809523809524"
"2021-10-31T00:00:00.000","Virginia Beach","VA","Passenger","2","0","2","530","532","0.3759398496240601503759398496"
"2021-10-31T00:00:00.000","Adams","WA","Truck","0","0","0","5414","5414","0"
"2021-10-31T00:00:00.000","Adams","WA","Passenger","16","16","32","13035","13067","0.2448917119461238233718527589"
"2021-10-31T00:00:00.000","Asotin","WA","Passenger","22","18","40","12791","12831","0.3117449925960564258436598862"
"2021-10-31T00:00:00.000","Asotin","WA","Truck","2","0","2","6751","6753","0.02961646675551606693321486747"
"2021-10-31T00:00:00.000","Benton","WA","Truck","20","0","20","43715","43735","0.04572996455927746655996341603"
"2021-10-31T00:00:00.000","Benton","WA","Passenger","605","434","1039","136080","137119","0.7577359811550550981264449128"
"2021-10-31T00:00:00.000","Chelan","WA","Passenger","392","110","502","54689","55191","0.9095685890815531517819934410"
"2021-10-31T00:00:00.000","Chelan","WA","Truck","7","0","7","23084","23091","0.03031484128015244034472305227"
"2021-10-31T00:00:00.000","Clallam","WA","Passenger","375","241","616","50545","51161","1.204042141474951623306815739"
"2021-10-31T00:00:00.000","Clallam","WA","Truck","3","0","3","22074","22077","0.01358880282647098790596548444"
"2021-10-31T00:00:00.000","Clark","WA","Truck","41","0","41","84039","84080","0.04876308277830637488106565176"
"2021-10-31T00:00:00.000","Clark","WA","Passenger","3362","1559","4921","321193","326114","1.508981521799125459195250741"
"2021-10-31T00:00:00.000","Columbia","WA","Passenger","7","2","9","2441","2450","0.3673469387755102040816326531"
"2021-10-31T00:00:00.000","Columbia","WA","Truck","1","0","1","1538","1539","0.06497725795971410006497725796"
"2021-10-31T00:00:00.000","Cowlitz","WA","Passenger","271","164","435","71872","72307","0.6016015046952577205526435891"
"2021-10-31T00:00:00.000","Cowlitz","WA","Truck","8","1","9","29088","29097","0.03093102381688833900402103310"
"2021-10-31T00:00:00.000","Douglas","WA","Truck","3","0","3","12685","12688","0.02364438839848675914249684741"
"2021-10-31T00:00:00.000","Douglas","WA","Passenger","104","52","156","28592","28748","0.5426464449700848754695978851"
"2021-10-31T00:00:00.000","Ferry","WA","Passenger","11","3","14","4451","4465","0.3135498320268756998880179171"
"2021-10-31T00:00:00.000","Ferry","WA","Truck","0","0","0","3595","3595","0"
"2021-10-31T00:00:00.000","Franklin","WA","Passenger","150","107","257","62110","62367","0.4120768996424391104269886318"
"2021-10-31T00:00:00.000","Franklin","WA","Truck","8","0","8","20776","20784","0.03849114703618167821401077752"
"2021-10-31T00:00:00.000","Garfield","WA","Truck","0","0","0","997","997","0"
"2021-10-31T00:00:00.000","Garfield","WA","Passenger","0","3","3","1359","1362","0.2202643171806167400881057269"
"2021-10-31T00:00:00.000","Grant","WA","Truck","4","0","4","28030","28034","0.01426838838553185417707069986"
"2021-10-31T00:00:00.000","Grant","WA","Passenger","138","101","239","66852","67091","0.3562325796306509069770908170"
"2021-10-31T00:00:00.000","Grays Harbor","WA","Passenger","202","159","361","49506","49867","0.7239256422082740088635771151"
"2021-10-31T00:00:00.000","Grays Harbor","WA","Truck","9","0","9","21391","21400","0.04205607476635514018691588785"
"2021-10-31T00:00:00.000","Island","WA","Passenger","693","351","1044","63296","64340","1.622629779297482126204538390"
"2021-10-31T00:00:00.000","Island","WA","Truck","9","0","9","21605","21614","0.04163967798649023780882761173"
"2021-10-31T00:00:00.000","Jefferson","WA","Truck","1","0","1","9599","9600","0.01041666666666666666666666667"
"2021-10-31T00:00:00.000","Jefferson","WA","Passenger","370","202","572","24785","25357","2.255787356548487597113223173"
"2021-10-31T00:00:00.000","King","WA","Truck","157","1","158","183475","183633","0.08604117996220722854824568569"
"2021-10-31T00:00:00.000","King","WA","Passenger","34263","10193","44456","1364818","1409274","3.154532049835589104744712526"
"2021-10-31T00:00:00.000","Kitsap","WA","Truck","26","0","26","54353","54379","0.04781257470714797991871862300"
"2021-10-31T00:00:00.000","Kitsap","WA","Passenger","2120","951","3071","180999","184070","1.668387026674634649861465747"
"2021-10-31T00:00:00.000","Kittitas","WA","Passenger","200","74","274","29850","30124","0.9095737617846235559686628602"
"2021-10-31T00:00:00.000","Kittitas","WA","Truck","4","0","4","14775","14779","0.02706543067866567426754178226"
"2021-10-31T00:00:00.000","Klickitat","WA","Passenger","89","51","140","15372","15512","0.9025270758122743682310469314"
"2021-10-31T00:00:00.000","Klickitat","WA","Truck","1","0","1","8320","8321","0.01201778632375916356207186636"
"2021-10-31T00:00:00.000","Lewis","WA","Truck","5","0","5","26755","26760","0.01868460388639760837070254111"
"2021-10-31T00:00:00.000","Lewis","WA","Passenger","205","166","371","59638","60009","0.6182405972437467713176356880"
"2021-10-31T00:00:00.000","Lincoln","WA","Truck","0","0","0","4807","4807","0"
"2021-10-31T00:00:00.000","Lincoln","WA","Passenger","9","16","25","7711","7736","0.3231644260599793174767321613"
"2021-10-31T00:00:00.000","Mason","WA","Passenger","268","163","431","47904","48335","0.8916933898831074790524464674"
"2021-10-31T00:00:00.000","Mason","WA","Truck","7","0","7","21288","21295","0.03287156609532754167644987086"
"2021-10-31T00:00:00.000","Okanogan","WA","Passenger","67","45","112","26593","26705","0.4193971166448230668414154653"
"2021-10-31T00:00:00.000","Okanogan","WA","Truck","2","0","2","16690","16692","0.01198178768272226216151449796"
"2021-10-31T00:00:00.000","Pacific","WA","Passenger","58","62","120","16108","16228","0.7394626571358146413606112891"
"2021-10-31T00:00:00.000","Pacific","WA","Truck","0","0","0","7993","7993","0"
"2021-10-31T00:00:00.000","Pend Oreille","WA","Passenger","18","7","25","9217","9242","0.2705042198658299069465483662"
"2021-10-31T00:00:00.000","Pend Oreille","WA","Truck","1","0","1","5687","5688","0.01758087201125175808720112518"
"2021-10-31T00:00:00.000","Pierce","WA","Passenger","4221","2178","6399","558654","565053","1.132460140907136144751023355"
"2021-10-31T00:00:00.000","Pierce","WA","Truck","55","0","55","145407","145462","0.03781056220868680480125393574"
"2021-10-31T00:00:00.000","San Juan","WA","Passenger","470","147","617","14198","14815","4.164697941275734053324333446"
"2021-10-31T00:00:00.000","San Juan","WA","Truck","0","0","0","5980","5980","0"
"2021-10-31T00:00:00.000","Skagit","WA","Passenger","676","318","994","91509","92503","1.074559744008302433434591311"
"2021-10-31T00:00:00.000","Skagit","WA","Truck","11","0","11","32858","32869","0.03346618394231646840487997809"
"2021-10-31T00:00:00.000","Skamania","WA","Truck","0","0","0","4019","4019","0"
"2021-10-31T00:00:00.000","Skamania","WA","Passenger","61","40","101","8337","8438","1.196966105712254088646598720"
"2021-10-31T00:00:00.000","Snohomish","WA","Truck","74","0","74","125823","125897","0.05877820758238877812815237853"
"2021-10-31T00:00:00.000","Snohomish","WA","Passenger","6800","2296","9096","539040","548136","1.659442182232146766495906125"
"2021-10-31T00:00:00.000","Spokane","WA","Truck","37","0","37","102672","102709","0.03602410694291639486315707484"
"2021-10-31T00:00:00.000","Spokane","WA","Passenger","1261","765","2026","326840","328866","0.6160563877080634665790930044"
"2021-10-31T00:00:00.000","Stevens","WA","Truck","2","0","2","18900","18902","0.01058089091101470743836631044"
"2021-10-31T00:00:00.000","Stevens","WA","Passenger","55","43","98","30267","30365","0.3227399967067347274822986992"
"2021-10-31T00:00:00.000","Thurston","WA","Passenger","1889","971","2860","197597","200457","1.426739899330030879440478507"
"2021-10-31T00:00:00.000","Thurston","WA","Truck","36","0","36","56255","56291","0.06395338508820237693414577819"
"2021-10-31T00:00:00.000","Wahkiakum","WA","Passenger","17","9","26","3066","3092","0.8408796895213454075032341527"
"2021-10-31T00:00:00.000","Wahkiakum","WA","Truck","0","0","0","1829","1829","0"
"2021-10-31T00:00:00.000","Walla Walla","WA","Passenger","132","86","218","36397","36615","0.5953844052983749829304929674"
"2021-10-31T00:00:00.000","Walla Walla","WA","Truck","3","0","3","14065","14068","0.02132499289166903611032129656"
"2021-10-31T00:00:00.000","Whatcom","WA","Truck","24","0","24","43797","43821","0.05476826179229136715273499007"
"2021-10-31T00:00:00.000","Whatcom","WA","Passenger","1633","671","2304","150514","152818","1.507675797353714876519781701"
"2021-10-31T00:00:00.000","Whitman","WA","Truck","2","0","2","8566","8568","0.02334267040149393090569561158"
"2021-10-31T00:00:00.000","Whitman","WA","Passenger","65","62","127","21976","22103","0.5745826358412885128715558974"
"2021-10-31T00:00:00.000","Yakima","WA","Truck","5","0","5","61691","61696","0.008104253112033195020746887967"
"2021-10-31T00:00:00.000","Yakima","WA","Passenger","286","176","462","168930","169392","0.2727401530178520827429866818"
"2021-10-31T00:00:00.000","Douglas","WI","Passenger","1","0","1","1","2","50.0"
"2021-10-31T00:00:00.000","Milwaukee","WI","Passenger","1","0","1","35","36","2.777777777777777777777777778"
"2021-10-31T00:00:00.000","Ozaukee","WI","Passenger","0","1","1","3","4","25.00"
"2021-11-30T00:00:00.000","Anchorage","AK","Passenger","1","0","1","119","120","0.8333333333333333333333333333"
"2021-11-30T00:00:00.000","Fairbanks North Star","AK","Passenger","0","1","1","74","75","1.333333333333333333333333333"
"2021-11-30T00:00:00.000","Juneau","AK","Passenger","0","1","1","25","26","3.846153846153846153846153846"
"2021-11-30T00:00:00.000","Sevier","AR","Passenger","0","1","1","0","1","100"
"2021-11-30T00:00:00.000","Maricopa","AZ","Passenger","5","3","8","851","859","0.9313154831199068684516880093"
"2021-11-30T00:00:00.000","Pima","AZ","Passenger","1","1","2","220","222","0.9009009009009009009009009009"
"2021-11-30T00:00:00.000","Pinal","AZ","Passenger","1","0","1","102","103","0.9708737864077669902912621359"
"2021-11-30T00:00:00.000","Alameda","CA","Passenger","4","0","4","194","198","2.020202020202020202020202020"
"2021-11-30T00:00:00.000","Contra Costa","CA","Passenger","1","5","6","304","310","1.935483870967741935483870968"
"2021-11-30T00:00:00.000","Fresno","CA","Passenger","1","0","1","145","146","0.6849315068493150684931506849"
"2021-11-30T00:00:00.000","Kern","CA","Passenger","1","1","2","181","183","1.092896174863387978142076503"
"2021-11-30T00:00:00.000","Kings","CA","Passenger","1","0","1","316","317","0.3154574132492113564668769716"
"2021-11-30T00:00:00.000","Los Angeles","CA","Passenger","6","5","11","739","750","1.466666666666666666666666667"
"2021-11-30T00:00:00.000","Marin","CA","Passenger","0","1","1","32","33","3.030303030303030303030303030"
"2021-11-30T00:00:00.000","Monterey","CA","Passenger","1","1","2","132","134","1.492537313432835820895522388"
"2021-11-30T00:00:00.000","Orange","CA","Passenger","5","2","7","371","378","1.851851851851851851851851852"
"2021-11-30T00:00:00.000","Placer","CA","Passenger","1","0","1","61","62","1.612903225806451612903225806"
"2021-11-30T00:00:00.000","Riverside","CA","Passenger","6","1","7","447","454","1.541850220264317180616740088"
"2021-11-30T00:00:00.000","Sacramento","CA","Passenger","2","0","2","205","207","0.9661835748792270531400966184"
"2021-11-30T00:00:00.000","San Bernardino","CA","Passenger","0","2","2","343","345","0.5797101449275362318840579710"
"2021-11-30T00:00:00.000","San Diego","CA","Passenger","16","9","25","2382","2407","1.038637307852098047361861238"
"2021-11-30T00:00:00.000","San Francisco","CA","Passenger","0","1","1","64","65","1.538461538461538461538461538"
"2021-11-30T00:00:00.000","San Joaquin","CA","Passenger","0","1","1","90","91","1.098901098901098901098901099"
"2021-11-30T00:00:00.000","San Luis Obispo","CA","Passenger","1","0","1","49","50","2.00"
"2021-11-30T00:00:00.000","Santa Barbara","CA","Passenger","1","0","1","67","68","1.470588235294117647058823529"
"2021-11-30T00:00:00.000","Santa Clara","CA","Passenger","5","1","6","201","207","2.898550724637681159420289855"
"2021-11-30T00:00:00.000","Santa Cruz","CA","Passenger","1","0","1","19","20","5.00"
"2021-11-30T00:00:00.000","Solano","CA","Passenger","1","0","1","174","175","0.5714285714285714285714285714"
"2021-11-30T00:00:00.000","Sonoma","CA","Passenger","0","1","1","77","78","1.282051282051282051282051282"
"2021-11-30T00:00:00.000","Ventura","CA","Passenger","2","1","3","238","241","1.244813278008298755186721992"
"2021-11-30T00:00:00.000","Boulder","CO","Passenger","1","1","2","25","27","7.407407407407407407407407407"
"2021-11-30T00:00:00.000","El Paso","CO","Passenger","2","0","2","601","603","0.3316749585406301824212271973"
"2021-11-30T00:00:00.000","Larimer","CO","Passenger","1","0","1","40","41","2.439024390243902439024390244"
"2021-11-30T00:00:00.000","Las Animas","CO","Passenger","1","0","1","0","1","100"
"2021-11-30T00:00:00.000","New London","CT","Passenger","0","4","4","219","223","1.793721973094170403587443946"
"2021-11-30T00:00:00.000","District of Columbia","DC","Passenger","4","2","6","190","196","3.061224489795918367346938776"
"2021-11-30T00:00:00.000","Kent","DE","Passenger","0","1","1","56","57","1.754385964912280701754385965"
"2021-11-30T00:00:00.000","New Castle","DE","Passenger","1","0","1","19","20","5.00"
"2021-11-30T00:00:00.000","Broward","FL","Passenger","1","0","1","86","87","1.149425287356321839080459770"
"2021-11-30T00:00:00.000","Duval","FL","Passenger","0","1","1","283","284","0.3521126760563380281690140845"
"2021-11-30T00:00:00.000","Hillsborough","FL","Passenger","0","1","1","125","126","0.7936507936507936507936507937"
"2021-11-30T00:00:00.000","Lake","FL","Passenger","1","0","1","18","19","5.263157894736842105263157895"
"2021-11-30T00:00:00.000","Okaloosa","FL","Passenger","0","1","1","97","98","1.020408163265306122448979592"
"2021-11-30T00:00:00.000","Orange","FL","Passenger","1","0","1","91","92","1.086956521739130434782608696"
"2021-11-30T00:00:00.000","Palm Beach","FL","Passenger","1","0","1","45","46","2.173913043478260869565217391"
"2021-11-30T00:00:00.000","Pinellas","FL","Passenger","0","1","1","72","73","1.369863013698630136986301370"
"2021-11-30T00:00:00.000","Polk","FL","Passenger","1","0","1","51","52","1.923076923076923076923076923"
"2021-11-30T00:00:00.000","Sarasota","FL","Passenger","2","0","2","26","28","7.142857142857142857142857143"
"2021-11-30T00:00:00.000","St. Johns","FL","Passenger","0","1","1","31","32","3.12500"
"2021-11-30T00:00:00.000","Bartow","GA","Passenger","0","1","1","2","3","33.33333333333333333333333333"
"2021-11-30T00:00:00.000","Bryan","GA","Passenger","1","0","1","46","47","2.127659574468085106382978723"
"2021-11-30T00:00:00.000","Columbia","GA","Passenger","1","1","2","99","101","1.980198019801980198019801980"
"2021-11-30T00:00:00.000","DeKalb","GA","Passenger","1","0","1","45","46","2.173913043478260869565217391"
"2021-11-30T00:00:00.000","Houston","GA","Passenger","1","0","1","41","42","2.380952380952380952380952381"
"2021-11-30T00:00:00.000","Liberty","GA","Passenger","1","0","1","100","101","0.9900990099009900990099009901"
"2021-11-30T00:00:00.000","Rockdale","GA","Passenger","1","0","1","6","7","14.28571428571428571428571429"
"2021-11-30T00:00:00.000","Honolulu","HI","Passenger","4","2","6","325","331","1.812688821752265861027190332"
"2021-11-30T00:00:00.000","Champaign","IL","Passenger","1","0","1","9","10","10.0"
"2021-11-30T00:00:00.000","Cook","IL","Passenger","2","0","2","158","160","1.2500"
"2021-11-30T00:00:00.000","DuPage","IL","Passenger","1","0","1","42","43","2.325581395348837209302325581"
"2021-11-30T00:00:00.000","Lake","IL","Passenger","4","0","4","155","159","2.515723270440251572327044025"
"2021-11-30T00:00:00.000","St. Clair","IL","Passenger","2","0","2","115","117","1.709401709401709401709401709"
"2021-11-30T00:00:00.000","Hamilton","IN","Passenger","2","0","2","27","29","6.896551724137931034482758621"
"2021-11-30T00:00:00.000","Howard","IN","Passenger","0","1","1","6","7","14.28571428571428571428571429"
"2021-11-30T00:00:00.000","Vigo","IN","Passenger","1","0","1","4","5","20.0"
"2021-11-30T00:00:00.000","Geary","KS","Passenger","1","0","1","87","88","1.136363636363636363636363636"
"2021-11-30T00:00:00.000","Leavenworth","KS","Passenger","1","1","2","105","107","1.869158878504672897196261682"
"2021-11-30T00:00:00.000","Oldham","KY","Passenger","0","1","1","4","5","20.0"
"2021-11-30T00:00:00.000","Plaquemines","LA","Passenger","0","1","1","15","16","6.2500"
"2021-11-30T00:00:00.000","Middlesex","MA","Passenger","1","1","2","81","83","2.409638554216867469879518072"
"2021-11-30T00:00:00.000","Suffolk","MA","Passenger","0","2","2","30","32","6.2500"
"2021-11-30T00:00:00.000","Anne Arundel","MD","Passenger","4","3","7","343","350","2.00"
"2021-11-30T00:00:00.000","Baltimore","MD","Passenger","1","0","1","72","73","1.369863013698630136986301370"
"2021-11-30T00:00:00.000","Calvert","MD","Passenger","0","2","2","81","83","2.409638554216867469879518072"
"2021-11-30T00:00:00.000","Carroll","MD","Passenger","0","1","1","12","13","7.692307692307692307692307692"
"2021-11-30T00:00:00.000","Charles","MD","Passenger","1","1","2","61","63","3.174603174603174603174603175"
"2021-11-30T00:00:00.000","Charles","MD","Truck","1","0","1","9","10","10.0"
"2021-11-30T00:00:00.000","Frederick","MD","Passenger","2","1","3","70","73","4.109589041095890410958904110"
"2021-11-30T00:00:00.000","Howard","MD","Passenger","0","1","1","54","55","1.818181818181818181818181818"
"2021-11-30T00:00:00.000","Montgomery","MD","Passenger","2","4","6","199","205","2.926829268292682926829268293"
"2021-11-30T00:00:00.000","Prince George's","MD","Passenger","1","0","1","129","130","0.7692307692307692307692307692"
"2021-11-30T00:00:00.000","St. Mary's","MD","Passenger","1","0","1","177","178","0.5617977528089887640449438202"
"2021-11-30T00:00:00.000","St. Mary's","MD","Truck","1","0","1","41","42","2.380952380952380952380952381"
"2021-11-30T00:00:00.000","Washington","MD","Passenger","2","0","2","11","13","15.38461538461538461538461538"
"2021-11-30T00:00:00.000","Penobscot","ME","Passenger","0","1","1","9","10","10.0"
"2021-11-30T00:00:00.000","Saginaw","MI","Passenger","1","0","1","6","7","14.28571428571428571428571429"
"2021-11-30T00:00:00.000","Hennepin","MN","Passenger","1","0","1","54","55","1.818181818181818181818181818"
"2021-11-30T00:00:00.000","Kanabec","MN","Passenger","1","0","1","0","1","100"
"2021-11-30T00:00:00.000","Boone","MO","Passenger","0","1","1","9","10","10.0"
"2021-11-30T00:00:00.000","Greene","MO","Passenger","0","1","1","18","19","5.263157894736842105263157895"
"2021-11-30T00:00:00.000","Platte","MO","Passenger","1","0","1","15","16","6.2500"
"2021-11-30T00:00:00.000","Ray","MO","Passenger","0","1","1","0","1","100"
"2021-11-30T00:00:00.000","St. Louis","MO","Passenger","1","0","1","71","72","1.388888888888888888888888889"
"2021-11-30T00:00:00.000","Harrison","MS","Passenger","2","0","2","46","48","4.166666666666666666666666667"
"2021-11-30T00:00:00.000","Flathead","MT","Passenger","1","0","1","34","35","2.857142857142857142857142857"
"2021-11-30T00:00:00.000","Glacier","MT","Passenger","0","1","1","5","6","16.66666666666666666666666667"
"2021-11-30T00:00:00.000","Cumberland","NC","Truck","1","0","1","91","92","1.086956521739130434782608696"
"2021-11-30T00:00:00.000","Cumberland","NC","Passenger","0","2","2","391","393","0.5089058524173027989821882952"
"2021-11-30T00:00:00.000","Harnett","NC","Passenger","0","1","1","149","150","0.6666666666666666666666666667"
"2021-11-30T00:00:00.000","Mecklenburg","NC","Passenger","1","0","1","69","70","1.428571428571428571428571429"
"2021-11-30T00:00:00.000","Moore","NC","Passenger","0","1","1","122","123","0.8130081300813008130081300813"
"2021-11-30T00:00:00.000","Onslow","NC","Passenger","0","1","1","152","153","0.6535947712418300653594771242"
"2021-11-30T00:00:00.000","Wake","NC","Passenger","1","0","1","90","91","1.098901098901098901098901099"
"2021-11-30T00:00:00.000","Wayne","NC","Passenger","1","0","1","27","28","3.571428571428571428571428571"
"2021-11-30T00:00:00.000","Wilson","NC","Passenger","1","0","1","1","2","50.0"
"2021-11-30T00:00:00.000","Williams","ND","Passenger","0","1","1","8","9","11.11111111111111111111111111"
"2021-11-30T00:00:00.000","Douglas","NE","Passenger","1","1","2","46","48","4.166666666666666666666666667"
"2021-11-30T00:00:00.000","Sarpy","NE","Passenger","1","0","1","52","53","1.886792452830188679245283019"
"2021-11-30T00:00:00.000","Carroll","NH","Passenger","0","1","1","3","4","25.00"
"2021-11-30T00:00:00.000","Burlington","NJ","Passenger","0","1","1","122","123","0.8130081300813008130081300813"
"2021-11-30T00:00:00.000","Camden","NJ","Passenger","0","1","1","11","12","8.333333333333333333333333333"
"2021-11-30T00:00:00.000","Hudson","NJ","Passenger","1","0","1","93","94","1.063829787234042553191489362"
"2021-11-30T00:00:00.000","Hudson","NJ","Truck","1","0","1","10","11","9.090909090909090909090909091"
"2021-11-30T00:00:00.000","Bernalillo","NM","Passenger","1","0","1","103","104","0.9615384615384615384615384615"
"2021-11-30T00:00:00.000","Chaves","NM","Passenger","1","0","1","5","6","16.66666666666666666666666667"
"2021-11-30T00:00:00.000","Carson City","NV","Passenger","1","0","1","9","10","10.0"
"2021-11-30T00:00:00.000","Clark","NV","Passenger","5","4","9","520","529","1.701323251417769376181474480"
"2021-11-30T00:00:00.000","Washoe","NV","Passenger","1","0","1","60","61","1.639344262295081967213114754"
"2021-11-30T00:00:00.000","Erie","NY","Passenger","1","0","1","24","25","4.00"
"2021-11-30T00:00:00.000","Jefferson","NY","Passenger","0","1","1","192","193","0.5181347150259067357512953368"
"2021-11-30T00:00:00.000","Kings","NY","Passenger","1","0","1","54","55","1.818181818181818181818181818"
"2021-11-30T00:00:00.000","New York","NY","Passenger","1","0","1","41","42","2.380952380952380952380952381"
"2021-11-30T00:00:00.000","Queens","NY","Passenger","1","0","1","40","41","2.439024390243902439024390244"
"2021-11-30T00:00:00.000","Saratoga","NY","Passenger","1","0","1","37","38","2.631578947368421052631578947"
"2021-11-30T00:00:00.000","Hamilton","OH","Passenger","1","0","1","28","29","3.448275862068965517241379310"
"2021-11-30T00:00:00.000","Shelby","OH","Passenger","0","1","1","2","3","33.33333333333333333333333333"
"2021-11-30T00:00:00.000","Rogers","OK","Passenger","1","0","1","3","4","25.00"
"2021-11-30T00:00:00.000","Clackamas","OR","Passenger","2","0","2","139","141","1.418439716312056737588652482"
"2021-11-30T00:00:00.000","Klamath","OR","Passenger","1","0","1","20","21","4.761904761904761904761904762"
"2021-11-30T00:00:00.000","Multnomah","OR","Passenger","2","5","7","534","541","1.293900184842883548983364140"
"2021-11-30T00:00:00.000","Washington","OR","Passenger","1","0","1","293","294","0.3401360544217687074829931973"
"2021-11-30T00:00:00.000","Yamhill","OR","Passenger","1","0","1","25","26","3.846153846153846153846153846"
"2021-11-30T00:00:00.000","Allegheny","PA","Passenger","1","1","2","50","52","3.846153846153846153846153846"
"2021-11-30T00:00:00.000","Montgomery","PA","Passenger","2","0","2","14","16","12.500"
"2021-11-30T00:00:00.000","Philadelphia","PA","Passenger","1","0","1","37","38","2.631578947368421052631578947"
"2021-11-30T00:00:00.000","RÃ­o Grande","PR","Passenger","1","0","1","0","1","100"
"2021-11-30T00:00:00.000","Newport","RI","Passenger","1","0","1","74","75","1.333333333333333333333333333"
"2021-11-30T00:00:00.000","Newport","RI","Truck","1","0","1","12","13","7.692307692307692307692307692"
"2021-11-30T00:00:00.000","Charleston","SC","Passenger","1","0","1","72","73","1.369863013698630136986301370"
"2021-11-30T00:00:00.000","Richland","SC","Passenger","0","1","1","123","124","0.8064516129032258064516129032"
"2021-11-30T00:00:00.000","Spartanburg","SC","Passenger","0","1","1","30","31","3.225806451612903225806451613"
"2021-11-30T00:00:00.000","Sumter","SC","Passenger","0","1","1","30","31","3.225806451612903225806451613"
"2021-11-30T00:00:00.000","Pennington","SD","Passenger","1","0","1","28","29","3.448275862068965517241379310"
"2021-11-30T00:00:00.000","Davidson","TN","Passenger","1","0","1","36","37","2.702702702702702702702702703"
"2021-11-30T00:00:00.000","Montgomery","TN","Passenger","1","0","1","186","187","0.5347593582887700534759358289"
"2021-11-30T00:00:00.000","Tipton","TN","Passenger","1","0","1","12","13","7.692307692307692307692307692"
"2021-11-30T00:00:00.000","Bell","TX","Passenger","0","1","1","311","312","0.3205128205128205128205128205"
"2021-11-30T00:00:00.000","Bexar","TX","Passenger","4","3","7","441","448","1.562500"
"2021-11-30T00:00:00.000","Coryell","TX","Passenger","1","0","1","103","104","0.9615384615384615384615384615"
"2021-11-30T00:00:00.000","Dallas","TX","Passenger","1","0","1","124","125","0.800"
"2021-11-30T00:00:00.000","Denton","TX","Passenger","1","0","1","56","57","1.754385964912280701754385965"
"2021-11-30T00:00:00.000","El Paso","TX","Passenger","2","0","2","328","330","0.6060606060606060606060606061"
"2021-11-30T00:00:00.000","Harris","TX","Passenger","1","0","1","159","160","0.62500"
"2021-11-30T00:00:00.000","Hidalgo","TX","Passenger","0","1","1","54","55","1.818181818181818181818181818"
"2021-11-30T00:00:00.000","Montgomery","TX","Passenger","1","1","2","26","28","7.142857142857142857142857143"
"2021-11-30T00:00:00.000","Nueces","TX","Passenger","1","0","1","58","59","1.694915254237288135593220339"
"2021-11-30T00:00:00.000","Tarrant","TX","Passenger","1","0","1","107","108","0.9259259259259259259259259259"
"2021-11-30T00:00:00.000","Travis","TX","Passenger","2","2","4","116","120","3.333333333333333333333333333"
"2021-11-30T00:00:00.000","Wichita","TX","Passenger","1","0","1","39","40","2.500"
"2021-11-30T00:00:00.000","Williamson","TX","Passenger","1","0","1","81","82","1.219512195121951219512195122"
"2021-11-30T00:00:00.000","Salt Lake","UT","Passenger","0","2","2","137","139","1.438848920863309352517985612"
"2021-11-30T00:00:00.000","Albemarle","VA","Passenger","1","0","1","18","19","5.263157894736842105263157895"
"2021-11-30T00:00:00.000","Alexandria","VA","Passenger","4","0","4","127","131","3.053435114503816793893129771"
"2021-11-30T00:00:00.000","Arlington","VA","Passenger","0","1","1","118","119","0.8403361344537815126050420168"
"2021-11-30T00:00:00.000","Chesapeake","VA","Passenger","1","3","4","366","370","1.081081081081081081081081081"
"2021-11-30T00:00:00.000","Danville","VA","Passenger","1","0","1","0","1","100"
"2021-11-30T00:00:00.000","Fairfax","VA","Passenger","3","4","7","640","647","1.081916537867078825347758887"
"2021-11-30T00:00:00.000","Goochland","VA","Passenger","3","0","3","145","148","2.027027027027027027027027027"
"2021-11-30T00:00:00.000","Loudoun","VA","Passenger","1","0","1","57","58","1.724137931034482758620689655"
"2021-11-30T00:00:00.000","Louisa","VA","Passenger","0","1","1","0","1","100"
"2021-11-30T00:00:00.000","Manassas","VA","Passenger","0","1","1","5","6","16.66666666666666666666666667"
"2021-11-30T00:00:00.000","Norfolk","VA","Passenger","1","1","2","301","303","0.6600660066006600660066006601"
"2021-11-30T00:00:00.000","Portsmouth","VA","Passenger","1","1","2","63","65","3.076923076923076923076923077"
"2021-11-30T00:00:00.000","Powhatan","VA","Passenger","1","0","1","1","2","50.0"
"2021-11-30T00:00:00.000","Prince William","VA","Passenger","1","1","2","191","193","1.036269430051813471502590674"
"2021-11-30T00:00:00.000","Stafford","VA","Passenger","2","1","3","92","95","3.157894736842105263157894737"
"2021-11-30T00:00:00.000","Suffolk","VA","Passenger","1","0","1","104","105","0.9523809523809523809523809524"
"2021-11-30T00:00:00.000","Virginia Beach","VA","Passenger","2","0","2","521","523","0.3824091778202676864244741874"
"2021-11-30T00:00:00.000","Adams","WA","Truck","0","0","0","5426","5426","0"
"2021-11-30T00:00:00.000","Adams","WA","Passenger","16","16","32","13045","13077","0.2447044429150416762254339680"
"2021-11-30T00:00:00.000","Asotin","WA","Passenger","22","18","40","12777","12817","0.3120855114301318561285792307"
"2021-11-30T00:00:00.000","Asotin","WA","Truck","2","0","2","6763","6765","0.02956393200295639320029563932"
"2021-11-30T00:00:00.000","Benton","WA","Truck","23","0","23","43658","43681","0.05265447219614935555504681669"
"2021-11-30T00:00:00.000","Benton","WA","Passenger","636","443","1079","136093","137172","0.7866036800513224273175283586"
"2021-11-30T00:00:00.000","Chelan","WA","Truck","8","0","8","23100","23108","0.03462004500605850787606023888"
"2021-11-30T00:00:00.000","Chelan","WA","Passenger","407","113","520","54716","55236","0.9414150191903830834962705482"
"2021-11-30T00:00:00.000","Clallam","WA","Truck","3","0","3","22124","22127","0.01355809644325936638495955168"
"2021-11-30T00:00:00.000","Clallam","WA","Passenger","382","244","626","50535","51161","1.223588280135259279529328981"
"2021-11-30T00:00:00.000","Clark","WA","Truck","48","0","48","84072","84120","0.05706134094151212553495007133"
"2021-11-30T00:00:00.000","Clark","WA","Passenger","3473","1582","5055","320964","326019","1.550523129020087786294663808"
"2021-11-30T00:00:00.000","Columbia","WA","Truck","2","0","2","1552","1554","0.1287001287001287001287001287"
"2021-11-30T00:00:00.000","Columbia","WA","Passenger","6","2","8","2461","2469","0.3240178209801539084649655731"
"2021-11-30T00:00:00.000","Cowlitz","WA","Passenger","279","169","448","71794","72242","0.6201378699371556712161900280"
"2021-11-30T00:00:00.000","Cowlitz","WA","Truck","9","1","10","29046","29056","0.03441629955947136563876651982"
"2021-11-30T00:00:00.000","Douglas","WA","Truck","4","0","4","12698","12702","0.03149110376318689970083451425"
"2021-11-30T00:00:00.000","Douglas","WA","Passenger","107","54","161","28625","28786","0.5592996595567289654693253665"
"2021-11-30T00:00:00.000","Ferry","WA","Truck","0","0","0","3602","3602","0"
"2021-11-30T00:00:00.000","Ferry","WA","Passenger","13","3","16","4464","4480","0.3571428571428571428571428571"
"2021-11-30T00:00:00.000","Franklin","WA","Truck","9","0","9","20785","20794","0.04328171587958064826392228527"
"2021-11-30T00:00:00.000","Franklin","WA","Passenger","159","108","267","62313","62580","0.4266538830297219558964525407"
"2021-11-30T00:00:00.000","Garfield","WA","Truck","0","0","0","993","993","0"
"2021-11-30T00:00:00.000","Garfield","WA","Passenger","0","3","3","1354","1357","0.2210759027266028002947678703"
"2021-11-30T00:00:00.000","Grant","WA","Passenger","136","103","239","66982","67221","0.3555436545127266776751312834"
"2021-11-30T00:00:00.000","Grant","WA","Truck","7","0","7","28056","28063","0.02494387627837365926665003742"
"2021-11-30T00:00:00.000","Grays Harbor","WA","Truck","10","0","10","21421","21431","0.04666137837711726004386169567"
"2021-11-30T00:00:00.000","Grays Harbor","WA","Passenger","205","162","367","49530","49897","0.7355151612321382047016854721"
"2021-11-30T00:00:00.000","Island","WA","Passenger","716","358","1074","63181","64255","1.671465255622130573496225975"
"2021-11-30T00:00:00.000","Island","WA","Truck","11","0","11","21583","21594","0.05094007594702232101509678614"
"2021-11-30T00:00:00.000","Jefferson","WA","Truck","2","0","2","9609","9611","0.02080948912704193112059098949"
"2021-11-30T00:00:00.000","Jefferson","WA","Passenger","380","205","585","24802","25387","2.304328987276952771103320597"
"2021-11-30T00:00:00.000","King","WA","Truck","188","1","189","183314","183503","0.1029955913527299281210661406"
"2021-11-30T00:00:00.000","King","WA","Passenger","35148","10372","45520","1363802","1409322","3.229921905710689253414052999"
"2021-11-30T00:00:00.000","Kitsap","WA","Passenger","2161","976","3137","180885","184022","1.704687483018334764321657193"
"2021-11-30T00:00:00.000","Kitsap","WA","Truck","33","0","33","54385","54418","0.06064169943768605975963835496"
"2021-11-30T00:00:00.000","Kittitas","WA","Truck","4","0","4","14809","14813","0.02700330790521838925268345372"
"2021-11-30T00:00:00.000","Kittitas","WA","Passenger","203","77","280","29847","30127","0.9293988780827828857835164470"
"2021-11-30T00:00:00.000","Klickitat","WA","Passenger","90","52","142","15362","15504","0.9158926728586171310629514964"
"2021-11-30T00:00:00.000","Klickitat","WA","Truck","1","0","1","8342","8343","0.01198609612849095049742298933"
"2021-11-30T00:00:00.000","Lewis","WA","Passenger","210","171","381","59641","60022","0.6347672520075972143547365966"
"2021-11-30T00:00:00.000","Lewis","WA","Truck","6","0","6","26739","26745","0.02243409983174425126191811554"
"2021-11-30T00:00:00.000","Lincoln","WA","Passenger","9","16","25","7698","7723","0.3237084034701540852000517933"
"2021-11-30T00:00:00.000","Lincoln","WA","Truck","0","0","0","4814","4814","0"
"2021-11-30T00:00:00.000","Mason","WA","Passenger","276","165","441","47819","48260","0.9138002486531288852051388313"
"2021-11-30T00:00:00.000","Mason","WA","Truck","9","0","9","21259","21268","0.04231709610682715817190144819"
"2021-11-30T00:00:00.000","Okanogan","WA","Passenger","68","44","112","26622","26734","0.4189421710181790977781102716"
"2021-11-30T00:00:00.000","Okanogan","WA","Truck","2","0","2","16700","16702","0.01197461381870434678481618968"
"2021-11-30T00:00:00.000","Pacific","WA","Passenger","60","67","127","16070","16197","0.7840958202136198061369389393"
"2021-11-30T00:00:00.000","Pacific","WA","Truck","1","0","1","8004","8005","0.01249219237976264834478450968"
"2021-11-30T00:00:00.000","Pend Oreille","WA","Passenger","18","7","25","9177","9202","0.2716800695500978048250380352"
"2021-11-30T00:00:00.000","Pend Oreille","WA","Truck","0","0","0","5696","5696","0"
"2021-11-30T00:00:00.000","Pierce","WA","Passenger","4350","2203","6553","558127","564680","1.160480272012467238081745413"
"2021-11-30T00:00:00.000","Pierce","WA","Truck","67","0","67","145301","145368","0.04608992350448516867536184029"
"2021-11-30T00:00:00.000","San Juan","WA","Truck","0","0","0","6000","6000","0"
"2021-11-30T00:00:00.000","San Juan","WA","Passenger","475","148","623","14207","14830","4.200944032366824005394470668"
"2021-11-30T00:00:00.000","Skagit","WA","Passenger","694","322","1016","91341","92357","1.100079041112205896683521552"
"2021-11-30T00:00:00.000","Skagit","WA","Truck","18","0","18","32822","32840","0.05481120584652862362971985384"
"2021-11-30T00:00:00.000","Skamania","WA","Truck","0","0","0","4004","4004","0"
"2021-11-30T00:00:00.000","Skamania","WA","Passenger","60","41","101","8346","8447","1.195690777790931691724872736"
"2021-11-30T00:00:00.000","Snohomish","WA","Passenger","6990","2329","9319","538671","547990","1.700578477709447252687092830"
"2021-11-30T00:00:00.000","Snohomish","WA","Truck","85","0","85","125707","125792","0.06757186466547952175019079115"
"2021-11-30T00:00:00.000","Spokane","WA","Passenger","1305","785","2090","327392","329482","0.6343290377016043365039668328"
"2021-11-30T00:00:00.000","Spokane","WA","Truck","45","0","45","102782","102827","0.04376282493897517189065128809"
"2021-11-30T00:00:00.000","Stevens","WA","Truck","2","0","2","18929","18931","0.01056468226718081453700279964"
"2021-11-30T00:00:00.000","Stevens","WA","Passenger","57","43","100","30340","30440","0.3285151116951379763469119580"
"2021-11-30T00:00:00.000","Thurston","WA","Passenger","1932","999","2931","197483","200414","1.462472681549193170137814724"
"2021-11-30T00:00:00.000","Thurston","WA","Truck","41","0","41","56239","56280","0.07285003553660270078180525942"
"2021-11-30T00:00:00.000","Wahkiakum","WA","Truck","0","0","0","1819","1819","0"
"2021-11-30T00:00:00.000","Wahkiakum","WA","Passenger","17","11","28","3092","3120","0.8974358974358974358974358974"
"2021-11-30T00:00:00.000","Walla Walla","WA","Truck","7","0","7","14090","14097","0.04965595516776619138823863233"
"2021-11-30T00:00:00.000","Walla Walla","WA","Passenger","137","89","226","36430","36656","0.6165429943256219991270187691"
"2021-11-30T00:00:00.000","Whatcom","WA","Passenger","1664","687","2351","150311","152662","1.540003406217657308302000498"
"2021-11-30T00:00:00.000","Whatcom","WA","Truck","27","0","27","43720","43747","0.06171851784122339817587491714"
"2021-11-30T00:00:00.000","Whitman","WA","Truck","5","0","5","8563","8568","0.05835667600373482726423902894"
"2021-11-30T00:00:00.000","Whitman","WA","Passenger","68","62","130","22009","22139","0.5871990604815032295948326483"
"2021-11-30T00:00:00.000","Yakima","WA","Passenger","288","179","467","168748","169215","0.2759802617971220045504240168"
"2021-11-30T00:00:00.000","Yakima","WA","Truck","5","0","5","61744","61749","0.008097297122220602762797778102"
"2021-11-30T00:00:00.000","Douglas","WI","Passenger","1","0","1","1","2","50.0"
"2021-11-30T00:00:00.000","Milwaukee","WI","Passenger","1","0","1","35","36","2.777777777777777777777777778"
"2021-11-30T00:00:00.000","Ozaukee","WI","Passenger","0","1","1","2","3","33.33333333333333333333333333"
"2021-12-31T00:00:00.000","Anchorage","AK","Passenger","1","0","1","115","116","0.8620689655172413793103448276"
"2021-12-31T00:00:00.000","Fairbanks North Star","AK","Passenger","0","1","1","74","75","1.333333333333333333333333333"
"2021-12-31T00:00:00.000","Juneau","AK","Passenger","0","1","1","25","26","3.846153846153846153846153846"
"2021-12-31T00:00:00.000","Maricopa","AZ","Passenger","5","3","8","822","830","0.9638554216867469879518072289"
"2021-12-31T00:00:00.000","Pima","AZ","Passenger","1","1","2","217","219","0.9132420091324200913242009132"
"2021-12-31T00:00:00.000","Pinal","AZ","Passenger","1","0","1","100","101","0.9900990099009900990099009901"
"2021-12-31T00:00:00.000","Alameda","CA","Passenger","4","0","4","192","196","2.040816326530612244897959184"
"2021-12-31T00:00:00.000","Contra Costa","CA","Passenger","1","5","6","304","310","1.935483870967741935483870968"
"2021-12-31T00:00:00.000","Fresno","CA","Passenger","1","0","1","143","144","0.6944444444444444444444444444"
"2021-12-31T00:00:00.000","Kern","CA","Passenger","1","1","2","177","179","1.117318435754189944134078212"
"2021-12-31T00:00:00.000","Kings","CA","Passenger","1","0","1","312","313","0.3194888178913738019169329073"
"2021-12-31T00:00:00.000","Los Angeles","CA","Passenger","4","5","9","725","734","1.226158038147138964577656676"
"2021-12-31T00:00:00.000","Marin","CA","Passenger","0","1","1","31","32","3.12500"
"2021-12-31T00:00:00.000","Monterey","CA","Passenger","1","1","2","130","132","1.515151515151515151515151515"
"2021-12-31T00:00:00.000","Orange","CA","Passenger","5","2","7","359","366","1.912568306010928961748633880"
"2021-12-31T00:00:00.000","Placer","CA","Passenger","1","0","1","62","63","1.587301587301587301587301587"
"2021-12-31T00:00:00.000","Riverside","CA","Passenger","6","1","7","437","444","1.576576576576576576576576577"
"2021-12-31T00:00:00.000","Sacramento","CA","Passenger","1","0","1","195","196","0.5102040816326530612244897959"
"2021-12-31T00:00:00.000","San Bernardino","CA","Passenger","1","2","3","338","341","0.8797653958944281524926686217"
"2021-12-31T00:00:00.000","San Diego","CA","Passenger","15","9","24","2340","2364","1.015228426395939086294416244"
"2021-12-31T00:00:00.000","San Francisco","CA","Passenger","0","1","1","65","66","1.515151515151515151515151515"
"2021-12-31T00:00:00.000","San Joaquin","CA","Passenger","0","1","1","88","89","1.123595505617977528089887640"
"2021-12-31T00:00:00.000","San Luis Obispo","CA","Passenger","1","0","1","49","50","2.00"
"2021-12-31T00:00:00.000","Santa Barbara","CA","Passenger","1","0","1","66","67","1.492537313432835820895522388"
"2021-12-31T00:00:00.000","Santa Clara","CA","Passenger","4","1","5","195","200","2.500"
"2021-12-31T00:00:00.000","Santa Cruz","CA","Passenger","1","0","1","19","20","5.00"
"2021-12-31T00:00:00.000","Solano","CA","Passenger","1","0","1","171","172","0.5813953488372093023255813953"
"2021-12-31T00:00:00.000","Sonoma","CA","Passenger","0","1","1","76","77","1.298701298701298701298701299"
"2021-12-31T00:00:00.000","Ventura","CA","Passenger","2","1","3","233","236","1.271186440677966101694915254"
"2021-12-31T00:00:00.000","Boulder","CO","Passenger","1","1","2","25","27","7.407407407407407407407407407"
"2021-12-31T00:00:00.000","El Paso","CO","Passenger","2","0","2","588","590","0.3389830508474576271186440678"
"2021-12-31T00:00:00.000","Larimer","CO","Passenger","1","0","1","40","41","2.439024390243902439024390244"
"2021-12-31T00:00:00.000","Las Animas","CO","Passenger","1","0","1","0","1","100"
"2021-12-31T00:00:00.000","New London","CT","Passenger","0","4","4","215","219","1.826484018264840182648401826"
"2021-12-31T00:00:00.000","District of Columbia","DC","Passenger","4","2","6","187","193","3.108808290155440414507772021"
"2021-12-31T00:00:00.000","Kent","DE","Passenger","0","1","1","54","55","1.818181818181818181818181818"
"2021-12-31T00:00:00.000","New Castle","DE","Passenger","1","0","1","19","20","5.00"
"2021-12-31T00:00:00.000","Broward","FL","Passenger","1","0","1","83","84","1.190476190476190476190476190"
"2021-12-31T00:00:00.000","Duval","FL","Passenger","0","1","1","275","276","0.3623188405797101449275362319"
"2021-12-31T00:00:00.000","Hillsborough","FL","Passenger","0","1","1","121","122","0.8196721311475409836065573770"
"2021-12-31T00:00:00.000","Lake","FL","Passenger","1","0","1","18","19","5.263157894736842105263157895"
"2021-12-31T00:00:00.000","Okaloosa","FL","Passenger","0","1","1","94","95","1.052631578947368421052631579"
"2021-12-31T00:00:00.000","Orange","FL","Passenger","1","0","1","89","90","1.111111111111111111111111111"
"2021-12-31T00:00:00.000","Palm Beach","FL","Passenger","1","0","1","42","43","2.325581395348837209302325581"
"2021-12-31T00:00:00.000","Pinellas","FL","Passenger","0","1","1","70","71","1.408450704225352112676056338"
"2021-12-31T00:00:00.000","Sarasota","FL","Passenger","2","0","2","27","29","6.896551724137931034482758621"
"2021-12-31T00:00:00.000","St. Johns","FL","Passenger","0","1","1","30","31","3.225806451612903225806451613"
"2021-12-31T00:00:00.000","Bartow","GA","Passenger","0","1","1","2","3","33.33333333333333333333333333"
"2021-12-31T00:00:00.000","Bryan","GA","Passenger","1","0","1","44","45","2.222222222222222222222222222"
"2021-12-31T00:00:00.000","Columbia","GA","Passenger","1","1","2","97","99","2.020202020202020202020202020"
"2021-12-31T00:00:00.000","DeKalb","GA","Passenger","1","0","1","45","46","2.173913043478260869565217391"
"2021-12-31T00:00:00.000","Houston","GA","Passenger","1","0","1","41","42","2.380952380952380952380952381"
"2021-12-31T00:00:00.000","Liberty","GA","Passenger","1","0","1","100","101","0.9900990099009900990099009901"
"2021-12-31T00:00:00.000","Rockdale","GA","Passenger","1","0","1","6","7","14.28571428571428571428571429"
"2021-12-31T00:00:00.000","Honolulu","HI","Passenger","4","2","6","313","319","1.880877742946708463949843260"
"2021-12-31T00:00:00.000","Champaign","IL","Passenger","1","0","1","9","10","10.0"
"2021-12-31T00:00:00.000","Cook","IL","Passenger","2","0","2","156","158","1.265822784810126582278481013"
"2021-12-31T00:00:00.000","DuPage","IL","Passenger","1","0","1","40","41","2.439024390243902439024390244"
"2021-12-31T00:00:00.000","Lake","IL","Passenger","4","0","4","152","156","2.564102564102564102564102564"
"2021-12-31T00:00:00.000","St. Clair","IL","Passenger","2","0","2","114","116","1.724137931034482758620689655"
"2021-12-31T00:00:00.000","Hamilton","IN","Passenger","2","0","2","24","26","7.692307692307692307692307692"
"2021-12-31T00:00:00.000","Howard","IN","Passenger","0","1","1","6","7","14.28571428571428571428571429"
"2021-12-31T00:00:00.000","Vigo","IN","Passenger","1","0","1","4","5","20.0"
"2021-12-31T00:00:00.000","Geary","KS","Passenger","1","0","1","85","86","1.162790697674418604651162791"
"2021-12-31T00:00:00.000","Leavenworth","KS","Passenger","1","1","2","105","107","1.869158878504672897196261682"
"2021-12-31T00:00:00.000","Oldham","KY","Passenger","0","1","1","4","5","20.0"
"2021-12-31T00:00:00.000","Plaquemines","LA","Passenger","0","1","1","15","16","6.2500"
"2021-12-31T00:00:00.000","Middlesex","MA","Passenger","0","1","1","81","82","1.219512195121951219512195122"
"2021-12-31T00:00:00.000","Suffolk","MA","Passenger","0","2","2","29","31","6.451612903225806451612903226"
"2021-12-31T00:00:00.000","Anne Arundel","MD","Passenger","4","3","7","338","345","2.028985507246376811594202899"
"2021-12-31T00:00:00.000","Baltimore","MD","Passenger","1","0","1","69","70","1.428571428571428571428571429"
"2021-12-31T00:00:00.000","Calvert","MD","Passenger","0","2","2","78","80","2.500"
"2021-12-31T00:00:00.000","Carroll","MD","Passenger","0","1","1","12","13","7.692307692307692307692307692"
"2021-12-31T00:00:00.000","Charles","MD","Truck","1","0","1","9","10","10.0"
"2021-12-31T00:00:00.000","Charles","MD","Passenger","1","1","2","61","63","3.174603174603174603174603175"
"2021-12-31T00:00:00.000","Frederick","MD","Passenger","2","1","3","69","72","4.166666666666666666666666667"
"2021-12-31T00:00:00.000","Howard","MD","Passenger","0","1","1","54","55","1.818181818181818181818181818"
"2021-12-31T00:00:00.000","Montgomery","MD","Passenger","2","4","6","199","205","2.926829268292682926829268293"
"2021-12-31T00:00:00.000","Prince George's","MD","Passenger","1","0","1","126","127","0.7874015748031496062992125984"
"2021-12-31T00:00:00.000","St. Mary's","MD","Truck","1","0","1","41","42","2.380952380952380952380952381"
"2021-12-31T00:00:00.000","St. Mary's","MD","Passenger","1","0","1","175","176","0.5681818181818181818181818182"
"2021-12-31T00:00:00.000","Washington","MD","Passenger","2","0","2","11","13","15.38461538461538461538461538"
"2021-12-31T00:00:00.000","Penobscot","ME","Passenger","0","1","1","9","10","10.0"
"2021-12-31T00:00:00.000","Hennepin","MN","Passenger","1","0","1","53","54","1.851851851851851851851851852"
"2021-12-31T00:00:00.000","Kanabec","MN","Passenger","1","0","1","0","1","100"
"2021-12-31T00:00:00.000","Boone","MO","Passenger","0","1","1","9","10","10.0"
"2021-12-31T00:00:00.000","Greene","MO","Passenger","0","1","1","17","18","5.555555555555555555555555556"
"2021-12-31T00:00:00.000","Platte","MO","Passenger","1","0","1","15","16","6.2500"
"2021-12-31T00:00:00.000","Ray","MO","Passenger","0","1","1","0","1","100"
"2021-12-31T00:00:00.000","St. Louis","MO","Passenger","1","0","1","72","73","1.369863013698630136986301370"
"2021-12-31T00:00:00.000","Harrison","MS","Passenger","2","0","2","44","46","4.347826086956521739130434783"
"2021-12-31T00:00:00.000","Flathead","MT","Passenger","1","0","1","33","34","2.941176470588235294117647059"
"2021-12-31T00:00:00.000","Glacier","MT","Passenger","0","1","1","5","6","16.66666666666666666666666667"
"2021-12-31T00:00:00.000","Cumberland","NC","Truck","1","0","1","87","88","1.136363636363636363636363636"
"2021-12-31T00:00:00.000","Cumberland","NC","Passenger","0","2","2","387","389","0.5141388174807197943444730077"
"2021-12-31T00:00:00.000","Harnett","NC","Passenger","0","1","1","147","148","0.6756756756756756756756756757"
"2021-12-31T00:00:00.000","Mecklenburg","NC","Passenger","1","0","1","65","66","1.515151515151515151515151515"
"2021-12-31T00:00:00.000","Moore","NC","Passenger","0","1","1","121","122","0.8196721311475409836065573770"
"2021-12-31T00:00:00.000","Onslow","NC","Passenger","0","1","1","150","151","0.6622516556291390728476821192"
"2021-12-31T00:00:00.000","Wake","NC","Passenger","1","0","1","88","89","1.123595505617977528089887640"
"2021-12-31T00:00:00.000","Wayne","NC","Passenger","1","0","1","26","27","3.703703703703703703703703704"
"2021-12-31T00:00:00.000","Wilson","NC","Passenger","1","0","1","1","2","50.0"
"2021-12-31T00:00:00.000","Williams","ND","Passenger","0","1","1","8","9","11.11111111111111111111111111"
"2021-12-31T00:00:00.000","Douglas","NE","Passenger","1","2","3","45","48","6.2500"
"2021-12-31T00:00:00.000","Sarpy","NE","Passenger","1","0","1","52","53","1.886792452830188679245283019"
"2021-12-31T00:00:00.000","Carroll","NH","Passenger","0","1","1","3","4","25.00"
"2021-12-31T00:00:00.000","Burlington","NJ","Passenger","0","1","1","120","121","0.8264462809917355371900826446"
"2021-12-31T00:00:00.000","Camden","NJ","Passenger","0","1","1","10","11","9.090909090909090909090909091"
"2021-12-31T00:00:00.000","Hudson","NJ","Passenger","1","0","1","90","91","1.098901098901098901098901099"
"2021-12-31T00:00:00.000","Hudson","NJ","Truck","1","0","1","10","11","9.090909090909090909090909091"
"2021-12-31T00:00:00.000","Chaves","NM","Passenger","1","0","1","5","6","16.66666666666666666666666667"
"2021-12-31T00:00:00.000","Carson City","NV","Passenger","1","0","1","9","10","10.0"
"2021-12-31T00:00:00.000","Clark","NV","Passenger","5","4","9","515","524","1.717557251908396946564885496"
"2021-12-31T00:00:00.000","Washoe","NV","Passenger","1","0","1","57","58","1.724137931034482758620689655"
"2021-12-31T00:00:00.000","Erie","NY","Passenger","1","0","1","24","25","4.00"
"2021-12-31T00:00:00.000","Jefferson","NY","Passenger","0","1","1","190","191","0.5235602094240837696335078534"
"2021-12-31T00:00:00.000","Kings","NY","Passenger","1","0","1","53","54","1.851851851851851851851851852"
"2021-12-31T00:00:00.000","New York","NY","Passenger","1","0","1","41","42","2.380952380952380952380952381"
"2021-12-31T00:00:00.000","Queens","NY","Passenger","1","0","1","40","41","2.439024390243902439024390244"
"2021-12-31T00:00:00.000","Saratoga","NY","Passenger","1","0","1","37","38","2.631578947368421052631578947"
"2021-12-31T00:00:00.000","Hamilton","OH","Passenger","1","0","1","28","29","3.448275862068965517241379310"
"2021-12-31T00:00:00.000","Shelby","OH","Passenger","0","1","1","2","3","33.33333333333333333333333333"
"2021-12-31T00:00:00.000","Rogers","OK","Passenger","1","0","1","3","4","25.00"
"2021-12-31T00:00:00.000","Clackamas","OR","Passenger","2","0","2","136","138","1.449275362318840579710144928"
"2021-12-31T00:00:00.000","Klamath","OR","Passenger","1","0","1","20","21","4.761904761904761904761904762"
"2021-12-31T00:00:00.000","Lincoln","OR","Passenger","0","1","1","31","32","3.12500"
"2021-12-31T00:00:00.000","Multnomah","OR","Passenger","2","4","6","517","523","1.147227533460803059273422562"
"2021-12-31T00:00:00.000","Yamhill","OR","Passenger","1","0","1","24","25","4.00"
"2021-12-31T00:00:00.000","Allegheny","PA","Passenger","1","1","2","46","48","4.166666666666666666666666667"
"2021-12-31T00:00:00.000","Montgomery","PA","Passenger","2","0","2","14","16","12.500"
"2021-12-31T00:00:00.000","Philadelphia","PA","Passenger","1","0","1","35","36","2.777777777777777777777777778"
"2021-12-31T00:00:00.000","RÃ­o Grande","PR","Passenger","1","0","1","0","1","100"
"2021-12-31T00:00:00.000","Newport","RI","Passenger","1","0","1","74","75","1.333333333333333333333333333"
"2021-12-31T00:00:00.000","Newport","RI","Truck","1","0","1","12","13","7.692307692307692307692307692"
"2021-12-31T00:00:00.000","Charleston","SC","Passenger","1","0","1","70","71","1.408450704225352112676056338"
"2021-12-31T00:00:00.000","Richland","SC","Passenger","0","1","1","122","123","0.8130081300813008130081300813"
"2021-12-31T00:00:00.000","Spartanburg","SC","Passenger","0","1","1","29","30","3.333333333333333333333333333"
"2021-12-31T00:00:00.000","Sumter","SC","Passenger","0","1","1","30","31","3.225806451612903225806451613"
"2021-12-31T00:00:00.000","Pennington","SD","Passenger","1","0","1","28","29","3.448275862068965517241379310"
"2021-12-31T00:00:00.000","Davidson","TN","Passenger","1","0","1","34","35","2.857142857142857142857142857"
"2021-12-31T00:00:00.000","Montgomery","TN","Passenger","1","0","1","180","181","0.5524861878453038674033149171"
"2021-12-31T00:00:00.000","Tipton","TN","Passenger","1","0","1","12","13","7.692307692307692307692307692"
"2021-12-31T00:00:00.000","Bell","TX","Passenger","0","1","1","304","305","0.3278688524590163934426229508"
"2021-12-31T00:00:00.000","Bexar","TX","Passenger","4","3","7","435","442","1.583710407239819004524886878"
"2021-12-31T00:00:00.000","Coryell","TX","Passenger","1","0","1","101","102","0.9803921568627450980392156863"
"2021-12-31T00:00:00.000","Dallas","TX","Passenger","1","0","1","119","120","0.8333333333333333333333333333"
"2021-12-31T00:00:00.000","Denton","TX","Passenger","1","0","1","55","56","1.785714285714285714285714286"
"2021-12-31T00:00:00.000","El Paso","TX","Passenger","1","0","1","323","324","0.3086419753086419753086419753"
"2021-12-31T00:00:00.000","Harris","TX","Passenger","1","0","1","151","152","0.6578947368421052631578947368"
"2021-12-31T00:00:00.000","Hidalgo","TX","Passenger","0","1","1","54","55","1.818181818181818181818181818"
"2021-12-31T00:00:00.000","Montgomery","TX","Passenger","1","1","2","25","27","7.407407407407407407407407407"
"2021-12-31T00:00:00.000","Nueces","TX","Passenger","1","0","1","58","59","1.694915254237288135593220339"
"2021-12-31T00:00:00.000","Tarrant","TX","Passenger","1","0","1","103","104","0.9615384615384615384615384615"
"2021-12-31T00:00:00.000","Travis","TX","Passenger","1","0","1","115","116","0.8620689655172413793103448276"
"2021-12-31T00:00:00.000","Wichita","TX","Passenger","1","0","1","39","40","2.500"
"2021-12-31T00:00:00.000","Williamson","TX","Passenger","1","0","1","78","79","1.265822784810126582278481013"
"2021-12-31T00:00:00.000","Salt Lake","UT","Passenger","1","2","3","132","135","2.222222222222222222222222222"
"2021-12-31T00:00:00.000","Albemarle","VA","Passenger","1","0","1","17","18","5.555555555555555555555555556"
"2021-12-31T00:00:00.000","Alexandria","VA","Passenger","4","0","4","124","128","3.12500"
"2021-12-31T00:00:00.000","Chesapeake","VA","Passenger","1","3","4","363","367","1.089918256130790190735694823"
"2021-12-31T00:00:00.000","Danville","VA","Passenger","1","0","1","0","1","100"
"2021-12-31T00:00:00.000","Fairfax","VA","Passenger","3","4","7","623","630","1.111111111111111111111111111"
"2021-12-31T00:00:00.000","Goochland","VA","Passenger","3","0","3","136","139","2.158273381294964028776978417"
"2021-12-31T00:00:00.000","Loudoun","VA","Passenger","1","0","1","57","58","1.724137931034482758620689655"
"2021-12-31T00:00:00.000","Louisa","VA","Passenger","0","1","1","0","1","100"
"2021-12-31T00:00:00.000","Manassas","VA","Passenger","0","1","1","5","6","16.66666666666666666666666667"
"2021-12-31T00:00:00.000","Norfolk","VA","Passenger","1","1","2","298","300","0.6666666666666666666666666667"
"2021-12-31T00:00:00.000","Portsmouth","VA","Passenger","1","1","2","62","64","3.12500"
"2021-12-31T00:00:00.000","Powhatan","VA","Passenger","1","0","1","1","2","50.0"
"2021-12-31T00:00:00.000","Prince William","VA","Passenger","1","1","2","187","189","1.058201058201058201058201058"
"2021-12-31T00:00:00.000","Stafford","VA","Passenger","2","1","3","89","92","3.260869565217391304347826087"
"2021-12-31T00:00:00.000","Suffolk","VA","Passenger","1","0","1","103","104","0.9615384615384615384615384615"
"2021-12-31T00:00:00.000","Virginia Beach","VA","Passenger","2","0","2","510","512","0.39062500"
"2021-12-31T00:00:00.000","Adams","WA","Passenger","17","16","33","13085","13118","0.2515627382222899832291507852"
"2021-12-31T00:00:00.000","Adams","WA","Truck","0","0","0","5424","5424","0"
"2021-12-31T00:00:00.000","Asotin","WA","Truck","2","0","2","6763","6765","0.02956393200295639320029563932"
"2021-12-31T00:00:00.000","Asotin","WA","Passenger","23","18","41","12745","12786","0.3206632254027842953230095417"
"2021-12-31T00:00:00.000","Benton","WA","Truck","28","0","28","43719","43747","0.06400438887237982033053695111"
"2021-12-31T00:00:00.000","Benton","WA","Passenger","650","454","1104","136208","137312","0.8040083896527615940340247029"
"2021-12-31T00:00:00.000","Chelan","WA","Truck","10","0","10","23110","23120","0.04325259515570934256055363322"
"2021-12-31T00:00:00.000","Chelan","WA","Passenger","416","114","530","54709","55239","0.9594670432122232480674885498"
"2021-12-31T00:00:00.000","Clallam","WA","Truck","4","0","4","22131","22135","0.01807092839394623898802800994"
"2021-12-31T00:00:00.000","Clallam","WA","Passenger","394","245","639","50416","51055","1.251591421016550778572128097"
"2021-12-31T00:00:00.000","Clark","WA","Passenger","3581","1609","5190","320485","325675","1.593613264757810700852076457"
"2021-12-31T00:00:00.000","Clark","WA","Truck","59","0","59","83991","84050","0.07019631171921475312314098751"
"2021-12-31T00:00:00.000","Columbia","WA","Truck","2","0","2","1555","1557","0.1284521515735388567758509955"
"2021-12-31T00:00:00.000","Columbia","WA","Passenger","6","2","8","2454","2462","0.3249390739236393176279447604"
"2021-12-31T00:00:00.000","Cowlitz","WA","Passenger","288","171","459","71605","72064","0.6369338365896980461811722913"
"2021-12-31T00:00:00.000","Cowlitz","WA","Truck","10","1","11","29018","29029","0.03789314134141720348616900341"
"2021-12-31T00:00:00.000","Douglas","WA","Passenger","116","57","173","28628","28801","0.6006735877226485191486406722"
"2021-12-31T00:00:00.000","Douglas","WA","Truck","4","0","4","12708","12712","0.03146633102580239144115796098"
"2021-12-31T00:00:00.000","Ferry","WA","Truck","0","0","0","3598","3598","0"
"2021-12-31T00:00:00.000","Ferry","WA","Passenger","14","3","17","4450","4467","0.3805686142825162301320796955"
"2021-12-31T00:00:00.000","Franklin","WA","Passenger","167","109","276","62352","62628","0.4406974516190841157309829469"
"2021-12-31T00:00:00.000","Franklin","WA","Truck","9","0","9","20851","20860","0.04314477468839884947267497603"
"2021-12-31T00:00:00.000","Garfield","WA","Truck","0","0","0","1000","1000","0"
"2021-12-31T00:00:00.000","Garfield","WA","Passenger","0","3","3","1354","1357","0.2210759027266028002947678703"
"2021-12-31T00:00:00.000","Grant","WA","Passenger","142","104","246","67017","67263","0.3657285580482583292449043308"
"2021-12-31T00:00:00.000","Grant","WA","Truck","7","0","7","28012","28019","0.02498304721795924194296727221"
"2021-12-31T00:00:00.000","Grays Harbor","WA","Truck","11","0","11","21387","21398","0.05140667352088980278530703804"
"2021-12-31T00:00:00.000","Grays Harbor","WA","Passenger","206","165","371","49478","49849","0.7442476278360649160464603101"
"2021-12-31T00:00:00.000","Island","WA","Passenger","729","357","1086","62987","64073","1.694941707115321586315608759"
"2021-12-31T00:00:00.000","Island","WA","Truck","12","0","12","21560","21572","0.05562766549230483960689783052"
"2021-12-31T00:00:00.000","Jefferson","WA","Truck","3","0","3","9607","9610","0.03121748178980228928199791883"
"2021-12-31T00:00:00.000","Jefferson","WA","Passenger","390","204","594","24771","25365","2.341809580130100532229450030"
"2021-12-31T00:00:00.000","King","WA","Passenger","35911","10505","46416","1360205","1406621","3.299822766758067738218041676"
"2021-12-31T00:00:00.000","King","WA","Truck","207","1","208","183011","183219","0.1135253439872502305983549741"
"2021-12-31T00:00:00.000","Kitsap","WA","Passenger","2207","995","3202","180570","183772","1.742376422958883834316435583"
"2021-12-31T00:00:00.000","Kitsap","WA","Truck","40","0","40","54304","54344","0.07360518180479905785367289857"
"2021-12-31T00:00:00.000","Kittitas","WA","Passenger","214","77","291","29850","30141","0.9654623270628048173584154474"
"2021-12-31T00:00:00.000","Kittitas","WA","Truck","4","0","4","14797","14801","0.02702520099993243699750016891"
"2021-12-31T00:00:00.000","Klickitat","WA","Passenger","91","54","145","15359","15504","0.9352425180598555211558307534"
"2021-12-31T00:00:00.000","Klickitat","WA","Truck","2","0","2","8339","8341","0.02397794029492866562762258722"
"2021-12-31T00:00:00.000","Lewis","WA","Truck","7","0","7","26704","26711","0.02620643180712066189959192842"
"2021-12-31T00:00:00.000","Lewis","WA","Passenger","217","172","389","59640","60029","0.6480201236069233203951423479"
"2021-12-31T00:00:00.000","Lincoln","WA","Passenger","9","16","25","7727","7752","0.3224974200206398348813209494"
"2021-12-31T00:00:00.000","Lincoln","WA","Truck","0","0","0","4828","4828","0"
"2021-12-31T00:00:00.000","Mason","WA","Passenger","286","166","452","47783","48235","0.9370788846273452886907846999"
"2021-12-31T00:00:00.000","Mason","WA","Truck","10","0","10","21225","21235","0.04709206498704968212856133741"
"2021-12-31T00:00:00.000","Okanogan","WA","Passenger","70","46","116","26618","26734","0.4339043914116854941273284955"
"2021-12-31T00:00:00.000","Okanogan","WA","Truck","2","0","2","16700","16702","0.01197461381870434678481618968"
"2021-12-31T00:00:00.000","Pacific","WA","Passenger","60","67","127","16068","16195","0.7841926520531028095091077493"
"2021-12-31T00:00:00.000","Pacific","WA","Truck","2","0","2","8019","8021","0.02493454681461164443336242364"
"2021-12-31T00:00:00.000","Pend Oreille","WA","Passenger","18","9","27","9139","9166","0.2945668775910975343661357190"
"2021-12-31T00:00:00.000","Pend Oreille","WA","Truck","1","0","1","5701","5702","0.01753770606804629954401964223"
"2021-12-31T00:00:00.000","Pierce","WA","Truck","78","0","78","144983","145061","0.05377048276242408366135625702"
"2021-12-31T00:00:00.000","Pierce","WA","Passenger","4454","2216","6670","556628","563298","1.184097937503772425962811869"
"2021-12-31T00:00:00.000","San Juan","WA","Passenger","480","150","630","14203","14833","4.247286455875412930627654554"
"2021-12-31T00:00:00.000","San Juan","WA","Truck","0","0","0","6007","6007","0"
"2021-12-31T00:00:00.000","Skagit","WA","Passenger","721","325","1046","91176","92222","1.134219600529157901585305025"
"2021-12-31T00:00:00.000","Skagit","WA","Truck","22","0","22","32709","32731","0.06721456722984326785005041093"
"2021-12-31T00:00:00.000","Skamania","WA","Truck","0","0","0","4002","4002","0"
"2021-12-31T00:00:00.000","Skamania","WA","Passenger","63","43","106","8326","8432","1.257115749525616698292220114"
"2021-12-31T00:00:00.000","Snohomish","WA","Truck","95","0","95","125462","125557","0.07566284635663483517446259468"
"2021-12-31T00:00:00.000","Snohomish","WA","Passenger","7178","2336","9514","537764","547278","1.738421789291731076345111625"
"2021-12-31T00:00:00.000","Spokane","WA","Truck","51","0","51","102877","102928","0.04954919944038551220270480336"
"2021-12-31T00:00:00.000","Spokane","WA","Passenger","1353","796","2149","327710","329859","0.6514904853285797871211638912"
"2021-12-31T00:00:00.000","Stevens","WA","Passenger","58","44","102","30319","30421","0.3352946977416915946221360245"
"2021-12-31T00:00:00.000","Stevens","WA","Truck","2","0","2","18947","18949","0.01055464668320227980368357169"
"2021-12-31T00:00:00.000","Thurston","WA","Passenger","1956","1015","2971","197214","200185","1.484127182356320403626645353"
"2021-12-31T00:00:00.000","Thurston","WA","Truck","44","0","44","56126","56170","0.07833363005162898344311910272"
"2021-12-31T00:00:00.000","Wahkiakum","WA","Truck","0","0","0","1825","1825","0"
"2021-12-31T00:00:00.000","Wahkiakum","WA","Passenger","17","11","28","3083","3111","0.9000321440051430408228865317"
"2021-12-31T00:00:00.000","Walla Walla","WA","Truck","7","0","7","14104","14111","0.04960668981645524767911558359"
"2021-12-31T00:00:00.000","Walla Walla","WA","Passenger","143","91","234","36415","36649","0.6384894540096591994324538187"
"2021-12-31T00:00:00.000","Whatcom","WA","Passenger","1696","700","2396","150082","152478","1.571374231036608559923398785"
"2021-12-31T00:00:00.000","Whatcom","WA","Truck","30","0","30","43715","43745","0.06857926620185164018744999429"
"2021-12-31T00:00:00.000","Whitman","WA","Passenger","69","63","132","22027","22159","0.5956947515682115618935872557"
"2021-12-31T00:00:00.000","Whitman","WA","Truck","5","0","5","8564","8569","0.05834986579530867079005718287"
"2021-12-31T00:00:00.000","Yakima","WA","Passenger","301","185","486","168883","169369","0.2869474343002556548128642195"
"2021-12-31T00:00:00.000","Yakima","WA","Truck","6","0","6","61810","61816","0.009706224925585608903843665071"
"2021-12-31T00:00:00.000","Douglas","WI","Passenger","1","0","1","1","2","50.0"
"2021-12-31T00:00:00.000","Ozaukee","WI","Passenger","0","1","1","2","3","33.33333333333333333333333333"
"2022-01-31T00:00:00.000","Anchorage","AK","Passenger","1","0","1","113","114","0.8771929824561403508771929825"
"2022-01-31T00:00:00.000","Fairbanks North Star","AK","Passenger","0","1","1","73","74","1.351351351351351351351351351"
"2022-01-31T00:00:00.000","Juneau","AK","Passenger","0","1","1","26","27","3.703703703703703703703703704"
"2022-01-31T00:00:00.000","Maricopa","AZ","Passenger","4","3","7","799","806","0.8684863523573200992555831266"
"2022-01-31T00:00:00.000","Pima","AZ","Passenger","1","1","2","215","217","0.9216589861751152073732718894"
"2022-01-31T00:00:00.000","Pinal","AZ","Passenger","1","0","1","96","97","1.030927835051546391752577320"
"2022-01-31T00:00:00.000","Alameda","CA","Passenger","4","0","4","187","191","2.094240837696335078534031414"
"2022-01-31T00:00:00.000","Contra Costa","CA","Passenger","1","6","7","300","307","2.280130293159609120521172638"
"2022-01-31T00:00:00.000","Fresno","CA","Passenger","1","0","1","139","140","0.7142857142857142857142857143"
"2022-01-31T00:00:00.000","Kern","CA","Passenger","1","1","2","174","176","1.136363636363636363636363636"
"2022-01-31T00:00:00.000","Kings","CA","Passenger","1","0","1","307","308","0.3246753246753246753246753247"
"2022-01-31T00:00:00.000","Los Angeles","CA","Passenger","5","5","10","712","722","1.385041551246537396121883657"
"2022-01-31T00:00:00.000","Marin","CA","Passenger","0","1","1","31","32","3.12500"
"2022-01-31T00:00:00.000","Monterey","CA","Passenger","1","1","2","126","128","1.562500"
"2022-01-31T00:00:00.000","Orange","CA","Passenger","5","2","7","357","364","1.923076923076923076923076923"
"2022-01-31T00:00:00.000","Placer","CA","Passenger","1","0","1","60","61","1.639344262295081967213114754"
"2022-01-31T00:00:00.000","Riverside","CA","Passenger","6","1","7","428","435","1.609195402298850574712643678"
"2022-01-31T00:00:00.000","Sacramento","CA","Passenger","1","0","1","190","191","0.5235602094240837696335078534"
"2022-01-31T00:00:00.000","San Bernardino","CA","Passenger","1","2","3","329","332","0.9036144578313253012048192771"
"2022-01-31T00:00:00.000","San Diego","CA","Passenger","15","9","24","2292","2316","1.036269430051813471502590674"
"2022-01-31T00:00:00.000","San Francisco","CA","Passenger","0","1","1","61","62","1.612903225806451612903225806"
"2022-01-31T00:00:00.000","San Joaquin","CA","Passenger","0","1","1","84","85","1.176470588235294117647058824"
"2022-01-31T00:00:00.000","San Luis Obispo","CA","Passenger","1","0","1","48","49","2.040816326530612244897959184"
"2022-01-31T00:00:00.000","Santa Barbara","CA","Passenger","1","0","1","65","66","1.515151515151515151515151515"
"2022-01-31T00:00:00.000","Santa Clara","CA","Passenger","4","1","5","194","199","2.512562814070351758793969849"
"2022-01-31T00:00:00.000","Santa Cruz","CA","Passenger","1","0","1","19","20","5.00"
"2022-01-31T00:00:00.000","Solano","CA","Passenger","1","0","1","168","169","0.5917159763313609467455621302"
"2022-01-31T00:00:00.000","Sonoma","CA","Passenger","0","1","1","71","72","1.388888888888888888888888889"
"2022-01-31T00:00:00.000","Ventura","CA","Passenger","2","1","3","228","231","1.298701298701298701298701299"
"2022-01-31T00:00:00.000","Boulder","CO","Passenger","1","1","2","23","25","8.00"
"2022-01-31T00:00:00.000","El Paso","CO","Passenger","2","0","2","583","585","0.3418803418803418803418803419"
"2022-01-31T00:00:00.000","Larimer","CO","Passenger","1","0","1","39","40","2.500"
"2022-01-31T00:00:00.000","Las Animas","CO","Passenger","1","0","1","0","1","100"
"2022-01-31T00:00:00.000","New London","CT","Passenger","0","4","4","215","219","1.826484018264840182648401826"
"2022-01-31T00:00:00.000","District of Columbia","DC","Passenger","4","2","6","183","189","3.174603174603174603174603175"
"2022-01-31T00:00:00.000","Kent","DE","Passenger","0","1","1","53","54","1.851851851851851851851851852"
"2022-01-31T00:00:00.000","New Castle","DE","Passenger","1","0","1","21","22","4.545454545454545454545454545"
"2022-01-31T00:00:00.000","Broward","FL","Passenger","1","0","1","80","81","1.234567901234567901234567901"
"2022-01-31T00:00:00.000","Duval","FL","Passenger","0","1","1","263","264","0.3787878787878787878787878788"
"2022-01-31T00:00:00.000","Hillsborough","FL","Passenger","0","1","1","119","120","0.8333333333333333333333333333"
"2022-01-31T00:00:00.000","Lake","FL","Passenger","1","0","1","18","19","5.263157894736842105263157895"
"2022-01-31T00:00:00.000","Okaloosa","FL","Passenger","0","1","1","90","91","1.098901098901098901098901099"
"2022-01-31T00:00:00.000","Orange","FL","Passenger","1","0","1","85","86","1.162790697674418604651162791"
"2022-01-31T00:00:00.000","Palm Beach","FL","Passenger","1","0","1","40","41","2.439024390243902439024390244"
"2022-01-31T00:00:00.000","Pinellas","FL","Passenger","0","1","1","69","70","1.428571428571428571428571429"
"2022-01-31T00:00:00.000","Sarasota","FL","Passenger","2","0","2","25","27","7.407407407407407407407407407"
"2022-01-31T00:00:00.000","St. Johns","FL","Passenger","0","1","1","30","31","3.225806451612903225806451613"
"2022-01-31T00:00:00.000","Bartow","GA","Passenger","0","1","1","2","3","33.33333333333333333333333333"
"2022-01-31T00:00:00.000","Bryan","GA","Passenger","1","0","1","43","44","2.272727272727272727272727273"
"2022-01-31T00:00:00.000","Columbia","GA","Passenger","1","1","2","93","95","2.105263157894736842105263158"
"2022-01-31T00:00:00.000","DeKalb","GA","Passenger","1","0","1","43","44","2.272727272727272727272727273"
"2022-01-31T00:00:00.000","Houston","GA","Passenger","1","0","1","38","39","2.564102564102564102564102564"
"2022-01-31T00:00:00.000","Liberty","GA","Passenger","1","0","1","99","100","1.00"
"2022-01-31T00:00:00.000","Rockdale","GA","Passenger","1","0","1","6","7","14.28571428571428571428571429"
"2022-01-31T00:00:00.000","Honolulu","HI","Passenger","4","2","6","307","313","1.916932907348242811501597444"
"2022-01-31T00:00:00.000","Champaign","IL","Passenger","1","0","1","9","10","10.0"
"2022-01-31T00:00:00.000","Cook","IL","Passenger","2","0","2","154","156","1.282051282051282051282051282"
"2022-01-31T00:00:00.000","DuPage","IL","Passenger","1","0","1","40","41","2.439024390243902439024390244"
"2022-01-31T00:00:00.000","Lake","IL","Passenger","4","0","4","152","156","2.564102564102564102564102564"
"2022-01-31T00:00:00.000","St. Clair","IL","Passenger","2","0","2","113","115","1.739130434782608695652173913"
"2022-01-31T00:00:00.000","Hamilton","IN","Passenger","2","0","2","21","23","8.695652173913043478260869565"
"2022-01-31T00:00:00.000","Howard","IN","Passenger","0","1","1","6","7","14.28571428571428571428571429"
"2022-01-31T00:00:00.000","Vigo","IN","Passenger","1","0","1","4","5","20.0"
"2022-01-31T00:00:00.000","Geary","KS","Passenger","1","0","1","82","83","1.204819277108433734939759036"
"2022-01-31T00:00:00.000","Leavenworth","KS","Passenger","1","1","2","102","104","1.923076923076923076923076923"
"2022-01-31T00:00:00.000","Oldham","KY","Passenger","0","1","1","4","5","20.0"
"2022-01-31T00:00:00.000","Plaquemines","LA","Passenger","0","1","1","15","16","6.2500"
"2022-01-31T00:00:00.000","Middlesex","MA","Passenger","0","1","1","79","80","1.2500"
"2022-01-31T00:00:00.000","Suffolk","MA","Passenger","0","2","2","28","30","6.666666666666666666666666667"
"2022-01-31T00:00:00.000","Anne Arundel","MD","Passenger","4","3","7","337","344","2.034883720930232558139534884"
"2022-01-31T00:00:00.000","Baltimore","MD","Passenger","1","0","1","67","68","1.470588235294117647058823529"
"2022-01-31T00:00:00.000","Calvert","MD","Passenger","0","2","2","77","79","2.531645569620253164556962025"
"2022-01-31T00:00:00.000","Carroll","MD","Passenger","0","1","1","11","12","8.333333333333333333333333333"
"2022-01-31T00:00:00.000","Charles","MD","Truck","1","0","1","9","10","10.0"
"2022-01-31T00:00:00.000","Charles","MD","Passenger","1","1","2","59","61","3.278688524590163934426229508"
"2022-01-31T00:00:00.000","Frederick","MD","Passenger","2","1","3","70","73","4.109589041095890410958904110"
"2022-01-31T00:00:00.000","Howard","MD","Passenger","0","1","1","55","56","1.785714285714285714285714286"
"2022-01-31T00:00:00.000","Montgomery","MD","Passenger","2","5","7","190","197","3.553299492385786802030456853"
"2022-01-31T00:00:00.000","Prince George's","MD","Passenger","1","0","1","124","125","0.800"
"2022-01-31T00:00:00.000","St. Mary's","MD","Truck","1","0","1","41","42","2.380952380952380952380952381"
"2022-01-31T00:00:00.000","St. Mary's","MD","Passenger","1","0","1","173","174","0.5747126436781609195402298851"
"2022-01-31T00:00:00.000","Washington","MD","Passenger","2","0","2","11","13","15.38461538461538461538461538"
"2022-01-31T00:00:00.000","Penobscot","ME","Passenger","0","1","1","8","9","11.11111111111111111111111111"
"2022-01-31T00:00:00.000","Hennepin","MN","Passenger","1","0","1","52","53","1.886792452830188679245283019"
"2022-01-31T00:00:00.000","Kanabec","MN","Passenger","1","0","1","0","1","100"
"2022-01-31T00:00:00.000","Boone","MO","Passenger","0","1","1","9","10","10.0"
"2022-01-31T00:00:00.000","Greene","MO","Passenger","0","1","1","17","18","5.555555555555555555555555556"
"2022-01-31T00:00:00.000","Platte","MO","Passenger","1","0","1","15","16","6.2500"
"2022-01-31T00:00:00.000","Ray","MO","Passenger","0","1","1","0","1","100"
"2022-01-31T00:00:00.000","St. Louis","MO","Passenger","1","0","1","71","72","1.388888888888888888888888889"
"2022-01-31T00:00:00.000","Harrison","MS","Passenger","2","0","2","44","46","4.347826086956521739130434783"
"2022-01-31T00:00:00.000","Flathead","MT","Passenger","1","0","1","31","32","3.12500"
"2022-01-31T00:00:00.000","Glacier","MT","Passenger","0","1","1","5","6","16.66666666666666666666666667"
"2022-01-31T00:00:00.000","Cumberland","NC","Truck","1","0","1","86","87","1.149425287356321839080459770"
"2022-01-31T00:00:00.000","Cumberland","NC","Passenger","0","2","2","379","381","0.5249343832020997375328083990"
"2022-01-31T00:00:00.000","Harnett","NC","Passenger","0","1","1","141","142","0.7042253521126760563380281690"
"2022-01-31T00:00:00.000","Mecklenburg","NC","Passenger","1","0","1","60","61","1.639344262295081967213114754"
"2022-01-31T00:00:00.000","Moore","NC","Passenger","0","1","1","122","123","0.8130081300813008130081300813"
"2022-01-31T00:00:00.000","Onslow","NC","Passenger","0","1","1","149","150","0.6666666666666666666666666667"
"2022-01-31T00:00:00.000","Wake","NC","Passenger","1","0","1","85","86","1.162790697674418604651162791"
"2022-01-31T00:00:00.000","Wayne","NC","Passenger","1","0","1","26","27","3.703703703703703703703703704"
"2022-01-31T00:00:00.000","Wilson","NC","Passenger","1","0","1","1","2","50.0"
"2022-01-31T00:00:00.000","Williams","ND","Passenger","0","1","1","8","9","11.11111111111111111111111111"
"2022-01-31T00:00:00.000","Douglas","NE","Passenger","1","2","3","44","47","6.382978723404255319148936170"
"2022-01-31T00:00:00.000","Sarpy","NE","Passenger","1","0","1","51","52","1.923076923076923076923076923"
"2022-01-31T00:00:00.000","Carroll","NH","Passenger","0","1","1","3","4","25.00"
"2022-01-31T00:00:00.000","Burlington","NJ","Passenger","0","1","1","118","119","0.8403361344537815126050420168"
"2022-01-31T00:00:00.000","Camden","NJ","Passenger","0","1","1","9","10","10.0"
"2022-01-31T00:00:00.000","Hudson","NJ","Passenger","1","0","1","87","88","1.136363636363636363636363636"
"2022-01-31T00:00:00.000","Hudson","NJ","Truck","1","0","1","10","11","9.090909090909090909090909091"
"2022-01-31T00:00:00.000","Chaves","NM","Passenger","1","0","1","4","5","20.0"
"2022-01-31T00:00:00.000","Carson City","NV","Passenger","1","0","1","8","9","11.11111111111111111111111111"
"2022-01-31T00:00:00.000","Clark","NV","Passenger","5","4","9","509","518","1.737451737451737451737451737"
"2022-01-31T00:00:00.000","Washoe","NV","Passenger","1","0","1","57","58","1.724137931034482758620689655"
"2022-01-31T00:00:00.000","Erie","NY","Passenger","1","0","1","23","24","4.166666666666666666666666667"
"2022-01-31T00:00:00.000","Jefferson","NY","Passenger","0","1","1","186","187","0.5347593582887700534759358289"
"2022-01-31T00:00:00.000","Kings","NY","Passenger","1","0","1","53","54","1.851851851851851851851851852"
"2022-01-31T00:00:00.000","New York","NY","Passenger","1","0","1","41","42","2.380952380952380952380952381"
"2022-01-31T00:00:00.000","Queens","NY","Passenger","1","0","1","40","41","2.439024390243902439024390244"
"2022-01-31T00:00:00.000","Saratoga","NY","Passenger","1","0","1","37","38","2.631578947368421052631578947"
"2022-01-31T00:00:00.000","Hamilton","OH","Passenger","1","0","1","26","27","3.703703703703703703703703704"
"2022-01-31T00:00:00.000","Shelby","OH","Passenger","0","1","1","2","3","33.33333333333333333333333333"
"2022-01-31T00:00:00.000","Rogers","OK","Passenger","1","0","1","2","3","33.33333333333333333333333333"
"2022-01-31T00:00:00.000","Clackamas","OR","Passenger","2","0","2","134","136","1.470588235294117647058823529"
"2022-01-31T00:00:00.000","Klamath","OR","Passenger","1","0","1","19","20","5.00"
"2022-01-31T00:00:00.000","Lincoln","OR","Passenger","0","1","1","31","32","3.12500"
"2022-01-31T00:00:00.000","Multnomah","OR","Passenger","1","3","4","500","504","0.7936507936507936507936507937"
"2022-01-31T00:00:00.000","Yamhill","OR","Passenger","1","0","1","23","24","4.166666666666666666666666667"
"2022-01-31T00:00:00.000","Allegheny","PA","Passenger","1","1","2","45","47","4.255319148936170212765957447"
"2022-01-31T00:00:00.000","Montgomery","PA","Passenger","2","0","2","14","16","12.500"
"2022-01-31T00:00:00.000","Philadelphia","PA","Passenger","1","0","1","34","35","2.857142857142857142857142857"
"2022-01-31T00:00:00.000","RÃ­o Grande","PR","Passenger","1","0","1","0","1","100"
"2022-01-31T00:00:00.000","Newport","RI","Passenger","1","0","1","75","76","1.315789473684210526315789474"
"2022-01-31T00:00:00.000","Newport","RI","Truck","1","0","1","12","13","7.692307692307692307692307692"
"2022-01-31T00:00:00.000","Charleston","SC","Passenger","1","0","1","66","67","1.492537313432835820895522388"
"2022-01-31T00:00:00.000","Richland","SC","Passenger","0","1","1","118","119","0.8403361344537815126050420168"
"2022-01-31T00:00:00.000","Spartanburg","SC","Passenger","0","1","1","29","30","3.333333333333333333333333333"
"2022-01-31T00:00:00.000","Sumter","SC","Passenger","0","1","1","30","31","3.225806451612903225806451613"
"2022-01-31T00:00:00.000","Pennington","SD","Passenger","1","0","1","27","28","3.571428571428571428571428571"
"2022-01-31T00:00:00.000","Davidson","TN","Passenger","1","0","1","33","34","2.941176470588235294117647059"
"2022-01-31T00:00:00.000","Montgomery","TN","Passenger","1","0","1","175","176","0.5681818181818181818181818182"
"2022-01-31T00:00:00.000","Tipton","TN","Passenger","1","0","1","12","13","7.692307692307692307692307692"
"2022-01-31T00:00:00.000","Bell","TX","Passenger","0","1","1","299","300","0.3333333333333333333333333333"
"2022-01-31T00:00:00.000","Bexar","TX","Passenger","4","3","7","425","432","1.620370370370370370370370370"
"2022-01-31T00:00:00.000","Coryell","TX","Passenger","1","0","1","97","98","1.020408163265306122448979592"
"2022-01-31T00:00:00.000","Dallas","TX","Passenger","1","0","1","112","113","0.8849557522123893805309734513"
"2022-01-31T00:00:00.000","Denton","TX","Passenger","1","0","1","51","52","1.923076923076923076923076923"
"2022-01-31T00:00:00.000","El Paso","TX","Passenger","1","0","1","321","322","0.3105590062111801242236024845"
"2022-01-31T00:00:00.000","Galveston","TX","Passenger","0","1","1","17","18","5.555555555555555555555555556"
"2022-01-31T00:00:00.000","Harris","TX","Passenger","1","0","1","148","149","0.6711409395973154362416107383"
"2022-01-31T00:00:00.000","Hidalgo","TX","Passenger","0","1","1","54","55","1.818181818181818181818181818"
"2022-01-31T00:00:00.000","Montgomery","TX","Passenger","1","1","2","22","24","8.333333333333333333333333333"
"2022-01-31T00:00:00.000","Nueces","TX","Passenger","1","0","1","55","56","1.785714285714285714285714286"
"2022-01-31T00:00:00.000","Tarrant","TX","Passenger","1","0","1","102","103","0.9708737864077669902912621359"
"2022-01-31T00:00:00.000","Wichita","TX","Passenger","1","0","1","38","39","2.564102564102564102564102564"
"2022-01-31T00:00:00.000","Williamson","TX","Passenger","1","0","1","76","77","1.298701298701298701298701299"
"2022-01-31T00:00:00.000","Salt Lake","UT","Passenger","2","2","4","128","132","3.030303030303030303030303030"
"2022-01-31T00:00:00.000","Albemarle","VA","Passenger","1","0","1","17","18","5.555555555555555555555555556"
"2022-01-31T00:00:00.000","Alexandria","VA","Passenger","4","0","4","120","124","3.225806451612903225806451613"
"2022-01-31T00:00:00.000","Chesapeake","VA","Passenger","1","3","4","356","360","1.111111111111111111111111111"
"2022-01-31T00:00:00.000","Danville","VA","Passenger","1","0","1","0","1","100"
"2022-01-31T00:00:00.000","Fairfax","VA","Passenger","3","3","6","613","619","0.9693053311793214862681744750"
"2022-01-31T00:00:00.000","Goochland","VA","Passenger","3","0","3","128","131","2.290076335877862595419847328"
"2022-01-31T00:00:00.000","Loudoun","VA","Passenger","1","0","1","57","58","1.724137931034482758620689655"
"2022-01-31T00:00:00.000","Louisa","VA","Passenger","0","1","1","0","1","100"
"2022-01-31T00:00:00.000","Manassas","VA","Passenger","0","1","1","5","6","16.66666666666666666666666667"
"2022-01-31T00:00:00.000","Norfolk","VA","Passenger","1","1","2","292","294","0.6802721088435374149659863946"
"2022-01-31T00:00:00.000","Portsmouth","VA","Passenger","1","1","2","62","64","3.12500"
"2022-01-31T00:00:00.000","Powhatan","VA","Passenger","1","0","1","1","2","50.0"
"2022-01-31T00:00:00.000","Prince William","VA","Truck","1","0","1","25","26","3.846153846153846153846153846"
"2022-01-31T00:00:00.000","Prince William","VA","Passenger","1","1","2","188","190","1.052631578947368421052631579"
"2022-01-31T00:00:00.000","Stafford","VA","Passenger","2","1","3","87","90","3.333333333333333333333333333"
"2022-01-31T00:00:00.000","Suffolk","VA","Passenger","1","0","1","99","100","1.00"
"2022-01-31T00:00:00.000","Virginia Beach","VA","Passenger","2","0","2","507","509","0.3929273084479371316306483301"
"2022-01-31T00:00:00.000","Adams","WA","Passenger","17","16","33","13041","13074","0.2524093620927030748049564020"
"2022-01-31T00:00:00.000","Adams","WA","Truck","1","0","1","5438","5439","0.01838573267144695716124287553"
"2022-01-31T00:00:00.000","Asotin","WA","Truck","2","0","2","6747","6749","0.02963401985479330271151281671"
"2022-01-31T00:00:00.000","Asotin","WA","Passenger","24","18","42","12692","12734","0.3298256635778231506203863672"
"2022-01-31T00:00:00.000","Benton","WA","Truck","33","0","33","43613","43646","0.07560830316638409018008523118"
"2022-01-31T00:00:00.000","Benton","WA","Passenger","665","462","1127","136061","137188","0.8215004227775024054582033414"
"2022-01-31T00:00:00.000","Chelan","WA","Passenger","429","117","546","54610","55156","0.9899195010515628399448836029"
"2022-01-31T00:00:00.000","Chelan","WA","Truck","11","0","11","23062","23073","0.04767477137780089281844580245"
"2022-01-31T00:00:00.000","Clallam","WA","Truck","5","0","5","22144","22149","0.02257438259063614610140412660"
"2022-01-31T00:00:00.000","Clallam","WA","Passenger","401","248","649","50269","50918","1.274598373856003770768686908"
"2022-01-31T00:00:00.000","Clark","WA","Passenger","3646","1619","5265","319620","324885","1.620573433676531695830832448"
"2022-01-31T00:00:00.000","Clark","WA","Truck","73","0","73","83886","83959","0.08694720041925225407639443061"
"2022-01-31T00:00:00.000","Columbia","WA","Truck","2","0","2","1558","1560","0.1282051282051282051282051282"
"2022-01-31T00:00:00.000","Columbia","WA","Passenger","6","2","8","2454","2462","0.3249390739236393176279447604"
"2022-01-31T00:00:00.000","Cowlitz","WA","Passenger","287","172","459","71367","71826","0.6390443571965583493442486008"
"2022-01-31T00:00:00.000","Cowlitz","WA","Truck","10","1","11","28939","28950","0.03799654576856649395509499136"
"2022-01-31T00:00:00.000","Douglas","WA","Passenger","117","57","174","28605","28779","0.6046075263212759303658917961"
"2022-01-31T00:00:00.000","Douglas","WA","Truck","5","0","5","12690","12695","0.03938558487593540764080346593"
"2022-01-31T00:00:00.000","Ferry","WA","Truck","0","0","0","3584","3584","0"
"2022-01-31T00:00:00.000","Ferry","WA","Passenger","14","3","17","4441","4458","0.3813369223867205024674742037"
"2022-01-31T00:00:00.000","Franklin","WA","Truck","9","0","9","20893","20902","0.04305808056645297100755908525"
"2022-01-31T00:00:00.000","Franklin","WA","Passenger","174","106","280","62205","62485","0.4481075458109946387132911899"
"2022-01-31T00:00:00.000","Garfield","WA","Passenger","0","3","3","1360","1363","0.2201027146001467351430667645"
"2022-01-31T00:00:00.000","Garfield","WA","Truck","0","0","0","994","994","0"
"2022-01-31T00:00:00.000","Grant","WA","Passenger","146","106","252","66855","67107","0.3755196924314900084938978050"
"2022-01-31T00:00:00.000","Grant","WA","Truck","8","0","8","28002","28010","0.02856122813280971081756515530"
"2022-01-31T00:00:00.000","Grays Harbor","WA","Truck","12","0","12","21347","21359","0.05618240554333068027529378716"
"2022-01-31T00:00:00.000","Grays Harbor","WA","Passenger","211","166","377","49368","49745","0.7578651120715649814051663484"
"2022-01-31T00:00:00.000","Island","WA","Passenger","750","360","1110","62829","63939","1.736029653263266550931356449"
"2022-01-31T00:00:00.000","Island","WA","Truck","14","0","14","21518","21532","0.06501950585175552665799739922"
"2022-01-31T00:00:00.000","Jefferson","WA","Truck","3","0","3","9581","9584","0.03130217028380634390651085142"
"2022-01-31T00:00:00.000","Jefferson","WA","Passenger","393","207","600","24708","25308","2.370791844476055002370791844"
"2022-01-31T00:00:00.000","King","WA","Passenger","36784","10695","47479","1357448","1404927","3.379463844028906839999515989"
"2022-01-31T00:00:00.000","King","WA","Truck","228","1","229","182624","182853","0.1252372124055935642291895676"
"2022-01-31T00:00:00.000","Kitsap","WA","Passenger","2270","1006","3276","180334","183610","1.784216545939763629431948151"
"2022-01-31T00:00:00.000","Kitsap","WA","Truck","44","0","44","54264","54308","0.08101937099506518376666421153"
"2022-01-31T00:00:00.000","Kittitas","WA","Truck","6","0","6","14773","14779","0.04059814601799851140131267339"
"2022-01-31T00:00:00.000","Kittitas","WA","Passenger","223","73","296","29821","30117","0.9828336155659594249095195405"
"2022-01-31T00:00:00.000","Klickitat","WA","Truck","2","0","2","8340","8342","0.02397506593143131143610644929"
"2022-01-31T00:00:00.000","Klickitat","WA","Passenger","92","55","147","15317","15464","0.9505949301603724780134505949"
"2022-01-31T00:00:00.000","Lewis","WA","Passenger","223","172","395","59534","59929","0.6591132840527958083732416693"
"2022-01-31T00:00:00.000","Lewis","WA","Truck","9","0","9","26678","26687","0.03372428523251021096413984337"
"2022-01-31T00:00:00.000","Lincoln","WA","Truck","0","0","0","4843","4843","0"
"2022-01-31T00:00:00.000","Lincoln","WA","Passenger","8","17","25","7742","7767","0.3218745976567529290588386765"
"2022-01-31T00:00:00.000","Mason","WA","Passenger","293","169","462","47786","48248","0.9575526446692090863870004974"
"2022-01-31T00:00:00.000","Mason","WA","Truck","12","0","12","21190","21202","0.05659843410998962362041316857"
"2022-01-31T00:00:00.000","Okanogan","WA","Truck","2","0","2","16705","16707","0.01197103010714071945890943916"
"2022-01-31T00:00:00.000","Okanogan","WA","Passenger","71","48","119","26551","26670","0.4461942257217847769028871391"
"2022-01-31T00:00:00.000","Pacific","WA","Truck","2","0","2","8025","8027","0.02491590880777376354802541423"
"2022-01-31T00:00:00.000","Pacific","WA","Passenger","64","66","130","16056","16186","0.8031632274805387371802792537"
"2022-01-31T00:00:00.000","Pend Oreille","WA","Truck","1","0","1","5727","5728","0.01745810055865921787709497207"
"2022-01-31T00:00:00.000","Pend Oreille","WA","Passenger","17","9","26","9126","9152","0.2840909090909090909090909091"
"2022-01-31T00:00:00.000","Pierce","WA","Passenger","4587","2242","6829","554981","561810","1.215535501326071091650202026"
"2022-01-31T00:00:00.000","Pierce","WA","Truck","86","0","86","144623","144709","0.05942961391482216033557000601"
"2022-01-31T00:00:00.000","San Juan","WA","Truck","4","0","4","6023","6027","0.06636801061888169902107184337"
"2022-01-31T00:00:00.000","San Juan","WA","Passenger","483","152","635","14180","14815","4.286196422544718191022612217"
"2022-01-31T00:00:00.000","Skagit","WA","Passenger","726","330","1056","90910","91966","1.148250440380140486701607116"
"2022-01-31T00:00:00.000","Skagit","WA","Truck","23","0","23","32663","32686","0.07036651777519427277733586245"
"2022-01-31T00:00:00.000","Skamania","WA","Truck","0","0","0","3991","3991","0"
"2022-01-31T00:00:00.000","Skamania","WA","Passenger","63","44","107","8316","8423","1.270331235901697732399382643"
"2022-01-31T00:00:00.000","Snohomish","WA","Passenger","7375","2377","9752","536940","546692","1.783819774205585594813898868"
"2022-01-31T00:00:00.000","Snohomish","WA","Truck","106","0","106","125302","125408","0.08452411329420770604746108701"
"2022-01-31T00:00:00.000","Spokane","WA","Passenger","1393","801","2194","326995","329189","0.6664864257311149522007114454"
"2022-01-31T00:00:00.000","Spokane","WA","Truck","56","0","56","102742","102798","0.05447576801105079865367030487"
"2022-01-31T00:00:00.000","Stevens","WA","Passenger","61","47","108","30217","30325","0.3561417971970321516900247321"
"2022-01-31T00:00:00.000","Stevens","WA","Truck","2","0","2","18942","18944","0.01055743243243243243243243243"
"2022-01-31T00:00:00.000","Thurston","WA","Passenger","2007","1023","3030","196881","199911","1.515674475141437939883248045"
"2022-01-31T00:00:00.000","Thurston","WA","Truck","47","0","47","56013","56060","0.08383874420264002854084909026"
"2022-01-31T00:00:00.000","Wahkiakum","WA","Passenger","17","12","29","3076","3105","0.9339774557165861513687600644"
"2022-01-31T00:00:00.000","Wahkiakum","WA","Truck","0","0","0","1817","1817","0"
"2022-01-31T00:00:00.000","Walla Walla","WA","Passenger","146","93","239","36320","36559","0.6537377937033288656691922646"
"2022-01-31T00:00:00.000","Walla Walla","WA","Truck","7","0","7","14120","14127","0.04955050612302682805974375310"
"2022-01-31T00:00:00.000","Whatcom","WA","Truck","29","0","29","43628","43657","0.06642691893625306365531300822"
"2022-01-31T00:00:00.000","Whatcom","WA","Passenger","1719","698","2417","149604","152021","1.589911920063675413265272561"
"2022-01-31T00:00:00.000","Whitman","WA","Passenger","71","61","132","22019","22151","0.5959098912013001670353482913"
"2022-01-31T00:00:00.000","Whitman","WA","Truck","5","0","5","8570","8575","0.05830903790087463556851311953"
"2022-01-31T00:00:00.000","Yakima","WA","Passenger","309","189","498","168409","168907","0.2948368036848680042863824471"
"2022-01-31T00:00:00.000","Yakima","WA","Truck","6","0","6","61634","61640","0.009733939000648929266709928618"
"2022-01-31T00:00:00.000","Douglas","WI","Passenger","1","0","1","1","2","50.0"
"2022-01-31T00:00:00.000","Ozaukee","WI","Passenger","0","1","1","2","3","33.33333333333333333333333333"
"2022-02-28T00:00:00.000","Anchorage","AK","Passenger","1","0","1","111","112","0.8928571428571428571428571429"
"2022-02-28T00:00:00.000","Fairbanks North Star","AK","Passenger","0","1","1","73","74","1.351351351351351351351351351"
"2022-02-28T00:00:00.000","Juneau","AK","Passenger","0","1","1","26","27","3.703703703703703703703703704"
"2022-02-28T00:00:00.000","Maricopa","AZ","Passenger","4","3","7","766","773","0.9055627425614489003880983182"
"2022-02-28T00:00:00.000","Pima","AZ","Passenger","1","1","2","208","210","0.9523809523809523809523809524"
"2022-02-28T00:00:00.000","Pinal","AZ","Passenger","1","0","1","92","93","1.075268817204301075268817204"
"2022-02-28T00:00:00.000","Alameda","CA","Passenger","3","0","3","181","184","1.630434782608695652173913043"
"2022-02-28T00:00:00.000","Contra Costa","CA","Passenger","1","6","7","304","311","2.250803858520900321543408360"
"2022-02-28T00:00:00.000","Fresno","CA","Passenger","1","0","1","137","138","0.7246376811594202898550724638"
"2022-02-28T00:00:00.000","Kern","CA","Passenger","1","1","2","175","177","1.129943502824858757062146893"
"2022-02-28T00:00:00.000","Kings","CA","Passenger","1","0","1","301","302","0.3311258278145695364238410596"
"2022-02-28T00:00:00.000","Los Angeles","CA","Passenger","5","5","10","697","707","1.414427157001414427157001414"
"2022-02-28T00:00:00.000","Marin","CA","Passenger","0","1","1","31","32","3.12500"
"2022-02-28T00:00:00.000","Monterey","CA","Passenger","1","1","2","122","124","1.612903225806451612903225806"
"2022-02-28T00:00:00.000","Orange","CA","Passenger","5","2","7","343","350","2.00"
"2022-02-28T00:00:00.000","Placer","CA","Passenger","1","0","1","59","60","1.666666666666666666666666667"
"2022-02-28T00:00:00.000","Riverside","CA","Passenger","6","1","7","414","421","1.662707838479809976247030879"
"2022-02-28T00:00:00.000","Sacramento","CA","Passenger","1","0","1","186","187","0.5347593582887700534759358289"
"2022-02-28T00:00:00.000","San Bernardino","CA","Passenger","1","2","3","317","320","0.937500"
"2022-02-28T00:00:00.000","San Diego","CA","Passenger","14","9","23","2251","2274","1.011433597185576077396657872"
"2022-02-28T00:00:00.000","San Francisco","CA","Passenger","0","1","1","59","60","1.666666666666666666666666667"
"2022-02-28T00:00:00.000","San Joaquin","CA","Passenger","0","1","1","81","82","1.219512195121951219512195122"
"2022-02-28T00:00:00.000","San Luis Obispo","CA","Passenger","1","0","1","48","49","2.040816326530612244897959184"
"2022-02-28T00:00:00.000","Santa Barbara","CA","Passenger","1","0","1","64","65","1.538461538461538461538461538"
"2022-02-28T00:00:00.000","Santa Clara","CA","Passenger","4","1","5","190","195","2.564102564102564102564102564"
"2022-02-28T00:00:00.000","Santa Cruz","CA","Passenger","1","0","1","19","20","5.00"
"2022-02-28T00:00:00.000","Solano","CA","Passenger","1","0","1","165","166","0.6024096385542168674698795181"
"2022-02-28T00:00:00.000","Sonoma","CA","Passenger","0","1","1","70","71","1.408450704225352112676056338"
"2022-02-28T00:00:00.000","Ventura","CA","Passenger","2","1","3","225","228","1.315789473684210526315789474"
"2022-02-28T00:00:00.000","Boulder","CO","Passenger","1","0","1","22","23","4.347826086956521739130434783"
"2022-02-28T00:00:00.000","El Paso","CO","Passenger","2","1","3","565","568","0.5281690140845070422535211268"
"2022-02-28T00:00:00.000","Larimer","CO","Passenger","1","0","1","39","40","2.500"
"2022-02-28T00:00:00.000","Las Animas","CO","Passenger","1","0","1","0","1","100"
"2022-02-28T00:00:00.000","New London","CT","Passenger","0","4","4","210","214","1.869158878504672897196261682"
"2022-02-28T00:00:00.000","District of Columbia","DC","Passenger","4","2","6","181","187","3.208556149732620320855614973"
"2022-02-28T00:00:00.000","Kent","DE","Passenger","0","1","1","51","52","1.923076923076923076923076923"
"2022-02-28T00:00:00.000","New Castle","DE","Passenger","1","0","1","21","22","4.545454545454545454545454545"
"2022-02-28T00:00:00.000","Broward","FL","Passenger","1","0","1","75","76","1.315789473684210526315789474"
"2022-02-28T00:00:00.000","Duval","FL","Passenger","0","1","1","258","259","0.3861003861003861003861003861"
"2022-02-28T00:00:00.000","Hillsborough","FL","Passenger","0","1","1","115","116","0.8620689655172413793103448276"
"2022-02-28T00:00:00.000","Lake","FL","Passenger","1","0","1","18","19","5.263157894736842105263157895"
"2022-02-28T00:00:00.000","Okaloosa","FL","Passenger","0","1","1","87","88","1.136363636363636363636363636"
"2022-02-28T00:00:00.000","Orange","FL","Passenger","1","0","1","80","81","1.234567901234567901234567901"
"2022-02-28T00:00:00.000","Palm Beach","FL","Passenger","1","0","1","39","40","2.500"
"2022-02-28T00:00:00.000","Pinellas","FL","Passenger","0","1","1","66","67","1.492537313432835820895522388"
"2022-02-28T00:00:00.000","Sarasota","FL","Passenger","2","0","2","24","26","7.692307692307692307692307692"
"2022-02-28T00:00:00.000","St. Johns","FL","Passenger","0","1","1","29","30","3.333333333333333333333333333"
"2022-02-28T00:00:00.000","Bartow","GA","Passenger","0","1","1","2","3","33.33333333333333333333333333"
"2022-02-28T00:00:00.000","Bryan","GA","Passenger","1","0","1","42","43","2.325581395348837209302325581"
"2022-02-28T00:00:00.000","Columbia","GA","Passenger","1","1","2","91","93","2.150537634408602150537634409"
"2022-02-28T00:00:00.000","DeKalb","GA","Passenger","1","0","1","40","41","2.439024390243902439024390244"
"2022-02-28T00:00:00.000","Houston","GA","Passenger","1","0","1","37","38","2.631578947368421052631578947"
"2022-02-28T00:00:00.000","Liberty","GA","Passenger","1","0","1","96","97","1.030927835051546391752577320"
"2022-02-28T00:00:00.000","Rockdale","GA","Passenger","1","0","1","6","7","14.28571428571428571428571429"
"2022-02-28T00:00:00.000","Honolulu","HI","Passenger","4","2","6","300","306","1.960784313725490196078431373"
"2022-02-28T00:00:00.000","Champaign","IL","Passenger","1","0","1","9","10","10.0"
"2022-02-28T00:00:00.000","Cook","IL","Passenger","2","0","2","155","157","1.273885350318471337579617834"
"2022-02-28T00:00:00.000","DuPage","IL","Passenger","1","0","1","39","40","2.500"
"2022-02-28T00:00:00.000","Lake","IL","Passenger","4","0","4","149","153","2.614379084967320261437908497"
"2022-02-28T00:00:00.000","Rock Island","IL","Passenger","0","1","1","14","15","6.666666666666666666666666667"
"2022-02-28T00:00:00.000","St. Clair","IL","Passenger","2","0","2","114","116","1.724137931034482758620689655"
"2022-02-28T00:00:00.000","Hamilton","IN","Passenger","2","0","2","21","23","8.695652173913043478260869565"
"2022-02-28T00:00:00.000","Howard","IN","Passenger","0","1","1","6","7","14.28571428571428571428571429"
"2022-02-28T00:00:00.000","Vigo","IN","Passenger","1","0","1","4","5","20.0"
"2022-02-28T00:00:00.000","Geary","KS","Passenger","1","0","1","80","81","1.234567901234567901234567901"
"2022-02-28T00:00:00.000","Leavenworth","KS","Passenger","1","1","2","99","101","1.980198019801980198019801980"
"2022-02-28T00:00:00.000","Oldham","KY","Passenger","0","1","1","4","5","20.0"
"2022-02-28T00:00:00.000","Plaquemines","LA","Passenger","0","1","1","15","16","6.2500"
"2022-02-28T00:00:00.000","Middlesex","MA","Passenger","0","1","1","76","77","1.298701298701298701298701299"
"2022-02-28T00:00:00.000","Suffolk","MA","Passenger","0","2","2","27","29","6.896551724137931034482758621"
"2022-02-28T00:00:00.000","Anne Arundel","MD","Passenger","4","3","7","336","343","2.040816326530612244897959184"
"2022-02-28T00:00:00.000","Baltimore","MD","Passenger","1","0","1","64","65","1.538461538461538461538461538"
"2022-02-28T00:00:00.000","Calvert","MD","Passenger","0","2","2","76","78","2.564102564102564102564102564"
"2022-02-28T00:00:00.000","Carroll","MD","Passenger","0","1","1","11","12","8.333333333333333333333333333"
"2022-02-28T00:00:00.000","Charles","MD","Passenger","0","1","1","55","56","1.785714285714285714285714286"
"2022-02-28T00:00:00.000","Charles","MD","Truck","1","0","1","9","10","10.0"
"2022-02-28T00:00:00.000","Frederick","MD","Passenger","2","1","3","69","72","4.166666666666666666666666667"
"2022-02-28T00:00:00.000","Howard","MD","Passenger","0","1","1","56","57","1.754385964912280701754385965"
"2022-02-28T00:00:00.000","Montgomery","MD","Passenger","2","5","7","187","194","3.608247422680412371134020619"
"2022-02-28T00:00:00.000","Prince George's","MD","Passenger","1","0","1","120","121","0.8264462809917355371900826446"
"2022-02-28T00:00:00.000","St. Mary's","MD","Truck","1","0","1","41","42","2.380952380952380952380952381"
"2022-02-28T00:00:00.000","St. Mary's","MD","Passenger","1","0","1","170","171","0.5847953216374269005847953216"
"2022-02-28T00:00:00.000","Washington","MD","Passenger","2","0","2","11","13","15.38461538461538461538461538"
"2022-02-28T00:00:00.000","Penobscot","ME","Passenger","0","1","1","7","8","12.500"
"2022-02-28T00:00:00.000","Hennepin","MN","Passenger","1","0","1","52","53","1.886792452830188679245283019"
"2022-02-28T00:00:00.000","Kanabec","MN","Passenger","1","0","1","0","1","100"
"2022-02-28T00:00:00.000","Boone","MO","Passenger","0","1","1","9","10","10.0"
"2022-02-28T00:00:00.000","Greene","MO","Passenger","0","1","1","17","18","5.555555555555555555555555556"
"2022-02-28T00:00:00.000","Platte","MO","Passenger","1","0","1","15","16","6.2500"
"2022-02-28T00:00:00.000","Ray","MO","Passenger","0","1","1","0","1","100"
"2022-02-28T00:00:00.000","St. Louis","MO","Passenger","1","0","1","70","71","1.408450704225352112676056338"
"2022-02-28T00:00:00.000","Harrison","MS","Passenger","2","0","2","44","46","4.347826086956521739130434783"
"2022-02-28T00:00:00.000","Flathead","MT","Passenger","1","0","1","31","32","3.12500"
"2022-02-28T00:00:00.000","Glacier","MT","Passenger","0","1","1","5","6","16.66666666666666666666666667"
"2022-02-28T00:00:00.000","Cumberland","NC","Passenger","0","2","2","369","371","0.5390835579514824797843665768"
"2022-02-28T00:00:00.000","Cumberland","NC","Truck","1","0","1","84","85","1.176470588235294117647058824"
"2022-02-28T00:00:00.000","Mecklenburg","NC","Passenger","1","0","1","57","58","1.724137931034482758620689655"
"2022-02-28T00:00:00.000","Moore","NC","Passenger","0","1","1","121","122","0.8196721311475409836065573770"
"2022-02-28T00:00:00.000","Onslow","NC","Passenger","0","1","1","147","148","0.6756756756756756756756756757"
"2022-02-28T00:00:00.000","Wake","NC","Passenger","1","0","1","82","83","1.204819277108433734939759036"
"2022-02-28T00:00:00.000","Wayne","NC","Passenger","1","0","1","26","27","3.703703703703703703703703704"
"2022-02-28T00:00:00.000","Wilson","NC","Passenger","1","0","1","1","2","50.0"
"2022-02-28T00:00:00.000","Williams","ND","Passenger","0","1","1","7","8","12.500"
"2022-02-28T00:00:00.000","Douglas","NE","Passenger","1","2","3","44","47","6.382978723404255319148936170"
"2022-02-28T00:00:00.000","Sarpy","NE","Passenger","1","0","1","49","50","2.00"
"2022-02-28T00:00:00.000","Carroll","NH","Passenger","0","1","1","3","4","25.00"
"2022-02-28T00:00:00.000","Burlington","NJ","Passenger","0","1","1","117","118","0.8474576271186440677966101695"
"2022-02-28T00:00:00.000","Camden","NJ","Passenger","0","1","1","9","10","10.0"
"2022-02-28T00:00:00.000","Hudson","NJ","Truck","1","0","1","10","11","9.090909090909090909090909091"
"2022-02-28T00:00:00.000","Hudson","NJ","Passenger","1","0","1","87","88","1.136363636363636363636363636"
"2022-02-28T00:00:00.000","Chaves","NM","Passenger","1","0","1","4","5","20.0"
"2022-02-28T00:00:00.000","Carson City","NV","Passenger","1","0","1","7","8","12.500"
"2022-02-28T00:00:00.000","Clark","NV","Passenger","5","4","9","497","506","1.778656126482213438735177866"
"2022-02-28T00:00:00.000","Washoe","NV","Passenger","1","0","1","55","56","1.785714285714285714285714286"
"2022-02-28T00:00:00.000","Erie","NY","Passenger","1","0","1","21","22","4.545454545454545454545454545"
"2022-02-28T00:00:00.000","Jefferson","NY","Passenger","0","1","1","183","184","0.5434782608695652173913043478"
"2022-02-28T00:00:00.000","Kings","NY","Passenger","1","0","1","53","54","1.851851851851851851851851852"
"2022-02-28T00:00:00.000","New York","NY","Passenger","1","0","1","39","40","2.500"
"2022-02-28T00:00:00.000","Queens","NY","Passenger","1","0","1","36","37","2.702702702702702702702702703"
"2022-02-28T00:00:00.000","Saratoga","NY","Passenger","1","0","1","37","38","2.631578947368421052631578947"
"2022-02-28T00:00:00.000","Hamilton","OH","Passenger","1","0","1","26","27","3.703703703703703703703703704"
"2022-02-28T00:00:00.000","Shelby","OH","Passenger","0","1","1","2","3","33.33333333333333333333333333"
"2022-02-28T00:00:00.000","Rogers","OK","Passenger","1","0","1","2","3","33.33333333333333333333333333"
"2022-02-28T00:00:00.000","Clackamas","OR","Passenger","2","0","2","134","136","1.470588235294117647058823529"
"2022-02-28T00:00:00.000","Douglas","OR","Passenger","1","0","1","27","28","3.571428571428571428571428571"
"2022-02-28T00:00:00.000","Klamath","OR","Passenger","1","0","1","18","19","5.263157894736842105263157895"
"2022-02-28T00:00:00.000","Lincoln","OR","Passenger","0","1","1","29","30","3.333333333333333333333333333"
"2022-02-28T00:00:00.000","Multnomah","OR","Passenger","1","3","4","487","491","0.8146639511201629327902240326"
"2022-02-28T00:00:00.000","Yamhill","OR","Passenger","1","0","1","24","25","4.00"
"2022-02-28T00:00:00.000","Allegheny","PA","Passenger","1","1","2","43","45","4.444444444444444444444444444"
"2022-02-28T00:00:00.000","Montgomery","PA","Passenger","2","0","2","14","16","12.500"
"2022-02-28T00:00:00.000","Philadelphia","PA","Passenger","1","0","1","34","35","2.857142857142857142857142857"
"2022-02-28T00:00:00.000","RÃ­o Grande","PR","Passenger","1","0","1","0","1","100"
"2022-02-28T00:00:00.000","Newport","RI","Truck","1","0","1","12","13","7.692307692307692307692307692"
"2022-02-28T00:00:00.000","Newport","RI","Passenger","1","0","1","75","76","1.315789473684210526315789474"
"2022-02-28T00:00:00.000","Charleston","SC","Passenger","1","0","1","64","65","1.538461538461538461538461538"
"2022-02-28T00:00:00.000","Richland","SC","Passenger","0","1","1","117","118","0.8474576271186440677966101695"
"2022-02-28T00:00:00.000","Spartanburg","SC","Passenger","0","1","1","26","27","3.703703703703703703703703704"
"2022-02-28T00:00:00.000","Sumter","SC","Passenger","0","1","1","29","30","3.333333333333333333333333333"
"2022-02-28T00:00:00.000","Pennington","SD","Passenger","1","0","1","27","28","3.571428571428571428571428571"
"2022-02-28T00:00:00.000","Davidson","TN","Passenger","1","0","1","32","33","3.030303030303030303030303030"
"2022-02-28T00:00:00.000","Montgomery","TN","Passenger","1","0","1","174","175","0.5714285714285714285714285714"
"2022-02-28T00:00:00.000","Tipton","TN","Passenger","1","0","1","12","13","7.692307692307692307692307692"
"2022-02-28T00:00:00.000","Bell","TX","Passenger","0","1","1","292","293","0.3412969283276450511945392491"
"2022-02-28T00:00:00.000","Bexar","TX","Passenger","4","3","7","422","429","1.631701631701631701631701632"
"2022-02-28T00:00:00.000","Coryell","TX","Passenger","1","0","1","95","96","1.041666666666666666666666667"
"2022-02-28T00:00:00.000","Dallas","TX","Passenger","1","0","1","108","109","0.9174311926605504587155963303"
"2022-02-28T00:00:00.000","Denton","TX","Passenger","1","0","1","51","52","1.923076923076923076923076923"
"2022-02-28T00:00:00.000","El Paso","TX","Passenger","1","0","1","320","321","0.3115264797507788161993769470"
"2022-02-28T00:00:00.000","Galveston","TX","Passenger","0","1","1","17","18","5.555555555555555555555555556"
"2022-02-28T00:00:00.000","Harris","TX","Passenger","1","0","1","144","145","0.6896551724137931034482758621"
"2022-02-28T00:00:00.000","Hidalgo","TX","Passenger","0","1","1","53","54","1.851851851851851851851851852"
"2022-02-28T00:00:00.000","Montgomery","TX","Passenger","1","0","1","21","22","4.545454545454545454545454545"
"2022-02-28T00:00:00.000","Nueces","TX","Passenger","1","0","1","53","54","1.851851851851851851851851852"
"2022-02-28T00:00:00.000","Tarrant","TX","Passenger","1","0","1","101","102","0.9803921568627450980392156863"
"2022-02-28T00:00:00.000","Wichita","TX","Passenger","1","0","1","37","38","2.631578947368421052631578947"
"2022-02-28T00:00:00.000","Williamson","TX","Passenger","1","0","1","75","76","1.315789473684210526315789474"
"2022-02-28T00:00:00.000","Salt Lake","UT","Passenger","2","2","4","125","129","3.100775193798449612403100775"
"2022-02-28T00:00:00.000","Albemarle","VA","Passenger","1","0","1","17","18","5.555555555555555555555555556"
"2022-02-28T00:00:00.000","Alexandria","VA","Passenger","5","0","5","119","124","4.032258064516129032258064516"
"2022-02-28T00:00:00.000","Chesapeake","VA","Passenger","1","3","4","348","352","1.136363636363636363636363636"
"2022-02-28T00:00:00.000","Danville","VA","Passenger","1","0","1","0","1","100"
"2022-02-28T00:00:00.000","Fairfax","VA","Passenger","3","3","6","606","612","0.9803921568627450980392156863"
"2022-02-28T00:00:00.000","Goochland","VA","Passenger","3","0","3","122","125","2.400"
"2022-02-28T00:00:00.000","Loudoun","VA","Passenger","1","0","1","56","57","1.754385964912280701754385965"
"2022-02-28T00:00:00.000","Louisa","VA","Passenger","0","1","1","0","1","100"
"2022-02-28T00:00:00.000","Manassas","VA","Passenger","0","1","1","5","6","16.66666666666666666666666667"
"2022-02-28T00:00:00.000","Norfolk","VA","Passenger","1","1","2","288","290","0.6896551724137931034482758621"
"2022-02-28T00:00:00.000","Portsmouth","VA","Passenger","1","1","2","61","63","3.174603174603174603174603175"
"2022-02-28T00:00:00.000","Powhatan","VA","Passenger","1","0","1","1","2","50.0"
"2022-02-28T00:00:00.000","Prince William","VA","Passenger","1","1","2","186","188","1.063829787234042553191489362"
"2022-02-28T00:00:00.000","Prince William","VA","Truck","1","0","1","24","25","4.00"
"2022-02-28T00:00:00.000","Stafford","VA","Passenger","2","1","3","88","91","3.296703296703296703296703297"
"2022-02-28T00:00:00.000","Suffolk","VA","Passenger","1","0","1","101","102","0.9803921568627450980392156863"
"2022-02-28T00:00:00.000","Virginia Beach","VA","Passenger","2","0","2","500","502","0.3984063745019920318725099602"
"2022-02-28T00:00:00.000","Adams","WA","Passenger","17","16","33","13015","13048","0.2529123237277743715511955855"
"2022-02-28T00:00:00.000","Adams","WA","Truck","1","0","1","5460","5461","0.01831166453030580479765610694"
"2022-02-28T00:00:00.000","Asotin","WA","Truck","2","0","2","6745","6747","0.02964280420927819771750407589"
"2022-02-28T00:00:00.000","Asotin","WA","Passenger","23","19","42","12665","12707","0.3305264814669080034626583773"
"2022-02-28T00:00:00.000","Benton","WA","Passenger","675","460","1135","135928","137063","0.8280863544501433647300876239"
"2022-02-28T00:00:00.000","Benton","WA","Truck","32","0","32","43659","43691","0.07324162871071845460163420384"
"2022-02-28T00:00:00.000","Chelan","WA","Passenger","437","122","559","54595","55154","1.013525764223809696486202270"
"2022-02-28T00:00:00.000","Chelan","WA","Truck","12","0","12","23067","23079","0.05199532042116209541141297283"
"2022-02-28T00:00:00.000","Clallam","WA","Passenger","404","250","654","50171","50825","1.286768322675848499754058042"
"2022-02-28T00:00:00.000","Clallam","WA","Truck","6","0","6","22102","22108","0.02713949701465532838791387733"
"2022-02-28T00:00:00.000","Clark","WA","Passenger","3734","1647","5381","319219","324600","1.657732593961799137399876771"
"2022-02-28T00:00:00.000","Clark","WA","Truck","76","0","76","83740","83816","0.09067481149183926696573446597"
"2022-02-28T00:00:00.000","Columbia","WA","Passenger","6","1","7","2460","2467","0.2837454398054316984191325497"
"2022-02-28T00:00:00.000","Columbia","WA","Truck","2","0","2","1572","1574","0.1270648030495552731893265565"
"2022-02-28T00:00:00.000","Cowlitz","WA","Truck","10","1","11","28918","28929","0.03802412803760931936810812679"
"2022-02-28T00:00:00.000","Cowlitz","WA","Passenger","294","176","470","71304","71774","0.6548332265165658873686850392"
"2022-02-28T00:00:00.000","Douglas","WA","Truck","5","0","5","12700","12705","0.03935458480913026367571822117"
"2022-02-28T00:00:00.000","Douglas","WA","Passenger","121","56","177","28579","28756","0.6155237167895395743497009320"
"2022-02-28T00:00:00.000","Ferry","WA","Passenger","15","3","18","4447","4465","0.4031354983202687569988801792"
"2022-02-28T00:00:00.000","Ferry","WA","Truck","0","0","0","3567","3567","0"
"2022-02-28T00:00:00.000","Franklin","WA","Passenger","180","107","287","62119","62406","0.4598916770823318270679101368"
"2022-02-28T00:00:00.000","Franklin","WA","Truck","9","0","9","20916","20925","0.04301075268817204301075268817"
"2022-02-28T00:00:00.000","Garfield","WA","Passenger","0","3","3","1357","1360","0.2205882352941176470588235294"
"2022-02-28T00:00:00.000","Garfield","WA","Truck","0","0","0","997","997","0"
"2022-02-28T00:00:00.000","Grant","WA","Truck","8","0","8","28012","28020","0.02855103497501784439685938615"
"2022-02-28T00:00:00.000","Grant","WA","Passenger","149","105","254","66815","67069","0.3787144582444944758383157644"
"2022-02-28T00:00:00.000","Grays Harbor","WA","Passenger","216","165","381","49319","49700","0.7665995975855130784708249497"
"2022-02-28T00:00:00.000","Grays Harbor","WA","Truck","13","0","13","21330","21343","0.06090990020147120835871245842"
"2022-02-28T00:00:00.000","Island","WA","Truck","15","0","15","21526","21541","0.06963465020194048558562740820"
"2022-02-28T00:00:00.000","Island","WA","Passenger","761","367","1128","62645","63773","1.768773618929641070672541671"
"2022-02-28T00:00:00.000","Jefferson","WA","Passenger","402","212","614","24702","25316","2.425343656185811344604202876"
"2022-02-28T00:00:00.000","Jefferson","WA","Truck","4","0","4","9585","9589","0.04171446449056210240901032433"
"2022-02-28T00:00:00.000","King","WA","Truck","242","1","243","182411","182654","0.1330384223723542873410929955"
"2022-02-28T00:00:00.000","King","WA","Passenger","37645","10811","48456","1355552","1404008","3.451262385969310716178255395"
"2022-02-28T00:00:00.000","Kitsap","WA","Passenger","2309","1018","3327","180050","183377","1.814295140611963332369926436"
"2022-02-28T00:00:00.000","Kitsap","WA","Truck","46","0","46","54199","54245","0.08480044243709097612683196608"
"2022-02-28T00:00:00.000","Kittitas","WA","Passenger","224","74","298","29782","30080","0.9906914893617021276595744681"
"2022-02-28T00:00:00.000","Kittitas","WA","Truck","6","0","6","14756","14762","0.04064489906516732150115160547"
"2022-02-28T00:00:00.000","Klickitat","WA","Truck","2","0","2","8335","8337","0.02398944464435648314741513734"
"2022-02-28T00:00:00.000","Klickitat","WA","Passenger","94","54","148","15302","15450","0.9579288025889967637540453074"
"2022-02-28T00:00:00.000","Lewis","WA","Passenger","231","172","403","59458","59861","0.6732263076126359399274987053"
"2022-02-28T00:00:00.000","Lewis","WA","Truck","9","0","9","26631","26640","0.03378378378378378378378378378"
"2022-02-28T00:00:00.000","Lincoln","WA","Truck","0","0","0","4855","4855","0"
"2022-02-28T00:00:00.000","Lincoln","WA","Passenger","9","17","26","7688","7714","0.3370495203526056520611874514"
"2022-02-28T00:00:00.000","Mason","WA","Truck","12","0","12","21190","21202","0.05659843410998962362041316857"
"2022-02-28T00:00:00.000","Mason","WA","Passenger","299","174","473","47730","48203","0.9812667261373773416592328278"
"2022-02-28T00:00:00.000","Okanogan","WA","Passenger","75","48","123","26482","26605","0.4623191129486938545386205600"
"2022-02-28T00:00:00.000","Okanogan","WA","Truck","3","0","3","16724","16727","0.01793507502839720212829557004"
"2022-02-28T00:00:00.000","Pacific","WA","Passenger","67","68","135","16022","16157","0.8355511542984464937797858513"
"2022-02-28T00:00:00.000","Pacific","WA","Truck","2","0","2","8007","8009","0.02497190660506929704082906730"
"2022-02-28T00:00:00.000","Pend Oreille","WA","Passenger","17","9","26","9082","9108","0.2854633289415898111550285463"
"2022-02-28T00:00:00.000","Pend Oreille","WA","Truck","1","0","1","5711","5712","0.01750700280112044817927170868"
"2022-02-28T00:00:00.000","Pierce","WA","Truck","94","0","94","144220","144314","0.06513574566570117937275662791"
"2022-02-28T00:00:00.000","Pierce","WA","Passenger","4707","2261","6968","553442","560410","1.243375385878196320551025142"
"2022-02-28T00:00:00.000","San Juan","WA","Passenger","486","153","639","14179","14818","4.312322850587123768389796194"
"2022-02-28T00:00:00.000","San Juan","WA","Truck","4","0","4","6017","6021","0.06643414715163594087360903504"
"2022-02-28T00:00:00.000","Skagit","WA","Truck","23","0","23","32644","32667","0.07040744482199161233048642361"
"2022-02-28T00:00:00.000","Skagit","WA","Passenger","741","340","1081","90678","91759","1.178086073300711646813936508"
"2022-02-28T00:00:00.000","Skamania","WA","Passenger","62","46","108","8308","8416","1.283269961977186311787072243"
"2022-02-28T00:00:00.000","Skamania","WA","Truck","0","0","0","3999","3999","0"
"2022-02-28T00:00:00.000","Snohomish","WA","Passenger","7610","2412","10022","536124","546146","1.835040447059943678064107400"
"2022-02-28T00:00:00.000","Snohomish","WA","Truck","109","0","109","125130","125239","0.08703359177253092087927881890"
"2022-02-28T00:00:00.000","Spokane","WA","Passenger","1434","819","2253","326523","328776","0.6852689977370610993503175414"
"2022-02-28T00:00:00.000","Spokane","WA","Truck","57","0","57","102686","102743","0.05547823209367061502973438580"
"2022-02-28T00:00:00.000","Stevens","WA","Passenger","61","47","108","30128","30236","0.3571901045111787273448868898"
"2022-02-28T00:00:00.000","Stevens","WA","Truck","2","0","2","18974","18976","0.01053962900505902192242833052"
"2022-02-28T00:00:00.000","Thurston","WA","Truck","48","0","48","55934","55982","0.08574184559322639419813511486"
"2022-02-28T00:00:00.000","Thurston","WA","Passenger","2060","1041","3101","196421","199522","1.554214572829061456881947855"
"2022-02-28T00:00:00.000","Wahkiakum","WA","Passenger","17","12","29","3097","3126","0.9277031349968010236724248241"
"2022-02-28T00:00:00.000","Wahkiakum","WA","Truck","0","0","0","1816","1816","0"
"2022-02-28T00:00:00.000","Walla Walla","WA","Passenger","152","95","247","36263","36510","0.6765269789098877019994522049"
"2022-02-28T00:00:00.000","Walla Walla","WA","Truck","7","0","7","14088","14095","0.04966300106420716566158212132"
"2022-02-28T00:00:00.000","Whatcom","WA","Truck","30","0","30","43620","43650","0.06872852233676975945017182131"
"2022-02-28T00:00:00.000","Whatcom","WA","Passenger","1743","710","2453","149395","151848","1.615431220694378589115431221"
"2022-02-28T00:00:00.000","Whitman","WA","Passenger","72","59","131","22063","22194","0.5902496170136072812471839236"
"2022-02-28T00:00:00.000","Whitman","WA","Truck","5","0","5","8587","8592","0.05819366852886405959031657356"
"2022-02-28T00:00:00.000","Yakima","WA","Truck","6","0","6","61665","61671","0.009729046067033127401858247799"
"2022-02-28T00:00:00.000","Yakima","WA","Passenger","317","190","507","168098","168605","0.3007028261320838646540731295"
"2022-02-28T00:00:00.000","Douglas","WI","Passenger","1","0","1","1","2","50.0"
"2022-02-28T00:00:00.000","Ozaukee","WI","Passenger","0","1","1","2","3","33.33333333333333333333333333"
"2022-03-31T00:00:00.000","Anchorage","AK","Passenger","1","0","1","110","111","0.9009009009009009009009009009"
"2022-03-31T00:00:00.000","Fairbanks North Star","AK","Passenger","0","1","1","73","74","1.351351351351351351351351351"
"2022-03-31T00:00:00.000","Juneau","AK","Passenger","0","1","1","27","28","3.571428571428571428571428571"
"2022-03-31T00:00:00.000","Montgomery","AL","Passenger","0","1","1","34","35","2.857142857142857142857142857"
"2022-03-31T00:00:00.000","Maricopa","AZ","Passenger","4","3","7","732","739","0.9472259810554803788903924222"
"2022-03-31T00:00:00.000","Pima","AZ","Passenger","1","1","2","199","201","0.9950248756218905472636815920"
"2022-03-31T00:00:00.000","Pinal","AZ","Passenger","1","0","1","90","91","1.098901098901098901098901099"
"2022-03-31T00:00:00.000","Alameda","CA","Passenger","3","0","3","176","179","1.675977653631284916201117318"
"2022-03-31T00:00:00.000","Contra Costa","CA","Passenger","0","5","5","296","301","1.661129568106312292358803987"
"2022-03-31T00:00:00.000","Fresno","CA","Passenger","1","0","1","131","132","0.7575757575757575757575757576"
"2022-03-31T00:00:00.000","Kern","CA","Passenger","1","1","2","170","172","1.162790697674418604651162791"
"2022-03-31T00:00:00.000","Kings","CA","Passenger","1","0","1","293","294","0.3401360544217687074829931973"
"2022-03-31T00:00:00.000","Los Angeles","CA","Passenger","3","5","8","677","685","1.167883211678832116788321168"
"2022-03-31T00:00:00.000","Marin","CA","Passenger","0","1","1","31","32","3.12500"
"2022-03-31T00:00:00.000","Monterey","CA","Passenger","1","1","2","120","122","1.639344262295081967213114754"
"2022-03-31T00:00:00.000","Orange","CA","Passenger","5","2","7","335","342","2.046783625730994152046783626"
"2022-03-31T00:00:00.000","Placer","CA","Passenger","1","0","1","57","58","1.724137931034482758620689655"
"2022-03-31T00:00:00.000","Riverside","CA","Passenger","8","1","9","401","410","2.195121951219512195121951220"
"2022-03-31T00:00:00.000","Sacramento","CA","Passenger","1","0","1","186","187","0.5347593582887700534759358289"
"2022-03-31T00:00:00.000","San Bernardino","CA","Passenger","1","2","3","308","311","0.9646302250803858520900321543"
"2022-03-31T00:00:00.000","San Diego","CA","Passenger","14","9","23","2212","2235","1.029082774049217002237136465"
"2022-03-31T00:00:00.000","San Joaquin","CA","Passenger","0","1","1","79","80","1.2500"
"2022-03-31T00:00:00.000","San Luis Obispo","CA","Passenger","1","0","1","48","49","2.040816326530612244897959184"
"2022-03-31T00:00:00.000","Santa Barbara","CA","Passenger","1","0","1","65","66","1.515151515151515151515151515"
"2022-03-31T00:00:00.000","Santa Clara","CA","Passenger","5","1","6","184","190","3.157894736842105263157894737"
"2022-03-31T00:00:00.000","Santa Cruz","CA","Passenger","1","0","1","19","20","5.00"
"2022-03-31T00:00:00.000","Solano","CA","Passenger","1","0","1","163","164","0.6097560975609756097560975610"
"2022-03-31T00:00:00.000","Sonoma","CA","Passenger","0","1","1","69","70","1.428571428571428571428571429"
"2022-03-31T00:00:00.000","Ventura","CA","Passenger","2","1","3","224","227","1.321585903083700440528634361"
"2022-03-31T00:00:00.000","Boulder","CO","Passenger","1","0","1","22","23","4.347826086956521739130434783"
"2022-03-31T00:00:00.000","El Paso","CO","Passenger","2","1","3","551","554","0.5415162454873646209386281588"
"2022-03-31T00:00:00.000","Larimer","CO","Passenger","1","0","1","40","41","2.439024390243902439024390244"
"2022-03-31T00:00:00.000","Las Animas","CO","Passenger","1","0","1","0","1","100"
"2022-03-31T00:00:00.000","New London","CT","Passenger","0","4","4","204","208","1.923076923076923076923076923"
"2022-03-31T00:00:00.000","District of Columbia","DC","Passenger","3","2","5","181","186","2.688172043010752688172043011"
"2022-03-31T00:00:00.000","Kent","DE","Passenger","0","1","1","50","51","1.960784313725490196078431373"
"2022-03-31T00:00:00.000","New Castle","DE","Passenger","1","0","1","19","20","5.00"
"2022-03-31T00:00:00.000","Broward","FL","Passenger","1","0","1","71","72","1.388888888888888888888888889"
"2022-03-31T00:00:00.000","Duval","FL","Passenger","0","1","1","246","247","0.4048582995951417004048582996"
"2022-03-31T00:00:00.000","Hillsborough","FL","Passenger","0","2","2","107","109","1.834862385321100917431192661"
"2022-03-31T00:00:00.000","Lake","FL","Passenger","1","0","1","17","18","5.555555555555555555555555556"
"2022-03-31T00:00:00.000","Okaloosa","FL","Passenger","0","1","1","86","87","1.149425287356321839080459770"
"2022-03-31T00:00:00.000","Orange","FL","Passenger","1","0","1","79","80","1.2500"
"2022-03-31T00:00:00.000","Palm Beach","FL","Passenger","1","0","1","37","38","2.631578947368421052631578947"
"2022-03-31T00:00:00.000","Pinellas","FL","Passenger","0","1","1","65","66","1.515151515151515151515151515"
"2022-03-31T00:00:00.000","Sarasota","FL","Passenger","2","0","2","22","24","8.333333333333333333333333333"
"2022-03-31T00:00:00.000","St. Johns","FL","Passenger","0","1","1","29","30","3.333333333333333333333333333"
"2022-03-31T00:00:00.000","Bartow","GA","Passenger","0","1","1","2","3","33.33333333333333333333333333"
"2022-03-31T00:00:00.000","Bryan","GA","Passenger","1","0","1","39","40","2.500"
"2022-03-31T00:00:00.000","Columbia","GA","Passenger","1","1","2","89","91","2.197802197802197802197802198"
"2022-03-31T00:00:00.000","DeKalb","GA","Passenger","1","0","1","38","39","2.564102564102564102564102564"
"2022-03-31T00:00:00.000","Houston","GA","Passenger","1","0","1","37","38","2.631578947368421052631578947"
"2022-03-31T00:00:00.000","Liberty","GA","Passenger","1","0","1","91","92","1.086956521739130434782608696"
"2022-03-31T00:00:00.000","Rockdale","GA","Passenger","1","0","1","6","7","14.28571428571428571428571429"
"2022-03-31T00:00:00.000","Honolulu","HI","Passenger","4","2","6","291","297","2.020202020202020202020202020"
"2022-03-31T00:00:00.000","Cook","IL","Passenger","2","0","2","154","156","1.282051282051282051282051282"
"2022-03-31T00:00:00.000","DuPage","IL","Passenger","1","0","1","38","39","2.564102564102564102564102564"
"2022-03-31T00:00:00.000","Lake","IL","Passenger","4","0","4","145","149","2.684563758389261744966442953"
"2022-03-31T00:00:00.000","Rock Island","IL","Passenger","0","1","1","13","14","7.142857142857142857142857143"
"2022-03-31T00:00:00.000","St. Clair","IL","Passenger","2","0","2","114","116","1.724137931034482758620689655"
"2022-03-31T00:00:00.000","Hamilton","IN","Passenger","1","0","1","21","22","4.545454545454545454545454545"
"2022-03-31T00:00:00.000","Howard","IN","Passenger","0","1","1","6","7","14.28571428571428571428571429"
"2022-03-31T00:00:00.000","Geary","KS","Passenger","1","0","1","79","80","1.2500"
"2022-03-31T00:00:00.000","Leavenworth","KS","Passenger","1","1","2","98","100","2.00"
"2022-03-31T00:00:00.000","Oldham","KY","Passenger","0","1","1","4","5","20.0"
"2022-03-31T00:00:00.000","Plaquemines","LA","Passenger","0","1","1","15","16","6.2500"
"2022-03-31T00:00:00.000","Middlesex","MA","Passenger","1","1","2","75","77","2.597402597402597402597402597"
"2022-03-31T00:00:00.000","Suffolk","MA","Passenger","0","1","1","27","28","3.571428571428571428571428571"
"2022-03-31T00:00:00.000","Anne Arundel","MD","Passenger","4","3","7","328","335","2.089552238805970149253731343"
"2022-03-31T00:00:00.000","Baltimore","MD","Passenger","1","0","1","64","65","1.538461538461538461538461538"
"2022-03-31T00:00:00.000","Calvert","MD","Passenger","0","2","2","73","75","2.666666666666666666666666667"
"2022-03-31T00:00:00.000","Carroll","MD","Passenger","0","1","1","10","11","9.090909090909090909090909091"
"2022-03-31T00:00:00.000","Charles","MD","Passenger","0","1","1","54","55","1.818181818181818181818181818"
"2022-03-31T00:00:00.000","Charles","MD","Truck","1","0","1","9","10","10.0"
"2022-03-31T00:00:00.000","Frederick","MD","Passenger","2","1","3","69","72","4.166666666666666666666666667"
"2022-03-31T00:00:00.000","Howard","MD","Passenger","0","1","1","56","57","1.754385964912280701754385965"
"2022-03-31T00:00:00.000","Montgomery","MD","Passenger","2","5","7","187","194","3.608247422680412371134020619"
"2022-03-31T00:00:00.000","Prince George's","MD","Passenger","1","0","1","116","117","0.8547008547008547008547008547"
"2022-03-31T00:00:00.000","St. Mary's","MD","Passenger","1","0","1","166","167","0.5988023952095808383233532934"
"2022-03-31T00:00:00.000","St. Mary's","MD","Truck","1","0","1","40","41","2.439024390243902439024390244"
"2022-03-31T00:00:00.000","Washington","MD","Passenger","2","0","2","11","13","15.38461538461538461538461538"
"2022-03-31T00:00:00.000","Penobscot","ME","Passenger","0","1","1","7","8","12.500"
"2022-03-31T00:00:00.000","Hennepin","MN","Passenger","1","0","1","50","51","1.960784313725490196078431373"
"2022-03-31T00:00:00.000","Kanabec","MN","Passenger","1","0","1","0","1","100"
"2022-03-31T00:00:00.000","Boone","MO","Passenger","0","1","1","9","10","10.0"
"2022-03-31T00:00:00.000","Greene","MO","Passenger","0","1","1","16","17","5.882352941176470588235294118"
"2022-03-31T00:00:00.000","Platte","MO","Passenger","1","0","1","15","16","6.2500"
"2022-03-31T00:00:00.000","Ray","MO","Passenger","0","1","1","0","1","100"
"2022-03-31T00:00:00.000","St. Louis","MO","Passenger","1","0","1","68","69","1.449275362318840579710144928"
"2022-03-31T00:00:00.000","Harrison","MS","Passenger","2","0","2","42","44","4.545454545454545454545454545"
"2022-03-31T00:00:00.000","Flathead","MT","Passenger","1","0","1","25","26","3.846153846153846153846153846"
"2022-03-31T00:00:00.000","Glacier","MT","Passenger","0","1","1","5","6","16.66666666666666666666666667"
"2022-03-31T00:00:00.000","Cumberland","NC","Passenger","0","2","2","361","363","0.5509641873278236914600550964"
"2022-03-31T00:00:00.000","Cumberland","NC","Truck","1","0","1","81","82","1.219512195121951219512195122"
"2022-03-31T00:00:00.000","Mecklenburg","NC","Passenger","1","0","1","53","54","1.851851851851851851851851852"
"2022-03-31T00:00:00.000","Moore","NC","Passenger","0","1","1","120","121","0.8264462809917355371900826446"
"2022-03-31T00:00:00.000","Onslow","NC","Passenger","0","1","1","147","148","0.6756756756756756756756756757"
"2022-03-31T00:00:00.000","Wake","NC","Passenger","1","0","1","73","74","1.351351351351351351351351351"
"2022-03-31T00:00:00.000","Wayne","NC","Passenger","1","0","1","26","27","3.703703703703703703703703704"
"2022-03-31T00:00:00.000","Wilson","NC","Passenger","1","0","1","1","2","50.0"
"2022-03-31T00:00:00.000","Williams","ND","Passenger","0","1","1","7","8","12.500"
"2022-03-31T00:00:00.000","Douglas","NE","Passenger","1","2","3","44","47","6.382978723404255319148936170"
"2022-03-31T00:00:00.000","Sarpy","NE","Passenger","1","0","1","46","47","2.127659574468085106382978723"
"2022-03-31T00:00:00.000","Carroll","NH","Passenger","0","1","1","3","4","25.00"
"2022-03-31T00:00:00.000","Burlington","NJ","Passenger","0","1","1","114","115","0.8695652173913043478260869565"
"2022-03-31T00:00:00.000","Camden","NJ","Passenger","0","1","1","9","10","10.0"
"2022-03-31T00:00:00.000","Hudson","NJ","Truck","1","0","1","10","11","9.090909090909090909090909091"
"2022-03-31T00:00:00.000","Hudson","NJ","Passenger","1","0","1","81","82","1.219512195121951219512195122"
"2022-03-31T00:00:00.000","Chaves","NM","Passenger","1","0","1","4","5","20.0"
"2022-03-31T00:00:00.000","Carson City","NV","Passenger","1","0","1","7","8","12.500"
"2022-03-31T00:00:00.000","Clark","NV","Passenger","5","4","9","487","496","1.814516129032258064516129032"
"2022-03-31T00:00:00.000","Washoe","NV","Passenger","1","0","1","52","53","1.886792452830188679245283019"
"2022-03-31T00:00:00.000","Jefferson","NY","Passenger","0","1","1","182","183","0.5464480874316939890710382514"
"2022-03-31T00:00:00.000","Kings","NY","Passenger","1","0","1","50","51","1.960784313725490196078431373"
"2022-03-31T00:00:00.000","New York","NY","Passenger","1","0","1","39","40","2.500"
"2022-03-31T00:00:00.000","Queens","NY","Passenger","1","0","1","35","36","2.777777777777777777777777778"
"2022-03-31T00:00:00.000","Saratoga","NY","Passenger","1","0","1","37","38","2.631578947368421052631578947"
"2022-03-31T00:00:00.000","Hamilton","OH","Passenger","1","0","1","26","27","3.703703703703703703703703704"
"2022-03-31T00:00:00.000","Shelby","OH","Passenger","0","1","1","2","3","33.33333333333333333333333333"
"2022-03-31T00:00:00.000","Rogers","OK","Passenger","1","0","1","2","3","33.33333333333333333333333333"
"2022-03-31T00:00:00.000","Clackamas","OR","Passenger","2","0","2","126","128","1.562500"
"2022-03-31T00:00:00.000","Douglas","OR","Passenger","1","0","1","26","27","3.703703703703703703703703704"
"2022-03-31T00:00:00.000","Lincoln","OR","Passenger","0","1","1","29","30","3.333333333333333333333333333"
"2022-03-31T00:00:00.000","Multnomah","OR","Passenger","1","3","4","470","474","0.8438818565400843881856540084"
"2022-03-31T00:00:00.000","Allegheny","PA","Passenger","1","1","2","42","44","4.545454545454545454545454545"
"2022-03-31T00:00:00.000","Montgomery","PA","Passenger","2","0","2","14","16","12.500"
"2022-03-31T00:00:00.000","Philadelphia","PA","Passenger","1","0","1","33","34","2.941176470588235294117647059"
"2022-03-31T00:00:00.000","RÃ­o Grande","PR","Passenger","1","0","1","0","1","100"
"2022-03-31T00:00:00.000","Newport","RI","Passenger","1","0","1","75","76","1.315789473684210526315789474"
"2022-03-31T00:00:00.000","Newport","RI","Truck","1","0","1","12","13","7.692307692307692307692307692"
"2022-03-31T00:00:00.000","Charleston","SC","Passenger","1","0","1","58","59","1.694915254237288135593220339"
"2022-03-31T00:00:00.000","Richland","SC","Passenger","0","1","1","117","118","0.8474576271186440677966101695"
"2022-03-31T00:00:00.000","Spartanburg","SC","Passenger","0","1","1","25","26","3.846153846153846153846153846"
"2022-03-31T00:00:00.000","Sumter","SC","Passenger","0","1","1","28","29","3.448275862068965517241379310"
"2022-03-31T00:00:00.000","Pennington","SD","Passenger","1","0","1","26","27","3.703703703703703703703703704"
"2022-03-31T00:00:00.000","Davidson","TN","Passenger","1","0","1","28","29","3.448275862068965517241379310"
"2022-03-31T00:00:00.000","Montgomery","TN","Passenger","1","0","1","170","171","0.5847953216374269005847953216"
"2022-03-31T00:00:00.000","Tipton","TN","Passenger","1","0","1","12","13","7.692307692307692307692307692"
"2022-03-31T00:00:00.000","Bell","TX","Passenger","0","1","1","287","288","0.3472222222222222222222222222"
"2022-03-31T00:00:00.000","Bexar","TX","Passenger","5","3","8","410","418","1.913875598086124401913875598"
"2022-03-31T00:00:00.000","Coryell","TX","Passenger","1","0","1","93","94","1.063829787234042553191489362"
"2022-03-31T00:00:00.000","Dallas","TX","Passenger","1","0","1","100","101","0.9900990099009900990099009901"
"2022-03-31T00:00:00.000","Denton","TX","Passenger","1","0","1","49","50","2.00"
"2022-03-31T00:00:00.000","El Paso","TX","Passenger","1","0","1","319","320","0.312500"
"2022-03-31T00:00:00.000","Galveston","TX","Passenger","0","1","1","16","17","5.882352941176470588235294118"
"2022-03-31T00:00:00.000","Harris","TX","Passenger","1","0","1","134","135","0.7407407407407407407407407407"
"2022-03-31T00:00:00.000","Hidalgo","TX","Passenger","0","1","1","52","53","1.886792452830188679245283019"
"2022-03-31T00:00:00.000","Montgomery","TX","Passenger","1","0","1","21","22","4.545454545454545454545454545"
"2022-03-31T00:00:00.000","Nueces","TX","Passenger","1","0","1","51","52","1.923076923076923076923076923"
"2022-03-31T00:00:00.000","Tarrant","TX","Passenger","1","0","1","97","98","1.020408163265306122448979592"
"2022-03-31T00:00:00.000","Wichita","TX","Passenger","1","0","1","35","36","2.777777777777777777777777778"
"2022-03-31T00:00:00.000","Williamson","TX","Passenger","1","0","1","71","72","1.388888888888888888888888889"
"2022-03-31T00:00:00.000","Salt Lake","UT","Passenger","2","2","4","120","124","3.225806451612903225806451613"
"2022-03-31T00:00:00.000","Albemarle","VA","Passenger","1","0","1","16","17","5.882352941176470588235294118"
"2022-03-31T00:00:00.000","Alexandria","VA","Passenger","5","0","5","116","121","4.132231404958677685950413223"
"2022-03-31T00:00:00.000","Chesapeake","VA","Passenger","1","3","4","344","348","1.149425287356321839080459770"
"2022-03-31T00:00:00.000","Danville","VA","Passenger","1","0","1","0","1","100"
"2022-03-31T00:00:00.000","Fairfax","VA","Passenger","3","3","6","590","596","1.006711409395973154362416107"
"2022-03-31T00:00:00.000","Goochland","VA","Passenger","3","0","3","107","110","2.727272727272727272727272727"
"2022-03-31T00:00:00.000","Loudoun","VA","Passenger","1","0","1","56","57","1.754385964912280701754385965"
"2022-03-31T00:00:00.000","Louisa","VA","Passenger","0","1","1","0","1","100"
"2022-03-31T00:00:00.000","Manassas","VA","Passenger","0","1","1","4","5","20.0"
"2022-03-31T00:00:00.000","Norfolk","VA","Passenger","1","1","2","285","287","0.6968641114982578397212543554"
"2022-03-31T00:00:00.000","Portsmouth","VA","Passenger","1","1","2","61","63","3.174603174603174603174603175"
"2022-03-31T00:00:00.000","Powhatan","VA","Passenger","1","0","1","1","2","50.0"
"2022-03-31T00:00:00.000","Prince William","VA","Passenger","0","1","1","182","183","0.5464480874316939890710382514"
"2022-03-31T00:00:00.000","Prince William","VA","Truck","1","0","1","23","24","4.166666666666666666666666667"
"2022-03-31T00:00:00.000","Stafford","VA","Passenger","2","1","3","85","88","3.409090909090909090909090909"
"2022-03-31T00:00:00.000","Suffolk","VA","Passenger","1","0","1","99","100","1.00"
"2022-03-31T00:00:00.000","Virginia Beach","VA","Passenger","2","0","2","487","489","0.4089979550102249488752556237"
"2022-03-31T00:00:00.000","Adams","WA","Truck","1","0","1","5483","5484","0.01823486506199854121079504012"
"2022-03-31T00:00:00.000","Adams","WA","Passenger","16","13","29","12970","12999","0.2230940841603200246172782522"
"2022-03-31T00:00:00.000","Asotin","WA","Passenger","23","19","42","12681","12723","0.3301108229191228483848149021"
"2022-03-31T00:00:00.000","Asotin","WA","Truck","2","0","2","6764","6766","0.02955956251847472657404670411"
"2022-03-31T00:00:00.000","Benton","WA","Passenger","708","452","1160","135793","136953","0.8470059071360247676210086672"
"2022-03-31T00:00:00.000","Benton","WA","Truck","35","0","35","43607","43642","0.08019797442830301086109710829"
"2022-03-31T00:00:00.000","Chelan","WA","Passenger","445","123","568","54613","55181","1.029339808992225584893350972"
"2022-03-31T00:00:00.000","Chelan","WA","Truck","12","0","12","23025","23037","0.05209011590050787863002995182"
"2022-03-31T00:00:00.000","Clallam","WA","Passenger","413","247","660","49980","50640","1.303317535545023696682464455"
"2022-03-31T00:00:00.000","Clallam","WA","Truck","7","0","7","22046","22053","0.03174171314560377272933387748"
"2022-03-31T00:00:00.000","Clark","WA","Truck","77","0","77","83447","83524","0.09218907140462621521957760644"
"2022-03-31T00:00:00.000","Clark","WA","Passenger","3848","1700","5548","318268","323816","1.713318674802974528744719223"
"2022-03-31T00:00:00.000","Columbia","WA","Passenger","6","0","6","2447","2453","0.2445984508764777823073787199"
"2022-03-31T00:00:00.000","Columbia","WA","Truck","2","0","2","1589","1591","0.1257071024512884978001257071"
"2022-03-31T00:00:00.000","Cowlitz","WA","Passenger","309","181","490","71096","71586","0.6844913809962841896460201715"
"2022-03-31T00:00:00.000","Cowlitz","WA","Truck","10","1","11","28869","28880","0.03808864265927977839335180055"
"2022-03-31T00:00:00.000","Douglas","WA","Truck","5","0","5","12744","12749","0.03921876225586320495725154914"
"2022-03-31T00:00:00.000","Douglas","WA","Passenger","124","57","181","28544","28725","0.6301131418624891209747606614"
"2022-03-31T00:00:00.000","Ferry","WA","Passenger","17","3","20","4434","4454","0.4490345756623259991019308487"
"2022-03-31T00:00:00.000","Ferry","WA","Truck","0","0","0","3569","3569","0"
"2022-03-31T00:00:00.000","Franklin","WA","Passenger","184","111","295","62106","62401","0.4727488341532988253393375106"
"2022-03-31T00:00:00.000","Franklin","WA","Truck","9","0","9","20938","20947","0.04296557979662958896261994558"
"2022-03-31T00:00:00.000","Garfield","WA","Truck","0","0","0","996","996","0"
"2022-03-31T00:00:00.000","Garfield","WA","Passenger","0","3","3","1338","1341","0.2237136465324384787472035794"
"2022-03-31T00:00:00.000","Grant","WA","Truck","9","0","9","28032","28041","0.03209585963410720017117791805"
"2022-03-31T00:00:00.000","Grant","WA","Passenger","158","106","264","66854","67118","0.3933371077803271849578354540"
"2022-03-31T00:00:00.000","Grays Harbor","WA","Passenger","219","164","383","49278","49661","0.7712289321600451058174422585"
"2022-03-31T00:00:00.000","Grays Harbor","WA","Truck","12","0","12","21331","21343","0.05622452326289650002342688469"
"2022-03-31T00:00:00.000","Island","WA","Passenger","775","375","1150","62610","63760","1.803638644918444165621079046"
"2022-03-31T00:00:00.000","Island","WA","Truck","15","0","15","21514","21529","0.06967346370012541223466022574"
"2022-03-31T00:00:00.000","Jefferson","WA","Passenger","415","216","631","24712","25343","2.489839403385550250562285444"
"2022-03-31T00:00:00.000","Jefferson","WA","Truck","4","0","4","9551","9555","0.04186289900575614861329147043"
"2022-03-31T00:00:00.000","King","WA","Truck","247","1","248","181880","182128","0.1361679697794957392603004480"
"2022-03-31T00:00:00.000","King","WA","Passenger","38352","10990","49342","1352558","1401900","3.519651900991511520079891576"
"2022-03-31T00:00:00.000","Kitsap","WA","Truck","47","0","47","54096","54143","0.08680715882016142437618898103"
"2022-03-31T00:00:00.000","Kitsap","WA","Passenger","2352","1043","3395","179656","183051","1.854674380363942289307351503"
"2022-03-31T00:00:00.000","Kittitas","WA","Passenger","230","76","306","29776","30082","1.017219599760654211821022538"
"2022-03-31T00:00:00.000","Kittitas","WA","Truck","7","0","7","14719","14726","0.04753497215808773597718321336"
"2022-03-31T00:00:00.000","Klickitat","WA","Passenger","98","55","153","15327","15480","0.9883720930232558139534883721"
"2022-03-31T00:00:00.000","Klickitat","WA","Truck","2","0","2","8302","8304","0.02408477842003853564547206166"
"2022-03-31T00:00:00.000","Lewis","WA","Passenger","235","170","405","59475","59880","0.6763527054108216432865731463"
"2022-03-31T00:00:00.000","Lewis","WA","Truck","9","0","9","26539","26548","0.03390085882175681783938526443"
"2022-03-31T00:00:00.000","Lincoln","WA","Passenger","9","18","27","7672","7699","0.3506948954409663592674373295"
"2022-03-31T00:00:00.000","Lincoln","WA","Truck","0","0","0","4844","4844","0"
"2022-03-31T00:00:00.000","Mason","WA","Passenger","304","178","482","47633","48115","1.001766600852125116907409332"
"2022-03-31T00:00:00.000","Mason","WA","Truck","13","0","13","21172","21185","0.06136417276374793485957045079"
"2022-03-31T00:00:00.000","Okanogan","WA","Passenger","78","47","125","26511","26636","0.4692896831356059468388646944"
"2022-03-31T00:00:00.000","Okanogan","WA","Truck","3","0","3","16683","16686","0.01797914419273642574613448400"
"2022-03-31T00:00:00.000","Pacific","WA","Passenger","69","71","140","15996","16136","0.8676251859196826970748636589"
"2022-03-31T00:00:00.000","Pacific","WA","Truck","2","0","2","8006","8008","0.02497502497502497502497502498"
"2022-03-31T00:00:00.000","Pend Oreille","WA","Passenger","16","10","26","9055","9081","0.2863120801673824468670851228"
"2022-03-31T00:00:00.000","Pend Oreille","WA","Truck","1","0","1","5677","5678","0.01761183515322296583303980275"
"2022-03-31T00:00:00.000","Pierce","WA","Passenger","4850","2320","7170","550794","557964","1.285029141665053659375873712"
"2022-03-31T00:00:00.000","Pierce","WA","Truck","101","0","101","143597","143698","0.07028629486840457069687817506"
"2022-03-31T00:00:00.000","San Juan","WA","Passenger","492","152","644","14126","14770","4.360189573459715639810426540"
"2022-03-31T00:00:00.000","San Juan","WA","Truck","4","0","4","5990","5994","0.06673340006673340006673340007"
"2022-03-31T00:00:00.000","Skagit","WA","Passenger","756","348","1104","90451","91555","1.205832559663590191688056360"
"2022-03-31T00:00:00.000","Skagit","WA","Truck","26","0","26","32549","32575","0.07981580966999232540291634689"
"2022-03-31T00:00:00.000","Skamania","WA","Passenger","68","46","114","8275","8389","1.358922398378829419477887710"
"2022-03-31T00:00:00.000","Skamania","WA","Truck","0","0","0","3965","3965","0"
"2022-03-31T00:00:00.000","Snohomish","WA","Passenger","7816","2462","10278","534917","545195","1.885197039591338878749805116"
"2022-03-31T00:00:00.000","Snohomish","WA","Truck","110","0","110","124762","124872","0.08809020436927413671599718111"
"2022-03-31T00:00:00.000","Spokane","WA","Passenger","1486","834","2320","326059","328379","0.7065007202043979669832723773"
"2022-03-31T00:00:00.000","Spokane","WA","Truck","58","0","58","102518","102576","0.05654344096084854156917797535"
"2022-03-31T00:00:00.000","Stevens","WA","Truck","2","0","2","18988","18990","0.01053185887309110057925223802"
"2022-03-31T00:00:00.000","Stevens","WA","Passenger","63","50","113","30105","30218","0.3739493017406843603150440135"
"2022-03-31T00:00:00.000","Thurston","WA","Passenger","2123","1053","3176","195789","198965","1.596260648857839318473098284"
"2022-03-31T00:00:00.000","Thurston","WA","Truck","50","0","50","55813","55863","0.08950468109482125915185364195"
"2022-03-31T00:00:00.000","Wahkiakum","WA","Truck","0","0","0","1815","1815","0"
"2022-03-31T00:00:00.000","Wahkiakum","WA","Passenger","18","12","30","3079","3109","0.9649404953361209392087487938"
"2022-03-31T00:00:00.000","Walla Walla","WA","Passenger","157","95","252","36135","36387","0.6925550333910462527825871877"
"2022-03-31T00:00:00.000","Walla Walla","WA","Truck","7","0","7","14036","14043","0.04984689881079541408530940682"
"2022-03-31T00:00:00.000","Whatcom","WA","Truck","30","0","30","43538","43568","0.06885787734116782959970620639"
"2022-03-31T00:00:00.000","Whatcom","WA","Passenger","1787","720","2507","149220","151727","1.652309740520803812109907927"
"2022-03-31T00:00:00.000","Whitman","WA","Truck","5","0","5","8589","8594","0.05818012566907144519432161973"
"2022-03-31T00:00:00.000","Whitman","WA","Passenger","82","57","139","22082","22221","0.6255344043922415732865307592"
"2022-03-31T00:00:00.000","Yakima","WA","Truck","6","0","6","61569","61575","0.009744214372716199756394640682"
"2022-03-31T00:00:00.000","Yakima","WA","Passenger","326","194","520","167702","168222","0.3091153356873655051063475645"
"2022-03-31T00:00:00.000","Douglas","WI","Passenger","1","0","1","1","2","50.0"
"2022-03-31T00:00:00.000","Ozaukee","WI","Passenger","0","1","1","2","3","33.33333333333333333333333333"
"2022-04-30T00:00:00.000","Anchorage","AK","Passenger","1","0","1","112","113","0.8849557522123893805309734513"
"2022-04-30T00:00:00.000","Fairbanks North Star","AK","Passenger","0","1","1","72","73","1.369863013698630136986301370"
"2022-04-30T00:00:00.000","Juneau","AK","Passenger","0","1","1","26","27","3.703703703703703703703703704"
"2022-04-30T00:00:00.000","Montgomery","AL","Passenger","0","1","1","33","34","2.941176470588235294117647059"
"2022-04-30T00:00:00.000","Maricopa","AZ","Passenger","4","3","7","705","712","0.9831460674157303370786516854"
"2022-04-30T00:00:00.000","Pima","AZ","Passenger","1","1","2","188","190","1.052631578947368421052631579"
"2022-04-30T00:00:00.000","Pinal","AZ","Passenger","1","0","1","87","88","1.136363636363636363636363636"
"2022-04-30T00:00:00.000","Alameda","CA","Passenger","3","0","3","170","173","1.734104046242774566473988439"
"2022-04-30T00:00:00.000","Contra Costa","CA","Passenger","0","5","5","296","301","1.661129568106312292358803987"
"2022-04-30T00:00:00.000","Fresno","CA","Passenger","1","0","1","127","128","0.7812500"
"2022-04-30T00:00:00.000","Kern","CA","Passenger","1","1","2","169","171","1.169590643274853801169590643"
"2022-04-30T00:00:00.000","Kings","CA","Passenger","1","0","1","291","292","0.3424657534246575342465753425"
"2022-04-30T00:00:00.000","Los Angeles","CA","Passenger","3","5","8","662","670","1.194029850746268656716417910"
"2022-04-30T00:00:00.000","Marin","CA","Passenger","0","1","1","30","31","3.225806451612903225806451613"
"2022-04-30T00:00:00.000","Monterey","CA","Passenger","1","1","2","118","120","1.666666666666666666666666667"
"2022-04-30T00:00:00.000","Orange","CA","Passenger","5","2","7","327","334","2.095808383233532934131736527"
"2022-04-30T00:00:00.000","Placer","CA","Passenger","1","0","1","55","56","1.785714285714285714285714286"
"2022-04-30T00:00:00.000","Riverside","CA","Passenger","7","1","8","400","408","1.960784313725490196078431373"
"2022-04-30T00:00:00.000","Sacramento","CA","Passenger","1","0","1","183","184","0.5434782608695652173913043478"
"2022-04-30T00:00:00.000","San Bernardino","CA","Passenger","1","2","3","307","310","0.9677419354838709677419354839"
"2022-04-30T00:00:00.000","San Diego","CA","Passenger","13","9","22","2168","2190","1.004566210045662100456621005"
"2022-04-30T00:00:00.000","San Joaquin","CA","Passenger","0","1","1","79","80","1.2500"
"2022-04-30T00:00:00.000","San Luis Obispo","CA","Passenger","1","0","1","48","49","2.040816326530612244897959184"
"2022-04-30T00:00:00.000","Santa Barbara","CA","Passenger","1","0","1","64","65","1.538461538461538461538461538"
"2022-04-30T00:00:00.000","Santa Clara","CA","Passenger","5","1","6","175","181","3.314917127071823204419889503"
"2022-04-30T00:00:00.000","Santa Cruz","CA","Passenger","1","0","1","19","20","5.00"
"2022-04-30T00:00:00.000","Solano","CA","Passenger","1","0","1","157","158","0.6329113924050632911392405063"
"2022-04-30T00:00:00.000","Sonoma","CA","Passenger","0","1","1","68","69","1.449275362318840579710144928"
"2022-04-30T00:00:00.000","Ventura","CA","Passenger","2","1","3","219","222","1.351351351351351351351351351"
"2022-04-30T00:00:00.000","Arapahoe","CO","Passenger","0","1","1","73","74","1.351351351351351351351351351"
"2022-04-30T00:00:00.000","Boulder","CO","Passenger","1","0","1","22","23","4.347826086956521739130434783"
"2022-04-30T00:00:00.000","El Paso","CO","Passenger","2","1","3","540","543","0.5524861878453038674033149171"
"2022-04-30T00:00:00.000","Larimer","CO","Passenger","1","0","1","38","39","2.564102564102564102564102564"
"2022-04-30T00:00:00.000","Las Animas","CO","Passenger","1","0","1","0","1","100"
"2022-04-30T00:00:00.000","New London","CT","Passenger","1","4","5","199","204","2.450980392156862745098039216"
"2022-04-30T00:00:00.000","District of Columbia","DC","Passenger","3","2","5","176","181","2.762430939226519337016574586"
"2022-04-30T00:00:00.000","Kent","DE","Passenger","0","1","1","48","49","2.040816326530612244897959184"
"2022-04-30T00:00:00.000","New Castle","DE","Passenger","1","0","1","18","19","5.263157894736842105263157895"
"2022-04-30T00:00:00.000","Broward","FL","Passenger","1","0","1","68","69","1.449275362318840579710144928"
"2022-04-30T00:00:00.000","Duval","FL","Passenger","0","1","1","239","240","0.4166666666666666666666666667"
"2022-04-30T00:00:00.000","Hillsborough","FL","Passenger","0","2","2","106","108","1.851851851851851851851851852"
"2022-04-30T00:00:00.000","Lake","FL","Passenger","1","0","1","16","17","5.882352941176470588235294118"
"2022-04-30T00:00:00.000","Monroe","FL","Passenger","0","1","1","37","38","2.631578947368421052631578947"
"2022-04-30T00:00:00.000","Okaloosa","FL","Passenger","0","1","1","83","84","1.190476190476190476190476190"
"2022-04-30T00:00:00.000","Orange","FL","Passenger","1","0","1","75","76","1.315789473684210526315789474"
"2022-04-30T00:00:00.000","Palm Beach","FL","Passenger","1","0","1","38","39","2.564102564102564102564102564"
"2022-04-30T00:00:00.000","Pinellas","FL","Passenger","0","1","1","62","63","1.587301587301587301587301587"
"2022-04-30T00:00:00.000","Sarasota","FL","Passenger","2","0","2","22","24","8.333333333333333333333333333"
"2022-04-30T00:00:00.000","St. Johns","FL","Passenger","0","1","1","28","29","3.448275862068965517241379310"
"2022-04-30T00:00:00.000","Bartow","GA","Passenger","0","1","1","2","3","33.33333333333333333333333333"
"2022-04-30T00:00:00.000","Bryan","GA","Passenger","1","0","1","39","40","2.500"
"2022-04-30T00:00:00.000","Columbia","GA","Passenger","1","1","2","86","88","2.272727272727272727272727273"
"2022-04-30T00:00:00.000","DeKalb","GA","Passenger","1","0","1","37","38","2.631578947368421052631578947"
"2022-04-30T00:00:00.000","Houston","GA","Passenger","1","0","1","36","37","2.702702702702702702702702703"
"2022-04-30T00:00:00.000","Liberty","GA","Passenger","1","0","1","90","91","1.098901098901098901098901099"
"2022-04-30T00:00:00.000","Rockdale","GA","Passenger","1","0","1","6","7","14.28571428571428571428571429"
"2022-04-30T00:00:00.000","Honolulu","HI","Passenger","4","2","6","291","297","2.020202020202020202020202020"
"2022-04-30T00:00:00.000","Cook","IL","Passenger","2","0","2","151","153","1.307189542483660130718954248"
"2022-04-30T00:00:00.000","DuPage","IL","Passenger","1","0","1","36","37","2.702702702702702702702702703"
"2022-04-30T00:00:00.000","Lake","IL","Passenger","4","0","4","142","146","2.739726027397260273972602740"
"2022-04-30T00:00:00.000","Rock Island","IL","Passenger","0","1","1","13","14","7.142857142857142857142857143"
"2022-04-30T00:00:00.000","St. Clair","IL","Passenger","2","0","2","113","115","1.739130434782608695652173913"
"2022-04-30T00:00:00.000","Hamilton","IN","Passenger","1","0","1","21","22","4.545454545454545454545454545"
"2022-04-30T00:00:00.000","Howard","IN","Passenger","0","1","1","6","7","14.28571428571428571428571429"
"2022-04-30T00:00:00.000","Geary","KS","Passenger","1","0","1","76","77","1.298701298701298701298701299"
"2022-04-30T00:00:00.000","Leavenworth","KS","Passenger","1","1","2","97","99","2.020202020202020202020202020"
"2022-04-30T00:00:00.000","Oldham","KY","Passenger","0","1","1","4","5","20.0"
"2022-04-30T00:00:00.000","Plaquemines","LA","Passenger","0","1","1","13","14","7.142857142857142857142857143"
"2022-04-30T00:00:00.000","Middlesex","MA","Passenger","1","1","2","75","77","2.597402597402597402597402597"
"2022-04-30T00:00:00.000","Suffolk","MA","Passenger","0","1","1","26","27","3.703703703703703703703703704"
"2022-04-30T00:00:00.000","Anne Arundel","MD","Passenger","4","2","6","324","330","1.818181818181818181818181818"
"2022-04-30T00:00:00.000","Baltimore","MD","Passenger","1","0","1","60","61","1.639344262295081967213114754"
"2022-04-30T00:00:00.000","Calvert","MD","Passenger","0","2","2","74","76","2.631578947368421052631578947"
"2022-04-30T00:00:00.000","Carroll","MD","Passenger","0","1","1","9","10","10.0"
"2022-04-30T00:00:00.000","Charles","MD","Passenger","0","1","1","51","52","1.923076923076923076923076923"
"2022-04-30T00:00:00.000","Charles","MD","Truck","1","0","1","9","10","10.0"
"2022-04-30T00:00:00.000","Frederick","MD","Passenger","2","1","3","68","71","4.225352112676056338028169014"
"2022-04-30T00:00:00.000","Howard","MD","Passenger","0","1","1","55","56","1.785714285714285714285714286"
"2022-04-30T00:00:00.000","Montgomery","MD","Passenger","3","5","8","185","193","4.145077720207253886010362694"
"2022-04-30T00:00:00.000","Prince George's","MD","Passenger","1","0","1","110","111","0.9009009009009009009009009009"
"2022-04-30T00:00:00.000","St. Mary's","MD","Passenger","1","0","1","159","160","0.62500"
"2022-04-30T00:00:00.000","St. Mary's","MD","Truck","1","0","1","40","41","2.439024390243902439024390244"
"2022-04-30T00:00:00.000","Washington","MD","Passenger","2","0","2","11","13","15.38461538461538461538461538"
"2022-04-30T00:00:00.000","Penobscot","ME","Passenger","0","1","1","7","8","12.500"
"2022-04-30T00:00:00.000","Hennepin","MN","Passenger","1","0","1","46","47","2.127659574468085106382978723"
"2022-04-30T00:00:00.000","Kanabec","MN","Passenger","1","0","1","0","1","100"
"2022-04-30T00:00:00.000","Boone","MO","Passenger","0","1","1","9","10","10.0"
"2022-04-30T00:00:00.000","Greene","MO","Passenger","0","1","1","16","17","5.882352941176470588235294118"
"2022-04-30T00:00:00.000","Platte","MO","Passenger","1","0","1","15","16","6.2500"
"2022-04-30T00:00:00.000","Ray","MO","Passenger","0","1","1","0","1","100"
"2022-04-30T00:00:00.000","St. Louis","MO","Passenger","1","0","1","65","66","1.515151515151515151515151515"
"2022-04-30T00:00:00.000","Harrison","MS","Passenger","2","0","2","40","42","4.761904761904761904761904762"
"2022-04-30T00:00:00.000","Glacier","MT","Passenger","0","1","1","5","6","16.66666666666666666666666667"
"2022-04-30T00:00:00.000","Cumberland","NC","Passenger","0","2","2","358","360","0.5555555555555555555555555556"
"2022-04-30T00:00:00.000","Cumberland","NC","Truck","1","0","1","80","81","1.234567901234567901234567901"
"2022-04-30T00:00:00.000","Mecklenburg","NC","Passenger","1","0","1","53","54","1.851851851851851851851851852"
"2022-04-30T00:00:00.000","Moore","NC","Passenger","0","1","1","116","117","0.8547008547008547008547008547"
"2022-04-30T00:00:00.000","Onslow","NC","Passenger","0","1","1","140","141","0.7092198581560283687943262411"
"2022-04-30T00:00:00.000","Wake","NC","Passenger","1","0","1","70","71","1.408450704225352112676056338"
"2022-04-30T00:00:00.000","Wayne","NC","Passenger","1","0","1","25","26","3.846153846153846153846153846"
"2022-04-30T00:00:00.000","Wilson","NC","Passenger","1","0","1","1","2","50.0"
"2022-04-30T00:00:00.000","Williams","ND","Passenger","0","1","1","7","8","12.500"
"2022-04-30T00:00:00.000","Douglas","NE","Passenger","1","2","3","41","44","6.818181818181818181818181818"
"2022-04-30T00:00:00.000","Sarpy","NE","Passenger","1","0","1","44","45","2.222222222222222222222222222"
"2022-04-30T00:00:00.000","Carroll","NH","Passenger","0","1","1","3","4","25.00"
"2022-04-30T00:00:00.000","Burlington","NJ","Passenger","0","2","2","112","114","1.754385964912280701754385965"
"2022-04-30T00:00:00.000","Camden","NJ","Passenger","0","1","1","8","9","11.11111111111111111111111111"
"2022-04-30T00:00:00.000","Hudson","NJ","Passenger","1","0","1","80","81","1.234567901234567901234567901"
"2022-04-30T00:00:00.000","Hudson","NJ","Truck","1","0","1","9","10","10.0"
"2022-04-30T00:00:00.000","Chaves","NM","Passenger","1","0","1","4","5","20.0"
"2022-04-30T00:00:00.000","Carson City","NV","Passenger","1","0","1","7","8","12.500"
"2022-04-30T00:00:00.000","Clark","NV","Passenger","5","4","9","477","486","1.851851851851851851851851852"
"2022-04-30T00:00:00.000","Washoe","NV","Passenger","1","0","1","50","51","1.960784313725490196078431373"
"2022-04-30T00:00:00.000","Jefferson","NY","Passenger","0","1","1","182","183","0.5464480874316939890710382514"
"2022-04-30T00:00:00.000","Kings","NY","Passenger","1","0","1","46","47","2.127659574468085106382978723"
"2022-04-30T00:00:00.000","New York","NY","Passenger","1","0","1","39","40","2.500"
"2022-04-30T00:00:00.000","Queens","NY","Passenger","1","0","1","31","32","3.12500"
"2022-04-30T00:00:00.000","Saratoga","NY","Passenger","1","0","1","35","36","2.777777777777777777777777778"
"2022-04-30T00:00:00.000","Hamilton","OH","Passenger","1","0","1","24","25","4.00"
"2022-04-30T00:00:00.000","Shelby","OH","Passenger","0","1","1","2","3","33.33333333333333333333333333"
"2022-04-30T00:00:00.000","Rogers","OK","Passenger","1","0","1","2","3","33.33333333333333333333333333"
"2022-04-30T00:00:00.000","Clackamas","OR","Passenger","2","0","2","124","126","1.587301587301587301587301587"
"2022-04-30T00:00:00.000","Douglas","OR","Passenger","1","0","1","26","27","3.703703703703703703703703704"
"2022-04-30T00:00:00.000","Lincoln","OR","Passenger","0","1","1","29","30","3.333333333333333333333333333"
"2022-04-30T00:00:00.000","Multnomah","OR","Passenger","0","3","3","449","452","0.6637168141592920353982300885"
"2022-04-30T00:00:00.000","Allegheny","PA","Passenger","1","1","2","42","44","4.545454545454545454545454545"
"2022-04-30T00:00:00.000","Montgomery","PA","Passenger","2","0","2","13","15","13.33333333333333333333333333"
"2022-04-30T00:00:00.000","Philadelphia","PA","Passenger","1","0","1","32","33","3.030303030303030303030303030"
"2022-04-30T00:00:00.000","RÃ­o Grande","PR","Passenger","1","0","1","0","1","100"
"2022-04-30T00:00:00.000","Newport","RI","Passenger","1","0","1","74","75","1.333333333333333333333333333"
"2022-04-30T00:00:00.000","Newport","RI","Truck","1","0","1","11","12","8.333333333333333333333333333"
"2022-04-30T00:00:00.000","Charleston","SC","Passenger","1","0","1","56","57","1.754385964912280701754385965"
"2022-04-30T00:00:00.000","Richland","SC","Passenger","0","1","1","117","118","0.8474576271186440677966101695"
"2022-04-30T00:00:00.000","Spartanburg","SC","Passenger","0","1","1","24","25","4.00"
"2022-04-30T00:00:00.000","Sumter","SC","Passenger","0","1","1","27","28","3.571428571428571428571428571"
"2022-04-30T00:00:00.000","Pennington","SD","Passenger","1","0","1","26","27","3.703703703703703703703703704"
"2022-04-30T00:00:00.000","Davidson","TN","Passenger","1","0","1","30","31","3.225806451612903225806451613"
"2022-04-30T00:00:00.000","Montgomery","TN","Passenger","1","0","1","164","165","0.6060606060606060606060606061"
"2022-04-30T00:00:00.000","Tipton","TN","Passenger","1","0","1","11","12","8.333333333333333333333333333"
"2022-04-30T00:00:00.000","Bell","TX","Passenger","0","1","1","279","280","0.3571428571428571428571428571"
"2022-04-30T00:00:00.000","Bexar","TX","Passenger","5","3","8","392","400","2.00"
"2022-04-30T00:00:00.000","Coryell","TX","Passenger","1","0","1","90","91","1.098901098901098901098901099"
"2022-04-30T00:00:00.000","Dallas","TX","Passenger","1","0","1","95","96","1.041666666666666666666666667"
"2022-04-30T00:00:00.000","Denton","TX","Passenger","1","0","1","45","46","2.173913043478260869565217391"
"2022-04-30T00:00:00.000","El Paso","TX","Passenger","1","0","1","311","312","0.3205128205128205128205128205"
"2022-04-30T00:00:00.000","Galveston","TX","Passenger","0","1","1","16","17","5.882352941176470588235294118"
"2022-04-30T00:00:00.000","Harris","TX","Passenger","2","0","2","134","136","1.470588235294117647058823529"
"2022-04-30T00:00:00.000","Hidalgo","TX","Passenger","0","1","1","52","53","1.886792452830188679245283019"
"2022-04-30T00:00:00.000","Montgomery","TX","Passenger","1","0","1","21","22","4.545454545454545454545454545"
"2022-04-30T00:00:00.000","Nueces","TX","Passenger","1","0","1","50","51","1.960784313725490196078431373"
"2022-04-30T00:00:00.000","Tarrant","TX","Passenger","1","0","1","94","95","1.052631578947368421052631579"
"2022-04-30T00:00:00.000","Wichita","TX","Passenger","1","0","1","35","36","2.777777777777777777777777778"
"2022-04-30T00:00:00.000","Williamson","TX","Passenger","1","0","1","69","70","1.428571428571428571428571429"
"2022-04-30T00:00:00.000","Salt Lake","UT","Passenger","2","2","4","109","113","3.539823008849557522123893805"
"2022-04-30T00:00:00.000","Albemarle","VA","Passenger","1","0","1","16","17","5.882352941176470588235294118"
"2022-04-30T00:00:00.000","Alexandria","VA","Passenger","5","0","5","117","122","4.098360655737704918032786885"
"2022-04-30T00:00:00.000","Chesapeake","VA","Passenger","1","3","4","338","342","1.169590643274853801169590643"
"2022-04-30T00:00:00.000","Danville","VA","Passenger","1","0","1","0","1","100"
"2022-04-30T00:00:00.000","Fairfax","VA","Passenger","4","3","7","585","592","1.182432432432432432432432432"
"2022-04-30T00:00:00.000","Goochland","VA","Passenger","3","0","3","93","96","3.12500"
"2022-04-30T00:00:00.000","Loudoun","VA","Passenger","2","0","2","54","56","3.571428571428571428571428571"
"2022-04-30T00:00:00.000","Manassas","VA","Passenger","0","1","1","4","5","20.0"
"2022-04-30T00:00:00.000","Norfolk","VA","Passenger","1","1","2","280","282","0.7092198581560283687943262411"
"2022-04-30T00:00:00.000","Portsmouth","VA","Passenger","1","1","2","59","61","3.278688524590163934426229508"
"2022-04-30T00:00:00.000","Powhatan","VA","Passenger","1","0","1","1","2","50.0"
"2022-04-30T00:00:00.000","Prince William","VA","Truck","1","0","1","22","23","4.347826086956521739130434783"
"2022-04-30T00:00:00.000","Prince William","VA","Passenger","0","1","1","182","183","0.5464480874316939890710382514"
"2022-04-30T00:00:00.000","Stafford","VA","Passenger","2","1","3","84","87","3.448275862068965517241379310"
"2022-04-30T00:00:00.000","Suffolk","VA","Passenger","1","0","1","100","101","0.9900990099009900990099009901"
"2022-04-30T00:00:00.000","Virginia Beach","VA","Passenger","2","0","2","468","470","0.4255319148936170212765957447"
"2022-04-30T00:00:00.000","Adams","WA","Truck","1","0","1","5473","5474","0.01826817683595177201315308732"
"2022-04-30T00:00:00.000","Adams","WA","Passenger","16","12","28","12968","12996","0.2154509079716835949522930132"
"2022-04-30T00:00:00.000","Asotin","WA","Truck","2","0","2","6748","6750","0.02962962962962962962962962963"
"2022-04-30T00:00:00.000","Asotin","WA","Passenger","25","20","45","12727","12772","0.3523332289383025367992483558"
"2022-04-30T00:00:00.000","Benton","WA","Truck","37","0","37","43545","43582","0.08489743472075627552659354779"
"2022-04-30T00:00:00.000","Benton","WA","Passenger","726","454","1180","135436","136616","0.8637348480412250395268489782"
"2022-04-30T00:00:00.000","Chelan","WA","Truck","12","0","12","23035","23047","0.05206751421009241983772291405"
"2022-04-30T00:00:00.000","Chelan","WA","Passenger","453","125","578","54514","55092","1.049154142162201408552965948"
"2022-04-30T00:00:00.000","Clallam","WA","Truck","7","0","7","21976","21983","0.03184278760860665059364054042"
"2022-04-30T00:00:00.000","Clallam","WA","Passenger","415","248","663","49814","50477","1.313469500960833647007547992"
"2022-04-30T00:00:00.000","Clark","WA","Truck","77","0","77","83119","83196","0.09255252656377710466849367758"
"2022-04-30T00:00:00.000","Clark","WA","Passenger","3965","1733","5698","317560","323258","1.762678727208607366252343329"
"2022-04-30T00:00:00.000","Columbia","WA","Passenger","7","0","7","2442","2449","0.2858309514087382605144957125"
"2022-04-30T00:00:00.000","Columbia","WA","Truck","2","0","2","1588","1590","0.1257861635220125786163522013"
"2022-04-30T00:00:00.000","Cowlitz","WA","Passenger","330","181","511","70869","71380","0.7158868030260577192490893808"
"2022-04-30T00:00:00.000","Cowlitz","WA","Truck","10","1","11","28718","28729","0.03828883706359427755926067736"
"2022-04-30T00:00:00.000","Douglas","WA","Passenger","126","58","184","28522","28706","0.6409809795861492370932906013"
"2022-04-30T00:00:00.000","Douglas","WA","Truck","5","0","5","12758","12763","0.03917574238031810702812818303"
"2022-04-30T00:00:00.000","Ferry","WA","Truck","0","0","0","3563","3563","0"
"2022-04-30T00:00:00.000","Ferry","WA","Passenger","19","4","23","4411","4434","0.5187189896256202074875958502"
"2022-04-30T00:00:00.000","Franklin","WA","Truck","9","0","9","20934","20943","0.04297378599054576708207993124"
"2022-04-30T00:00:00.000","Franklin","WA","Passenger","184","110","294","61976","62270","0.4721374658744178577163963385"
"2022-04-30T00:00:00.000","Garfield","WA","Truck","0","0","0","985","985","0"
"2022-04-30T00:00:00.000","Garfield","WA","Passenger","0","3","3","1338","1341","0.2237136465324384787472035794"
"2022-04-30T00:00:00.000","Grant","WA","Passenger","166","104","270","66809","67079","0.4025104727261885239791887178"
"2022-04-30T00:00:00.000","Grant","WA","Truck","9","0","9","28039","28048","0.03208784940102681118083285796"
"2022-04-30T00:00:00.000","Grays Harbor","WA","Passenger","214","166","380","49158","49538","0.7670878921232185393031612096"
"2022-04-30T00:00:00.000","Grays Harbor","WA","Truck","12","0","12","21301","21313","0.05630366443015999624642237132"
"2022-04-30T00:00:00.000","Island","WA","Passenger","796","382","1178","62426","63604","1.852084774542481604930507515"
"2022-04-30T00:00:00.000","Island","WA","Truck","17","0","17","21495","21512","0.07902566009669021941242097434"
"2022-04-30T00:00:00.000","Jefferson","WA","Truck","5","0","5","9526","9531","0.05246039240373517993914594481"
"2022-04-30T00:00:00.000","Jefferson","WA","Passenger","422","220","642","24726","25368","2.530747398297067171239356670"
"2022-04-30T00:00:00.000","King","WA","Truck","247","1","248","181522","181770","0.1364361555812290256918083292"
"2022-04-30T00:00:00.000","King","WA","Passenger","39733","11105","50838","1350636","1401474","3.627466510259912064012603873"
"2022-04-30T00:00:00.000","Kitsap","WA","Truck","47","0","47","53914","53961","0.08709994255110172161375808454"
"2022-04-30T00:00:00.000","Kitsap","WA","Passenger","2410","1057","3467","179358","182825","1.896348967591959524135101873"
"2022-04-30T00:00:00.000","Kittitas","WA","Truck","7","0","7","14702","14709","0.04758991093888095723706574206"
"2022-04-30T00:00:00.000","Kittitas","WA","Passenger","240","79","319","29709","30028","1.062341814306647129345943786"
"2022-04-30T00:00:00.000","Klickitat","WA","Passenger","102","56","158","15223","15381","1.027241401729406410506469020"
"2022-04-30T00:00:00.000","Klickitat","WA","Truck","2","0","2","8261","8263","0.02420428415829601839525596030"
"2022-04-30T00:00:00.000","Lewis","WA","Passenger","241","177","418","59457","59875","0.6981210855949895615866388309"
"2022-04-30T00:00:00.000","Lewis","WA","Truck","9","0","9","26448","26457","0.03401746229731262047851230298"
"2022-04-30T00:00:00.000","Lincoln","WA","Passenger","9","18","27","7667","7694","0.3509227969846633740577073044"
"2022-04-30T00:00:00.000","Lincoln","WA","Truck","0","0","0","4861","4861","0"
"2022-04-30T00:00:00.000","Mason","WA","Passenger","311","187","498","47485","47983","1.037867578100577287789425422"
"2022-04-30T00:00:00.000","Mason","WA","Truck","13","0","13","21111","21124","0.06154137473963264533232342359"
"2022-04-30T00:00:00.000","Okanogan","WA","Passenger","80","49","129","26434","26563","0.4856379174039076911493430712"
"2022-04-30T00:00:00.000","Okanogan","WA","Truck","3","0","3","16662","16665","0.01800180018001800180018001800"
"2022-04-30T00:00:00.000","Pacific","WA","Passenger","69","71","140","15929","16069","0.8712427655734644346256767689"
"2022-04-30T00:00:00.000","Pacific","WA","Truck","2","0","2","7973","7975","0.02507836990595611285266457680"
"2022-04-30T00:00:00.000","Pend Oreille","WA","Passenger","16","10","26","9035","9061","0.2869440459110473457675753228"
"2022-04-30T00:00:00.000","Pend Oreille","WA","Truck","1","0","1","5647","5648","0.01770538243626062322946175637"
"2022-04-30T00:00:00.000","Pierce","WA","Passenger","5049","2347","7396","549234","556630","1.328710274329446849792501302"
"2022-04-30T00:00:00.000","Pierce","WA","Truck","104","0","104","143003","143107","0.07267289510645880355258652617"
"2022-04-30T00:00:00.000","San Juan","WA","Truck","4","0","4","5973","5977","0.06692320562154927221013886565"
"2022-04-30T00:00:00.000","San Juan","WA","Passenger","493","155","648","14115","14763","4.389351757772810404389351758"
"2022-04-30T00:00:00.000","Skagit","WA","Passenger","778","349","1127","90223","91350","1.233716475095785440613026820"
"2022-04-30T00:00:00.000","Skagit","WA","Truck","27","0","27","32471","32498","0.08308203581758877469382731245"
"2022-04-30T00:00:00.000","Skamania","WA","Truck","0","0","0","3969","3969","0"
"2022-04-30T00:00:00.000","Skamania","WA","Passenger","70","47","117","8211","8328","1.404899135446685878962536023"
"2022-04-30T00:00:00.000","Snohomish","WA","Passenger","8116","2513","10629","533787","544416","1.952367307353200493740081114"
"2022-04-30T00:00:00.000","Snohomish","WA","Truck","110","0","110","124455","124565","0.08830730943684020390960542689"
"2022-04-30T00:00:00.000","Spokane","WA","Passenger","1554","842","2396","325704","328100","0.7302651630600426699177080158"
"2022-04-30T00:00:00.000","Spokane","WA","Truck","61","0","61","102399","102460","0.05953542845988678508686316611"
"2022-04-30T00:00:00.000","Stevens","WA","Truck","2","0","2","18965","18967","0.01054463014709759055201138820"
"2022-04-30T00:00:00.000","Stevens","WA","Passenger","67","52","119","30120","30239","0.3935315321273851648533350971"
"2022-04-30T00:00:00.000","Thurston","WA","Passenger","2168","1068","3236","195239","198475","1.630432044338077843557123063"
"2022-04-30T00:00:00.000","Thurston","WA","Truck","50","0","50","55628","55678","0.08980207622400229893315133446"
"2022-04-30T00:00:00.000","Wahkiakum","WA","Truck","0","0","0","1817","1817","0"
"2022-04-30T00:00:00.000","Wahkiakum","WA","Passenger","20","12","32","3080","3112","1.028277634961439588688946015"
"2022-04-30T00:00:00.000","Walla Walla","WA","Truck","7","0","7","14011","14018","0.04993579683264374375802539592"
"2022-04-30T00:00:00.000","Walla Walla","WA","Passenger","164","96","260","36038","36298","0.7162929087002038679817069811"
"2022-04-30T00:00:00.000","Whatcom","WA","Passenger","1829","743","2572","148961","151533","1.697320055697438841704447216"
"2022-04-30T00:00:00.000","Whatcom","WA","Truck","29","0","29","43419","43448","0.06674645553305100349843491070"
"2022-04-30T00:00:00.000","Whitman","WA","Truck","5","0","5","8585","8590","0.05820721769499417927823050058"
"2022-04-30T00:00:00.000","Whitman","WA","Passenger","85","59","144","22070","22214","0.6482398487440352930584316197"
"2022-04-30T00:00:00.000","Yakima","WA","Passenger","331","196","527","167301","167828","0.3140119646304549896322425340"
"2022-04-30T00:00:00.000","Yakima","WA","Truck","6","0","6","61417","61423","0.009768327825081809745535060157"
"2022-04-30T00:00:00.000","Douglas","WI","Passenger","1","0","1","1","2","50.0"
"2022-04-30T00:00:00.000","Ozaukee","WI","Passenger","0","1","1","2","3","33.33333333333333333333333333"
"2022-05-31T00:00:00.000","Anchorage","AK","Passenger","1","0","1","106","107","0.9345794392523364485981308411"
"2022-05-31T00:00:00.000","Fairbanks North Star","AK","Passenger","0","1","1","70","71","1.408450704225352112676056338"
"2022-05-31T00:00:00.000","Juneau","AK","Passenger","0","1","1","26","27","3.703703703703703703703703704"
"2022-05-31T00:00:00.000","Montgomery","AL","Passenger","0","1","1","32","33","3.030303030303030303030303030"
"2022-05-31T00:00:00.000","Maricopa","AZ","Passenger","4","3","7","675","682","1.026392961876832844574780059"
"2022-05-31T00:00:00.000","Pima","AZ","Passenger","1","0","1","184","185","0.5405405405405405405405405405"
"2022-05-31T00:00:00.000","Pinal","AZ","Passenger","1","0","1","86","87","1.149425287356321839080459770"
"2022-05-31T00:00:00.000","Alameda","CA","Passenger","3","0","3","161","164","1.829268292682926829268292683"
"2022-05-31T00:00:00.000","Contra Costa","CA","Passenger","0","6","6","291","297","2.020202020202020202020202020"
"2022-05-31T00:00:00.000","Fresno","CA","Passenger","1","0","1","122","123","0.8130081300813008130081300813"
"2022-05-31T00:00:00.000","Kern","CA","Passenger","1","1","2","163","165","1.212121212121212121212121212"
"2022-05-31T00:00:00.000","Kings","CA","Passenger","1","0","1","285","286","0.3496503496503496503496503497"
"2022-05-31T00:00:00.000","Los Angeles","CA","Passenger","3","6","9","646","655","1.374045801526717557251908397"
"2022-05-31T00:00:00.000","Marin","CA","Passenger","0","1","1","29","30","3.333333333333333333333333333"
"2022-05-31T00:00:00.000","Monterey","CA","Passenger","1","1","2","115","117","1.709401709401709401709401709"
"2022-05-31T00:00:00.000","Orange","CA","Passenger","5","2","7","320","327","2.140672782874617737003058104"
"2022-05-31T00:00:00.000","Placer","CA","Passenger","1","0","1","51","52","1.923076923076923076923076923"
"2022-05-31T00:00:00.000","Riverside","CA","Passenger","8","1","9","391","400","2.2500"
"2022-05-31T00:00:00.000","Sacramento","CA","Passenger","1","0","1","173","174","0.5747126436781609195402298851"
"2022-05-31T00:00:00.000","San Bernardino","CA","Passenger","1","2","3","293","296","1.013513513513513513513513514"
"2022-05-31T00:00:00.000","San Diego","CA","Passenger","13","8","21","2108","2129","0.9863785814936589948332550493"
"2022-05-31T00:00:00.000","San Joaquin","CA","Passenger","0","1","1","77","78","1.282051282051282051282051282"
"2022-05-31T00:00:00.000","San Luis Obispo","CA","Passenger","1","0","1","49","50","2.00"
"2022-05-31T00:00:00.000","Santa Barbara","CA","Passenger","1","0","1","62","63","1.587301587301587301587301587"
"2022-05-31T00:00:00.000","Santa Clara","CA","Passenger","6","1","7","170","177","3.954802259887005649717514124"
"2022-05-31T00:00:00.000","Santa Cruz","CA","Passenger","1","0","1","18","19","5.263157894736842105263157895"
"2022-05-31T00:00:00.000","Solano","CA","Passenger","1","0","1","159","160","0.62500"
"2022-05-31T00:00:00.000","Sonoma","CA","Passenger","0","1","1","69","70","1.428571428571428571428571429"
"2022-05-31T00:00:00.000","Ventura","CA","Passenger","1","1","2","217","219","0.9132420091324200913242009132"
"2022-05-31T00:00:00.000","Arapahoe","CO","Passenger","0","1","1","70","71","1.408450704225352112676056338"
"2022-05-31T00:00:00.000","Boulder","CO","Passenger","1","0","1","22","23","4.347826086956521739130434783"
"2022-05-31T00:00:00.000","El Paso","CO","Passenger","2","1","3","526","529","0.5671077504725897920604914934"
"2022-05-31T00:00:00.000","Larimer","CO","Passenger","1","0","1","37","38","2.631578947368421052631578947"
"2022-05-31T00:00:00.000","Las Animas","CO","Passenger","1","0","1","0","1","100"
"2022-05-31T00:00:00.000","New London","CT","Passenger","1","4","5","193","198","2.525252525252525252525252525"
"2022-05-31T00:00:00.000","District of Columbia","DC","Passenger","4","2","6","171","177","3.389830508474576271186440678"
"2022-05-31T00:00:00.000","Kent","DE","Passenger","0","1","1","46","47","2.127659574468085106382978723"
"2022-05-31T00:00:00.000","New Castle","DE","Passenger","1","0","1","18","19","5.263157894736842105263157895"
"2022-05-31T00:00:00.000","Broward","FL","Passenger","1","0","1","62","63","1.587301587301587301587301587"
"2022-05-31T00:00:00.000","Duval","FL","Passenger","0","1","1","233","234","0.4273504273504273504273504274"
"2022-05-31T00:00:00.000","Hillsborough","FL","Passenger","0","1","1","103","104","0.9615384615384615384615384615"
"2022-05-31T00:00:00.000","Lake","FL","Passenger","1","0","1","15","16","6.2500"
"2022-05-31T00:00:00.000","Monroe","FL","Passenger","0","1","1","36","37","2.702702702702702702702702703"
"2022-05-31T00:00:00.000","Okaloosa","FL","Passenger","0","1","1","79","80","1.2500"
"2022-05-31T00:00:00.000","Orange","FL","Passenger","1","0","1","71","72","1.388888888888888888888888889"
"2022-05-31T00:00:00.000","Palm Beach","FL","Passenger","1","0","1","38","39","2.564102564102564102564102564"
"2022-05-31T00:00:00.000","Pinellas","FL","Passenger","0","1","1","60","61","1.639344262295081967213114754"
"2022-05-31T00:00:00.000","Sarasota","FL","Passenger","2","0","2","22","24","8.333333333333333333333333333"
"2022-05-31T00:00:00.000","St. Johns","FL","Passenger","0","1","1","27","28","3.571428571428571428571428571"
"2022-05-31T00:00:00.000","Bartow","GA","Passenger","0","1","1","2","3","33.33333333333333333333333333"
"2022-05-31T00:00:00.000","Bryan","GA","Passenger","1","0","1","38","39","2.564102564102564102564102564"
"2022-05-31T00:00:00.000","Columbia","GA","Passenger","1","1","2","82","84","2.380952380952380952380952381"
"2022-05-31T00:00:00.000","DeKalb","GA","Passenger","1","0","1","35","36","2.777777777777777777777777778"
"2022-05-31T00:00:00.000","Houston","GA","Passenger","1","0","1","32","33","3.030303030303030303030303030"
"2022-05-31T00:00:00.000","Liberty","GA","Passenger","1","0","1","88","89","1.123595505617977528089887640"
"2022-05-31T00:00:00.000","Rockdale","GA","Passenger","1","0","1","6","7","14.28571428571428571428571429"
"2022-05-31T00:00:00.000","Honolulu","HI","Passenger","4","2","6","279","285","2.105263157894736842105263158"
"2022-05-31T00:00:00.000","Cook","IL","Passenger","2","0","2","147","149","1.342281879194630872483221477"
"2022-05-31T00:00:00.000","DuPage","IL","Passenger","1","0","1","36","37","2.702702702702702702702702703"
"2022-05-31T00:00:00.000","Lake","IL","Passenger","4","0","4","140","144","2.777777777777777777777777778"
"2022-05-31T00:00:00.000","Rock Island","IL","Passenger","0","1","1","13","14","7.142857142857142857142857143"
"2022-05-31T00:00:00.000","St. Clair","IL","Passenger","2","0","2","110","112","1.785714285714285714285714286"
"2022-05-31T00:00:00.000","Hamilton","IN","Passenger","1","0","1","21","22","4.545454545454545454545454545"
"2022-05-31T00:00:00.000","Howard","IN","Passenger","0","1","1","5","6","16.66666666666666666666666667"
"2022-05-31T00:00:00.000","Geary","KS","Passenger","1","0","1","73","74","1.351351351351351351351351351"
"2022-05-31T00:00:00.000","Leavenworth","KS","Passenger","1","1","2","96","98","2.040816326530612244897959184"
"2022-05-31T00:00:00.000","Oldham","KY","Passenger","0","1","1","4","5","20.0"
"2022-05-31T00:00:00.000","Plaquemines","LA","Passenger","0","1","1","13","14","7.142857142857142857142857143"
"2022-05-31T00:00:00.000","Middlesex","MA","Passenger","1","1","2","69","71","2.816901408450704225352112676"
"2022-05-31T00:00:00.000","Suffolk","MA","Passenger","0","1","1","25","26","3.846153846153846153846153846"
"2022-05-31T00:00:00.000","Anne Arundel","MD","Passenger","4","3","7","310","317","2.208201892744479495268138801"
"2022-05-31T00:00:00.000","Baltimore","MD","Passenger","1","0","1","56","57","1.754385964912280701754385965"
"2022-05-31T00:00:00.000","Calvert","MD","Passenger","0","2","2","73","75","2.666666666666666666666666667"
"2022-05-31T00:00:00.000","Carroll","MD","Passenger","0","1","1","9","10","10.0"
"2022-05-31T00:00:00.000","Charles","MD","Truck","1","0","1","9","10","10.0"
"2022-05-31T00:00:00.000","Charles","MD","Passenger","0","1","1","49","50","2.00"
"2022-05-31T00:00:00.000","Frederick","MD","Passenger","2","1","3","65","68","4.411764705882352941176470588"
"2022-05-31T00:00:00.000","Howard","MD","Passenger","0","1","1","53","54","1.851851851851851851851851852"
"2022-05-31T00:00:00.000","Montgomery","MD","Passenger","3","5","8","186","194","4.123711340206185567010309278"
"2022-05-31T00:00:00.000","Prince George's","MD","Passenger","1","0","1","105","106","0.9433962264150943396226415094"
"2022-05-31T00:00:00.000","St. Mary's","MD","Passenger","1","0","1","157","158","0.6329113924050632911392405063"
"2022-05-31T00:00:00.000","St. Mary's","MD","Truck","1","0","1","40","41","2.439024390243902439024390244"
"2022-05-31T00:00:00.000","Washington","MD","Passenger","2","0","2","11","13","15.38461538461538461538461538"
"2022-05-31T00:00:00.000","Penobscot","ME","Passenger","0","1","1","8","9","11.11111111111111111111111111"
"2022-05-31T00:00:00.000","Hennepin","MN","Passenger","1","0","1","40","41","2.439024390243902439024390244"
"2022-05-31T00:00:00.000","Kanabec","MN","Passenger","1","0","1","0","1","100"
"2022-05-31T00:00:00.000","Boone","MO","Passenger","0","1","1","8","9","11.11111111111111111111111111"
"2022-05-31T00:00:00.000","Greene","MO","Passenger","0","1","1","16","17","5.882352941176470588235294118"
"2022-05-31T00:00:00.000","Platte","MO","Passenger","1","0","1","15","16","6.2500"
"2022-05-31T00:00:00.000","Ray","MO","Passenger","0","1","1","0","1","100"
"2022-05-31T00:00:00.000","St. Louis","MO","Passenger","1","0","1","63","64","1.562500"
"2022-05-31T00:00:00.000","Harrison","MS","Passenger","2","0","2","41","43","4.651162790697674418604651163"
"2022-05-31T00:00:00.000","Glacier","MT","Passenger","0","1","1","5","6","16.66666666666666666666666667"
"2022-05-31T00:00:00.000","Cumberland","NC","Passenger","0","2","2","345","347","0.5763688760806916426512968300"
"2022-05-31T00:00:00.000","Cumberland","NC","Truck","1","0","1","76","77","1.298701298701298701298701299"
"2022-05-31T00:00:00.000","Mecklenburg","NC","Passenger","1","0","1","49","50","2.00"
"2022-05-31T00:00:00.000","Moore","NC","Passenger","0","1","1","113","114","0.8771929824561403508771929825"
"2022-05-31T00:00:00.000","Onslow","NC","Passenger","0","1","1","138","139","0.7194244604316546762589928058"
"2022-05-31T00:00:00.000","Wake","NC","Passenger","1","0","1","65","66","1.515151515151515151515151515"
"2022-05-31T00:00:00.000","Wayne","NC","Passenger","1","0","1","25","26","3.846153846153846153846153846"
"2022-05-31T00:00:00.000","Williams","ND","Passenger","0","1","1","6","7","14.28571428571428571428571429"
"2022-05-31T00:00:00.000","Douglas","NE","Passenger","1","2","3","40","43","6.976744186046511627906976744"
"2022-05-31T00:00:00.000","Sarpy","NE","Passenger","1","0","1","43","44","2.272727272727272727272727273"
"2022-05-31T00:00:00.000","Carroll","NH","Passenger","0","1","1","3","4","25.00"
"2022-05-31T00:00:00.000","Burlington","NJ","Passenger","0","2","2","110","112","1.785714285714285714285714286"
"2022-05-31T00:00:00.000","Camden","NJ","Passenger","0","1","1","8","9","11.11111111111111111111111111"
"2022-05-31T00:00:00.000","Hudson","NJ","Passenger","1","0","1","77","78","1.282051282051282051282051282"
"2022-05-31T00:00:00.000","Hudson","NJ","Truck","1","0","1","9","10","10.0"
"2022-05-31T00:00:00.000","Chaves","NM","Passenger","1","0","1","3","4","25.00"
"2022-05-31T00:00:00.000","Carson City","NV","Passenger","1","0","1","7","8","12.500"
"2022-05-31T00:00:00.000","Clark","NV","Passenger","5","4","9","458","467","1.927194860813704496788008565"
"2022-05-31T00:00:00.000","Jefferson","NY","Passenger","0","1","1","180","181","0.5524861878453038674033149171"
"2022-05-31T00:00:00.000","Kings","NY","Passenger","1","0","1","44","45","2.222222222222222222222222222"
"2022-05-31T00:00:00.000","New York","NY","Passenger","1","0","1","37","38","2.631578947368421052631578947"
"2022-05-31T00:00:00.000","Queens","NY","Passenger","1","0","1","30","31","3.225806451612903225806451613"
"2022-05-31T00:00:00.000","Saratoga","NY","Passenger","1","0","1","35","36","2.777777777777777777777777778"
"2022-05-31T00:00:00.000","Hamilton","OH","Passenger","1","0","1","24","25","4.00"
"2022-05-31T00:00:00.000","Rogers","OK","Passenger","1","0","1","1","2","50.0"
"2022-05-31T00:00:00.000","Clackamas","OR","Passenger","2","0","2","121","123","1.626016260162601626016260163"
"2022-05-31T00:00:00.000","Douglas","OR","Passenger","1","0","1","25","26","3.846153846153846153846153846"
"2022-05-31T00:00:00.000","Lincoln","OR","Passenger","0","1","1","25","26","3.846153846153846153846153846"
"2022-05-31T00:00:00.000","Multnomah","OR","Passenger","0","3","3","436","439","0.6833712984054669703872437358"
"2022-05-31T00:00:00.000","Allegheny","PA","Passenger","1","1","2","41","43","4.651162790697674418604651163"
"2022-05-31T00:00:00.000","Montgomery","PA","Passenger","2","0","2","12","14","14.28571428571428571428571429"
"2022-05-31T00:00:00.000","Philadelphia","PA","Passenger","1","0","1","31","32","3.12500"
"2022-05-31T00:00:00.000","Newport","RI","Truck","1","0","1","11","12","8.333333333333333333333333333"
"2022-05-31T00:00:00.000","Newport","RI","Passenger","1","0","1","74","75","1.333333333333333333333333333"
"2022-05-31T00:00:00.000","Charleston","SC","Passenger","1","0","1","54","55","1.818181818181818181818181818"
"2022-05-31T00:00:00.000","Richland","SC","Passenger","0","1","1","114","115","0.8695652173913043478260869565"
"2022-05-31T00:00:00.000","Spartanburg","SC","Passenger","0","1","1","24","25","4.00"
"2022-05-31T00:00:00.000","Sumter","SC","Passenger","0","1","1","27","28","3.571428571428571428571428571"
"2022-05-31T00:00:00.000","Pennington","SD","Passenger","1","0","1","25","26","3.846153846153846153846153846"
"2022-05-31T00:00:00.000","Davidson","TN","Passenger","1","0","1","29","30","3.333333333333333333333333333"
"2022-05-31T00:00:00.000","Montgomery","TN","Passenger","1","0","1","158","159","0.6289308176100628930817610063"
"2022-05-31T00:00:00.000","Tipton","TN","Passenger","1","0","1","10","11","9.090909090909090909090909091"
"2022-05-31T00:00:00.000","Bell","TX","Passenger","0","1","1","274","275","0.3636363636363636363636363636"
"2022-05-31T00:00:00.000","Bexar","TX","Passenger","5","2","7","384","391","1.790281329923273657289002558"
"2022-05-31T00:00:00.000","Coryell","TX","Passenger","1","0","1","86","87","1.149425287356321839080459770"
"2022-05-31T00:00:00.000","Denton","TX","Passenger","1","0","1","44","45","2.222222222222222222222222222"
"2022-05-31T00:00:00.000","El Paso","TX","Passenger","1","0","1","302","303","0.3300330033003300330033003300"
"2022-05-31T00:00:00.000","Galveston","TX","Passenger","0","1","1","14","15","6.666666666666666666666666667"
"2022-05-31T00:00:00.000","Harris","TX","Passenger","2","0","2","127","129","1.550387596899224806201550388"
"2022-05-31T00:00:00.000","Hidalgo","TX","Passenger","0","1","1","52","53","1.886792452830188679245283019"
"2022-05-31T00:00:00.000","Montgomery","TX","Passenger","1","0","1","19","20","5.00"
"2022-05-31T00:00:00.000","Nueces","TX","Passenger","1","0","1","48","49","2.040816326530612244897959184"
"2022-05-31T00:00:00.000","Tarrant","TX","Passenger","1","0","1","90","91","1.098901098901098901098901099"
"2022-05-31T00:00:00.000","Wichita","TX","Passenger","1","0","1","34","35","2.857142857142857142857142857"
"2022-05-31T00:00:00.000","Williamson","TX","Passenger","1","0","1","68","69","1.449275362318840579710144928"
"2022-05-31T00:00:00.000","Salt Lake","UT","Passenger","2","2","4","108","112","3.571428571428571428571428571"
"2022-05-31T00:00:00.000","Albemarle","VA","Passenger","1","0","1","15","16","6.2500"
"2022-05-31T00:00:00.000","Alexandria","VA","Passenger","5","0","5","114","119","4.201680672268907563025210084"
"2022-05-31T00:00:00.000","Chesapeake","VA","Passenger","1","3","4","326","330","1.212121212121212121212121212"
"2022-05-31T00:00:00.000","Danville","VA","Passenger","1","0","1","0","1","100"
"2022-05-31T00:00:00.000","Fairfax","VA","Passenger","5","3","8","578","586","1.365187713310580204778156997"
"2022-05-31T00:00:00.000","Goochland","VA","Passenger","3","0","3","85","88","3.409090909090909090909090909"
"2022-05-31T00:00:00.000","Loudoun","VA","Passenger","2","0","2","52","54","3.703703703703703703703703704"
"2022-05-31T00:00:00.000","Louisa","VA","Passenger","0","1","1","0","1","100"
"2022-05-31T00:00:00.000","Manassas","VA","Passenger","0","1","1","4","5","20.0"
"2022-05-31T00:00:00.000","Norfolk","VA","Passenger","1","1","2","272","274","0.7299270072992700729927007299"
"2022-05-31T00:00:00.000","Portsmouth","VA","Passenger","1","1","2","59","61","3.278688524590163934426229508"
"2022-05-31T00:00:00.000","Powhatan","VA","Passenger","1","0","1","1","2","50.0"
"2022-05-31T00:00:00.000","Prince William","VA","Truck","1","0","1","21","22","4.545454545454545454545454545"
"2022-05-31T00:00:00.000","Prince William","VA","Passenger","0","1","1","176","177","0.5649717514124293785310734463"
"2022-05-31T00:00:00.000","Stafford","VA","Passenger","2","1","3","84","87","3.448275862068965517241379310"
"2022-05-31T00:00:00.000","Suffolk","VA","Passenger","1","0","1","98","99","1.010101010101010101010101010"
"2022-05-31T00:00:00.000","Virginia Beach","VA","Passenger","2","0","2","453","455","0.4395604395604395604395604396"
"2022-05-31T00:00:00.000","Adams","WA","Passenger","16","12","28","12917","12945","0.2162997296253379683275395906"
"2022-05-31T00:00:00.000","Adams","WA","Truck","1","0","1","5451","5452","0.01834189288334556126192223037"
"2022-05-31T00:00:00.000","Asotin","WA","Truck","1","0","1","6697","6698","0.01492982979994028068080023888"
"2022-05-31T00:00:00.000","Asotin","WA","Passenger","24","20","44","12737","12781","0.3442610124403411313668727017"
"2022-05-31T00:00:00.000","Benton","WA","Passenger","740","464","1204","135043","136247","0.8836891821471298450608086784"
"2022-05-31T00:00:00.000","Benton","WA","Truck","38","0","38","43436","43474","0.08740856603947186824308782261"
"2022-05-31T00:00:00.000","Chelan","WA","Truck","14","0","14","23009","23023","0.06080875646093037397385223472"
"2022-05-31T00:00:00.000","Chelan","WA","Passenger","456","126","582","54306","54888","1.060341058154787931788369042"
"2022-05-31T00:00:00.000","Clallam","WA","Truck","7","0","7","21906","21913","0.03194450782640441746908227993"
"2022-05-31T00:00:00.000","Clallam","WA","Passenger","421","251","672","49721","50393","1.333518544242255868870676483"
"2022-05-31T00:00:00.000","Clark","WA","Truck","78","0","78","82694","82772","0.09423476537959696515729956990"
"2022-05-31T00:00:00.000","Clark","WA","Passenger","4036","1775","5811","316027","321838","1.805566775831318862284751956"
"2022-05-31T00:00:00.000","Columbia","WA","Passenger","7","0","7","2432","2439","0.2870028700287002870028700287"
"2022-05-31T00:00:00.000","Columbia","WA","Truck","2","0","2","1581","1583","0.1263423878711307643714466203"
"2022-05-31T00:00:00.000","Cowlitz","WA","Truck","11","1","12","28551","28563","0.04201239365612855792458775339"
"2022-05-31T00:00:00.000","Cowlitz","WA","Passenger","338","184","522","70565","71087","0.7343114774853348713548187432"
"2022-05-31T00:00:00.000","Douglas","WA","Passenger","131","59","190","28481","28671","0.6626905235255135851557322730"
"2022-05-31T00:00:00.000","Douglas","WA","Truck","5","0","5","12764","12769","0.03915733416868979559871563944"
"2022-05-31T00:00:00.000","Ferry","WA","Truck","1","0","1","3557","3558","0.02810567734682405845980888139"
"2022-05-31T00:00:00.000","Ferry","WA","Passenger","20","4","24","4433","4457","0.5384787973973524792461296836"
"2022-05-31T00:00:00.000","Franklin","WA","Truck","9","0","9","20897","20906","0.04304984215057878121113555917"
"2022-05-31T00:00:00.000","Franklin","WA","Passenger","187","115","302","61918","62220","0.4853744776599164255866280939"
"2022-05-31T00:00:00.000","Garfield","WA","Truck","0","0","0","974","974","0"
"2022-05-31T00:00:00.000","Garfield","WA","Passenger","0","3","3","1334","1337","0.2243829468960359012715033657"
"2022-05-31T00:00:00.000","Grant","WA","Passenger","173","103","276","66558","66834","0.4129634617111051261334051531"
"2022-05-31T00:00:00.000","Grant","WA","Truck","9","0","9","27902","27911","0.03224535129518827702339579377"
"2022-05-31T00:00:00.000","Grays Harbor","WA","Passenger","220","166","386","48980","49366","0.7819146781185431268484381963"
"2022-05-31T00:00:00.000","Grays Harbor","WA","Truck","11","0","11","21226","21237","0.05179639308753590431793567830"
"2022-05-31T00:00:00.000","Island","WA","Truck","17","0","17","21453","21470","0.07918025151374010246856078249"
"2022-05-31T00:00:00.000","Island","WA","Passenger","813","388","1201","62153","63354","1.895697193547368753354168640"
"2022-05-31T00:00:00.000","Jefferson","WA","Truck","5","0","5","9488","9493","0.05267038870746866111871905615"
"2022-05-31T00:00:00.000","Jefferson","WA","Passenger","432","225","657","24593","25250","2.601980198019801980198019802"
"2022-05-31T00:00:00.000","King","WA","Passenger","40369","11305","51674","1347282","1398956","3.693754485487749436007994533"
"2022-05-31T00:00:00.000","King","WA","Truck","265","1","266","180705","180971","0.1469848760298611379723823154"
"2022-05-31T00:00:00.000","Kitsap","WA","Passenger","2434","1070","3504","178757","182261","1.922517708121869187593615749"
"2022-05-31T00:00:00.000","Kitsap","WA","Truck","50","0","50","53701","53751","0.09302152518092686647690275530"
"2022-05-31T00:00:00.000","Kittitas","WA","Truck","7","0","7","14645","14652","0.04777504777504777504777504778"
"2022-05-31T00:00:00.000","Kittitas","WA","Passenger","251","81","332","29660","29992","1.106961856495065350760202721"
"2022-05-31T00:00:00.000","Klickitat","WA","Passenger","102","55","157","15199","15356","1.022401667100807501953633759"
"2022-05-31T00:00:00.000","Klickitat","WA","Truck","3","0","3","8264","8267","0.03628885932018870206846498125"
"2022-05-31T00:00:00.000","Lewis","WA","Truck","9","0","9","26396","26405","0.03408445370195038818405604999"
"2022-05-31T00:00:00.000","Lewis","WA","Passenger","240","178","418","59368","59786","0.6991603385407955039641387616"
"2022-05-31T00:00:00.000","Lincoln","WA","Passenger","10","18","28","7684","7712","0.3630705394190871369294605809"
"2022-05-31T00:00:00.000","Lincoln","WA","Truck","0","0","0","4846","4846","0"
"2022-05-31T00:00:00.000","Mason","WA","Truck","15","0","15","21013","21028","0.07133346014837359710861708199"
"2022-05-31T00:00:00.000","Mason","WA","Passenger","322","188","510","47228","47738","1.068331308391637689052746240"
"2022-05-31T00:00:00.000","Okanogan","WA","Passenger","83","52","135","26343","26478","0.5098572399728076138681169273"
"2022-05-31T00:00:00.000","Okanogan","WA","Truck","3","0","3","16621","16624","0.01804619826756496631376323388"
"2022-05-31T00:00:00.000","Pacific","WA","Passenger","68","71","139","15893","16032","0.8670159680638722554890219561"
"2022-05-31T00:00:00.000","Pacific","WA","Truck","2","0","2","7939","7941","0.02518574486840448306258657600"
"2022-05-31T00:00:00.000","Pend Oreille","WA","Passenger","16","11","27","8998","9025","0.2991689750692520775623268698"
"2022-05-31T00:00:00.000","Pend Oreille","WA","Truck","1","0","1","5606","5607","0.01783484929552345282682361334"
"2022-05-31T00:00:00.000","Pierce","WA","Truck","106","0","106","142121","142227","0.07452874629992898676060101106"
"2022-05-31T00:00:00.000","Pierce","WA","Passenger","5163","2369","7532","546429","553961","1.359662503317020512274329781"
"2022-05-31T00:00:00.000","San Juan","WA","Truck","4","0","4","5959","5963","0.06708032869361059869193359047"
"2022-05-31T00:00:00.000","San Juan","WA","Passenger","496","151","647","14061","14708","4.398966548816970356268697308"
"2022-05-31T00:00:00.000","Skagit","WA","Truck","29","0","29","32329","32358","0.08962234995982446381111317140"
"2022-05-31T00:00:00.000","Skagit","WA","Passenger","785","353","1138","89909","91047","1.249903895790086438872230826"
"2022-05-31T00:00:00.000","Skamania","WA","Truck","0","0","0","3954","3954","0"
"2022-05-31T00:00:00.000","Skamania","WA","Passenger","73","46","119","8188","8307","1.432526784639460695798723968"
"2022-05-31T00:00:00.000","Snohomish","WA","Truck","115","0","115","123762","123877","0.09283402084325581019882625508"
"2022-05-31T00:00:00.000","Snohomish","WA","Passenger","8289","2564","10853","532141","542994","1.998732951008666762431997407"
"2022-05-31T00:00:00.000","Spokane","WA","Truck","62","0","62","102110","102172","0.06068198723720784559370473320"
"2022-05-31T00:00:00.000","Spokane","WA","Passenger","1586","862","2448","324913","327361","0.7477983021801619618708398374"
"2022-05-31T00:00:00.000","Stevens","WA","Truck","3","0","3","18892","18895","0.01587721619476051865572902884"
"2022-05-31T00:00:00.000","Stevens","WA","Passenger","66","55","121","30043","30164","0.4011404323034080360694868055"
"2022-05-31T00:00:00.000","Thurston","WA","Passenger","2213","1082","3295","194524","197819","1.665664066646783170474019179"
"2022-05-31T00:00:00.000","Thurston","WA","Truck","50","0","50","55434","55484","0.09011606949751279648186864682"
"2022-05-31T00:00:00.000","Wahkiakum","WA","Truck","1","0","1","1802","1803","0.05546311702717692734331669440"
"2022-05-31T00:00:00.000","Wahkiakum","WA","Passenger","21","11","32","3081","3113","1.027947317699967876646321876"
"2022-05-31T00:00:00.000","Walla Walla","WA","Truck","7","0","7","13938","13945","0.05019720329867335962710648978"
"2022-05-31T00:00:00.000","Walla Walla","WA","Passenger","172","101","273","35923","36196","0.7542269864073378273842413526"
"2022-05-31T00:00:00.000","Whatcom","WA","Truck","30","0","30","43283","43313","0.06926326968808440883799321220"
"2022-05-31T00:00:00.000","Whatcom","WA","Passenger","1853","755","2608","148638","151246","1.724343123123917326739219550"
"2022-05-31T00:00:00.000","Whitman","WA","Truck","5","0","5","8552","8557","0.05843169335047329671613883370"
"2022-05-31T00:00:00.000","Whitman","WA","Passenger","86","61","147","22032","22179","0.6627891248478290274584066008"
"2022-05-31T00:00:00.000","Yakima","WA","Passenger","336","202","538","166731","167269","0.3216376017074293503279149155"
"2022-05-31T00:00:00.000","Yakima","WA","Truck","7","0","7","61192","61199","0.01143809539371558358796712365"
"2022-05-31T00:00:00.000","Douglas","WI","Passenger","1","0","1","1","2","50.0"
"2022-05-31T00:00:00.000","Ozaukee","WI","Passenger","0","1","1","2","3","33.33333333333333333333333333"
"2022-06-30T00:00:00.000","Anchorage","AK","Passenger","1","0","1","102","103","0.9708737864077669902912621359"
"2022-06-30T00:00:00.000","Fairbanks North Star","AK","Passenger","0","1","1","67","68","1.470588235294117647058823529"
"2022-06-30T00:00:00.000","Juneau","AK","Passenger","0","1","1","25","26","3.846153846153846153846153846"
"2022-06-30T00:00:00.000","Montgomery","AL","Passenger","0","1","1","32","33","3.030303030303030303030303030"
"2022-06-30T00:00:00.000","Maricopa","AZ","Passenger","4","3","7","631","638","1.097178683385579937304075235"
"2022-06-30T00:00:00.000","Pima","AZ","Passenger","1","0","1","178","179","0.5586592178770949720670391061"
"2022-06-30T00:00:00.000","Pinal","AZ","Passenger","1","0","1","86","87","1.149425287356321839080459770"
"2022-06-30T00:00:00.000","Alameda","CA","Passenger","3","0","3","153","156","1.923076923076923076923076923"
"2022-06-30T00:00:00.000","Contra Costa","CA","Passenger","0","6","6","280","286","2.097902097902097902097902098"
"2022-06-30T00:00:00.000","Fresno","CA","Passenger","1","0","1","119","120","0.8333333333333333333333333333"
"2022-06-30T00:00:00.000","Kern","CA","Passenger","1","1","2","157","159","1.257861635220125786163522013"
"2022-06-30T00:00:00.000","Kings","CA","Passenger","1","0","1","284","285","0.3508771929824561403508771930"
"2022-06-30T00:00:00.000","Los Angeles","CA","Passenger","3","6","9","623","632","1.424050632911392405063291139"
"2022-06-30T00:00:00.000","Marin","CA","Passenger","0","1","1","29","30","3.333333333333333333333333333"
"2022-06-30T00:00:00.000","Monterey","CA","Passenger","1","1","2","113","115","1.739130434782608695652173913"
"2022-06-30T00:00:00.000","Orange","CA","Passenger","5","2","7","303","310","2.258064516129032258064516129"
"2022-06-30T00:00:00.000","Placer","CA","Passenger","1","0","1","51","52","1.923076923076923076923076923"
"2022-06-30T00:00:00.000","Riverside","CA","Passenger","8","1","9","379","388","2.319587628865979381443298969"
"2022-06-30T00:00:00.000","Sacramento","CA","Passenger","1","0","1","168","169","0.5917159763313609467455621302"
"2022-06-30T00:00:00.000","San Bernardino","CA","Passenger","1","2","3","287","290","1.034482758620689655172413793"
"2022-06-30T00:00:00.000","San Diego","CA","Passenger","14","9","23","2065","2088","1.101532567049808429118773946"
"2022-06-30T00:00:00.000","San Joaquin","CA","Passenger","0","1","1","73","74","1.351351351351351351351351351"
"2022-06-30T00:00:00.000","San Luis Obispo","CA","Passenger","1","0","1","48","49","2.040816326530612244897959184"
"2022-06-30T00:00:00.000","Santa Barbara","CA","Passenger","1","0","1","60","61","1.639344262295081967213114754"
"2022-06-30T00:00:00.000","Santa Clara","CA","Passenger","5","1","6","168","174","3.448275862068965517241379310"
"2022-06-30T00:00:00.000","Santa Cruz","CA","Passenger","1","0","1","17","18","5.555555555555555555555555556"
"2022-06-30T00:00:00.000","Solano","CA","Passenger","1","0","1","154","155","0.6451612903225806451612903226"
"2022-06-30T00:00:00.000","Sonoma","CA","Passenger","0","1","1","66","67","1.492537313432835820895522388"
"2022-06-30T00:00:00.000","Ventura","CA","Passenger","1","1","2","214","216","0.9259259259259259259259259259"
"2022-06-30T00:00:00.000","Arapahoe","CO","Passenger","0","1","1","70","71","1.408450704225352112676056338"
"2022-06-30T00:00:00.000","Boulder","CO","Passenger","1","0","1","20","21","4.761904761904761904761904762"
"2022-06-30T00:00:00.000","El Paso","CO","Passenger","2","1","3","517","520","0.5769230769230769230769230769"
"2022-06-30T00:00:00.000","Larimer","CO","Passenger","1","0","1","36","37","2.702702702702702702702702703"
"2022-06-30T00:00:00.000","Las Animas","CO","Passenger","1","0","1","0","1","100"
"2022-06-30T00:00:00.000","New London","CT","Passenger","1","4","5","185","190","2.631578947368421052631578947"
"2022-06-30T00:00:00.000","District of Columbia","DC","Passenger","3","2","5","167","172","2.906976744186046511627906977"
"2022-06-30T00:00:00.000","Kent","DE","Passenger","0","1","1","46","47","2.127659574468085106382978723"
"2022-06-30T00:00:00.000","New Castle","DE","Passenger","1","0","1","17","18","5.555555555555555555555555556"
"2022-06-30T00:00:00.000","Duval","FL","Passenger","0","1","1","220","221","0.4524886877828054298642533937"
"2022-06-30T00:00:00.000","Hillsborough","FL","Passenger","0","1","1","101","102","0.9803921568627450980392156863"
"2022-06-30T00:00:00.000","Lake","FL","Passenger","1","0","1","14","15","6.666666666666666666666666667"
"2022-06-30T00:00:00.000","Monroe","FL","Passenger","0","1","1","36","37","2.702702702702702702702702703"
"2022-06-30T00:00:00.000","Okaloosa","FL","Passenger","0","1","1","79","80","1.2500"
"2022-06-30T00:00:00.000","Orange","FL","Passenger","1","0","1","66","67","1.492537313432835820895522388"
"2022-06-30T00:00:00.000","Palm Beach","FL","Passenger","1","0","1","35","36","2.777777777777777777777777778"
"2022-06-30T00:00:00.000","Pinellas","FL","Passenger","0","1","1","57","58","1.724137931034482758620689655"
"2022-06-30T00:00:00.000","Sarasota","FL","Passenger","2","0","2","20","22","9.090909090909090909090909091"
"2022-06-30T00:00:00.000","St. Johns","FL","Passenger","0","1","1","25","26","3.846153846153846153846153846"
"2022-06-30T00:00:00.000","Bartow","GA","Passenger","0","1","1","2","3","33.33333333333333333333333333"
"2022-06-30T00:00:00.000","Bryan","GA","Passenger","1","0","1","36","37","2.702702702702702702702702703"
"2022-06-30T00:00:00.000","Columbia","GA","Passenger","1","1","2","76","78","2.564102564102564102564102564"
"2022-06-30T00:00:00.000","DeKalb","GA","Passenger","1","0","1","34","35","2.857142857142857142857142857"
"2022-06-30T00:00:00.000","Houston","GA","Passenger","1","0","1","29","30","3.333333333333333333333333333"
"2022-06-30T00:00:00.000","Liberty","GA","Passenger","1","0","1","85","86","1.162790697674418604651162791"
"2022-06-30T00:00:00.000","Rockdale","GA","Passenger","1","0","1","6","7","14.28571428571428571428571429"
"2022-06-30T00:00:00.000","Honolulu","HI","Passenger","3","2","5","272","277","1.805054151624548736462093863"
"2022-06-30T00:00:00.000","Cook","IL","Passenger","1","0","1","144","145","0.6896551724137931034482758621"
"2022-06-30T00:00:00.000","DuPage","IL","Passenger","1","0","1","35","36","2.777777777777777777777777778"
"2022-06-30T00:00:00.000","Lake","IL","Passenger","3","0","3","135","138","2.173913043478260869565217391"
"2022-06-30T00:00:00.000","Rock Island","IL","Passenger","0","1","1","12","13","7.692307692307692307692307692"
"2022-06-30T00:00:00.000","St. Clair","IL","Passenger","2","0","2","108","110","1.818181818181818181818181818"
"2022-06-30T00:00:00.000","Hamilton","IN","Passenger","1","0","1","20","21","4.761904761904761904761904762"
"2022-06-30T00:00:00.000","Howard","IN","Passenger","0","1","1","5","6","16.66666666666666666666666667"
"2022-06-30T00:00:00.000","Geary","KS","Passenger","1","0","1","73","74","1.351351351351351351351351351"
"2022-06-30T00:00:00.000","Leavenworth","KS","Passenger","1","1","2","94","96","2.083333333333333333333333333"
"2022-06-30T00:00:00.000","Oldham","KY","Passenger","0","1","1","4","5","20.0"
"2022-06-30T00:00:00.000","Plaquemines","LA","Passenger","0","1","1","13","14","7.142857142857142857142857143"
"2022-06-30T00:00:00.000","Middlesex","MA","Passenger","2","1","3","68","71","4.225352112676056338028169014"
"2022-06-30T00:00:00.000","Suffolk","MA","Passenger","0","1","1","23","24","4.166666666666666666666666667"
"2022-06-30T00:00:00.000","Anne Arundel","MD","Passenger","4","3","7","300","307","2.280130293159609120521172638"
"2022-06-30T00:00:00.000","Calvert","MD","Passenger","0","2","2","73","75","2.666666666666666666666666667"
"2022-06-30T00:00:00.000","Carroll","MD","Passenger","0","1","1","9","10","10.0"
"2022-06-30T00:00:00.000","Charles","MD","Passenger","0","1","1","49","50","2.00"
"2022-06-30T00:00:00.000","Frederick","MD","Passenger","2","1","3","63","66","4.545454545454545454545454545"
"2022-06-30T00:00:00.000","Howard","MD","Passenger","0","1","1","54","55","1.818181818181818181818181818"
"2022-06-30T00:00:00.000","Montgomery","MD","Passenger","3","5","8","185","193","4.145077720207253886010362694"
"2022-06-30T00:00:00.000","Prince George's","MD","Passenger","2","0","2","103","105","1.904761904761904761904761905"
"2022-06-30T00:00:00.000","St. Mary's","MD","Truck","1","0","1","41","42","2.380952380952380952380952381"
"2022-06-30T00:00:00.000","St. Mary's","MD","Passenger","1","0","1","158","159","0.6289308176100628930817610063"
"2022-06-30T00:00:00.000","Washington","MD","Passenger","1","0","1","11","12","8.333333333333333333333333333"
"2022-06-30T00:00:00.000","Penobscot","ME","Passenger","0","1","1","8","9","11.11111111111111111111111111"
"2022-06-30T00:00:00.000","Kanabec","MN","Passenger","1","0","1","0","1","100"
"2022-06-30T00:00:00.000","Boone","MO","Passenger","0","1","1","8","9","11.11111111111111111111111111"
"2022-06-30T00:00:00.000","Greene","MO","Passenger","0","1","1","13","14","7.142857142857142857142857143"
"2022-06-30T00:00:00.000","Platte","MO","Passenger","1","0","1","15","16","6.2500"
"2022-06-30T00:00:00.000","Ray","MO","Passenger","0","1","1","0","1","100"
"2022-06-30T00:00:00.000","St. Louis","MO","Passenger","1","0","1","60","61","1.639344262295081967213114754"
"2022-06-30T00:00:00.000","Harrison","MS","Passenger","1","0","1","38","39","2.564102564102564102564102564"
"2022-06-30T00:00:00.000","Glacier","MT","Passenger","0","1","1","4","5","20.0"
"2022-06-30T00:00:00.000","Cumberland","NC","Passenger","0","2","2","335","337","0.5934718100890207715133531157"
"2022-06-30T00:00:00.000","Cumberland","NC","Truck","1","0","1","75","76","1.315789473684210526315789474"
"2022-06-30T00:00:00.000","Mecklenburg","NC","Passenger","1","0","1","47","48","2.083333333333333333333333333"
"2022-06-30T00:00:00.000","Moore","NC","Passenger","0","1","1","111","112","0.8928571428571428571428571429"
"2022-06-30T00:00:00.000","Onslow","NC","Passenger","0","1","1","139","140","0.7142857142857142857142857143"
"2022-06-30T00:00:00.000","Wake","NC","Passenger","1","0","1","60","61","1.639344262295081967213114754"
"2022-06-30T00:00:00.000","Wayne","NC","Passenger","1","0","1","25","26","3.846153846153846153846153846"
"2022-06-30T00:00:00.000","Williams","ND","Passenger","0","1","1","6","7","14.28571428571428571428571429"
"2022-06-30T00:00:00.000","Douglas","NE","Passenger","1","2","3","38","41","7.317073170731707317073170732"
"2022-06-30T00:00:00.000","Sarpy","NE","Passenger","1","0","1","43","44","2.272727272727272727272727273"
"2022-06-30T00:00:00.000","Carroll","NH","Passenger","0","1","1","3","4","25.00"
"2022-06-30T00:00:00.000","Burlington","NJ","Passenger","0","2","2","108","110","1.818181818181818181818181818"
"2022-06-30T00:00:00.000","Camden","NJ","Passenger","0","1","1","8","9","11.11111111111111111111111111"
"2022-06-30T00:00:00.000","Hudson","NJ","Truck","1","0","1","9","10","10.0"
"2022-06-30T00:00:00.000","Hudson","NJ","Passenger","1","0","1","76","77","1.298701298701298701298701299"
"2022-06-30T00:00:00.000","Chaves","NM","Passenger","1","0","1","2","3","33.33333333333333333333333333"
"2022-06-30T00:00:00.000","Carson City","NV","Passenger","1","0","1","6","7","14.28571428571428571428571429"
"2022-06-30T00:00:00.000","Clark","NV","Passenger","5","4","9","447","456","1.973684210526315789473684211"
"2022-06-30T00:00:00.000","Jefferson","NY","Passenger","0","1","1","179","180","0.5555555555555555555555555556"
"2022-06-30T00:00:00.000","Queens","NY","Passenger","1","0","1","28","29","3.448275862068965517241379310"
"2022-06-30T00:00:00.000","Saratoga","NY","Passenger","1","0","1","35","36","2.777777777777777777777777778"
"2022-06-30T00:00:00.000","Hamilton","OH","Passenger","1","0","1","23","24","4.166666666666666666666666667"
"2022-06-30T00:00:00.000","Rogers","OK","Passenger","1","0","1","1","2","50.0"
"2022-06-30T00:00:00.000","Clackamas","OR","Passenger","2","0","2","117","119","1.680672268907563025210084034"
"2022-06-30T00:00:00.000","Douglas","OR","Passenger","1","0","1","26","27","3.703703703703703703703703704"
"2022-06-30T00:00:00.000","Lincoln","OR","Passenger","0","1","1","25","26","3.846153846153846153846153846"
"2022-06-30T00:00:00.000","Multnomah","OR","Passenger","0","2","2","421","423","0.4728132387706855791962174941"
"2022-06-30T00:00:00.000","Allegheny","PA","Passenger","1","1","2","41","43","4.651162790697674418604651163"
"2022-06-30T00:00:00.000","Montgomery","PA","Passenger","2","0","2","13","15","13.33333333333333333333333333"
"2022-06-30T00:00:00.000","Philadelphia","PA","Passenger","1","0","1","27","28","3.571428571428571428571428571"
"2022-06-30T00:00:00.000","Newport","RI","Truck","1","0","1","10","11","9.090909090909090909090909091"
"2022-06-30T00:00:00.000","Newport","RI","Passenger","1","0","1","71","72","1.388888888888888888888888889"
"2022-06-30T00:00:00.000","Charleston","SC","Passenger","1","0","1","52","53","1.886792452830188679245283019"
"2022-06-30T00:00:00.000","Richland","SC","Passenger","0","1","1","113","114","0.8771929824561403508771929825"
"2022-06-30T00:00:00.000","Spartanburg","SC","Passenger","0","1","1","21","22","4.545454545454545454545454545"
"2022-06-30T00:00:00.000","Sumter","SC","Passenger","0","1","1","27","28","3.571428571428571428571428571"
"2022-06-30T00:00:00.000","Pennington","SD","Passenger","1","0","1","24","25","4.00"
"2022-06-30T00:00:00.000","Davidson","TN","Passenger","1","0","1","27","28","3.571428571428571428571428571"
"2022-06-30T00:00:00.000","Montgomery","TN","Passenger","1","0","1","156","157","0.6369426751592356687898089172"
"2022-06-30T00:00:00.000","Tipton","TN","Passenger","1","0","1","10","11","9.090909090909090909090909091"
"2022-06-30T00:00:00.000","Bell","TX","Passenger","0","1","1","263","264","0.3787878787878787878787878788"
"2022-06-30T00:00:00.000","Bexar","TX","Passenger","5","2","7","375","382","1.832460732984293193717277487"
"2022-06-30T00:00:00.000","Coryell","TX","Passenger","1","0","1","83","84","1.190476190476190476190476190"
"2022-06-30T00:00:00.000","Denton","TX","Passenger","1","0","1","44","45","2.222222222222222222222222222"
"2022-06-30T00:00:00.000","El Paso","TX","Passenger","1","0","1","294","295","0.3389830508474576271186440678"
"2022-06-30T00:00:00.000","Galveston","TX","Passenger","0","1","1","14","15","6.666666666666666666666666667"
"2022-06-30T00:00:00.000","Harris","TX","Passenger","1","0","1","119","120","0.8333333333333333333333333333"
"2022-06-30T00:00:00.000","Hidalgo","TX","Passenger","0","1","1","54","55","1.818181818181818181818181818"
"2022-06-30T00:00:00.000","Montgomery","TX","Passenger","1","0","1","18","19","5.263157894736842105263157895"
"2022-06-30T00:00:00.000","Nueces","TX","Passenger","1","0","1","45","46","2.173913043478260869565217391"
"2022-06-30T00:00:00.000","Tarrant","TX","Passenger","1","0","1","87","88","1.136363636363636363636363636"
"2022-06-30T00:00:00.000","Wichita","TX","Passenger","1","0","1","34","35","2.857142857142857142857142857"
"2022-06-30T00:00:00.000","Williamson","TX","Passenger","1","0","1","65","66","1.515151515151515151515151515"
"2022-06-30T00:00:00.000","Salt Lake","UT","Passenger","2","2","4","102","106","3.773584905660377358490566038"
"2022-06-30T00:00:00.000","Albemarle","VA","Passenger","1","0","1","15","16","6.2500"
"2022-06-30T00:00:00.000","Alexandria","VA","Passenger","5","1","6","115","121","4.958677685950413223140495868"
"2022-06-30T00:00:00.000","Chesapeake","VA","Passenger","1","3","4","321","325","1.230769230769230769230769231"
"2022-06-30T00:00:00.000","Danville","VA","Passenger","1","0","1","0","1","100"
"2022-06-30T00:00:00.000","Fairfax","VA","Passenger","5","3","8","568","576","1.388888888888888888888888889"
"2022-06-30T00:00:00.000","Goochland","VA","Passenger","2","0","2","69","71","2.816901408450704225352112676"
"2022-06-30T00:00:00.000","Loudoun","VA","Passenger","2","0","2","52","54","3.703703703703703703703703704"
"2022-06-30T00:00:00.000","Louisa","VA","Passenger","0","1","1","0","1","100"
"2022-06-30T00:00:00.000","Manassas","VA","Passenger","0","1","1","5","6","16.66666666666666666666666667"
"2022-06-30T00:00:00.000","Norfolk","VA","Passenger","1","1","2","265","267","0.7490636704119850187265917603"
"2022-06-30T00:00:00.000","Portsmouth","VA","Passenger","1","1","2","59","61","3.278688524590163934426229508"
"2022-06-30T00:00:00.000","Prince William","VA","Truck","1","0","1","23","24","4.166666666666666666666666667"
"2022-06-30T00:00:00.000","Prince William","VA","Passenger","0","1","1","172","173","0.5780346820809248554913294798"
"2022-06-30T00:00:00.000","Stafford","VA","Passenger","2","1","3","82","85","3.529411764705882352941176471"
"2022-06-30T00:00:00.000","Suffolk","VA","Passenger","1","0","1","100","101","0.9900990099009900990099009901"
"2022-06-30T00:00:00.000","Virginia Beach","VA","Passenger","2","0","2","439","441","0.4535147392290249433106575964"
"2022-06-30T00:00:00.000","Adams","WA","Passenger","17","12","29","12854","12883","0.2251028487153613288830241403"
"2022-06-30T00:00:00.000","Adams","WA","Truck","2","0","2","5424","5426","0.03685956505713232583855510505"
"2022-06-30T00:00:00.000","Asotin","WA","Truck","1","0","1","6698","6699","0.01492760113449768622182415286"
"2022-06-30T00:00:00.000","Asotin","WA","Passenger","24","20","44","12725","12769","0.3445845406844702012686976271"
"2022-06-30T00:00:00.000","Benton","WA","Passenger","763","468","1231","134839","136070","0.9046814139780995076063790696"
"2022-06-30T00:00:00.000","Benton","WA","Truck","40","0","40","43368","43408","0.09214891264283081459638776262"
"2022-06-30T00:00:00.000","Chelan","WA","Passenger","466","126","592","54162","54754","1.081199547065054607882529130"
"2022-06-30T00:00:00.000","Chelan","WA","Truck","16","0","16","22965","22981","0.06962273182193986336538879944"
"2022-06-30T00:00:00.000","Clallam","WA","Truck","8","0","8","21832","21840","0.03663003663003663003663003663"
"2022-06-30T00:00:00.000","Clallam","WA","Passenger","431","255","686","49621","50307","1.363627328204822390522193730"
"2022-06-30T00:00:00.000","Clark","WA","Passenger","4192","1822","6014","315216","321230","1.872178812688727702892008841"
"2022-06-30T00:00:00.000","Clark","WA","Truck","79","0","79","82416","82495","0.09576337959876356142796533123"
"2022-06-30T00:00:00.000","Columbia","WA","Passenger","7","0","7","2431","2438","0.2871205906480721903199343724"
"2022-06-30T00:00:00.000","Columbia","WA","Truck","2","0","2","1575","1577","0.1268230818008877615726062143"
"2022-06-30T00:00:00.000","Cowlitz","WA","Truck","12","1","13","28433","28446","0.04570062574702945932644308514"
"2022-06-30T00:00:00.000","Cowlitz","WA","Passenger","352","181","533","70440","70973","0.7509898130274893269271413073"
"2022-06-30T00:00:00.000","Douglas","WA","Passenger","130","59","189","28419","28608","0.6606543624161073825503355705"
"2022-06-30T00:00:00.000","Douglas","WA","Truck","5","0","5","12763","12768","0.03916040100250626566416040100"
"2022-06-30T00:00:00.000","Ferry","WA","Passenger","19","4","23","4397","4420","0.5203619909502262443438914027"
"2022-06-30T00:00:00.000","Ferry","WA","Truck","1","0","1","3554","3555","0.02812939521800281293952180028"
"2022-06-30T00:00:00.000","Franklin","WA","Passenger","192","114","306","61751","62057","0.4930950577694700033839856906"
"2022-06-30T00:00:00.000","Franklin","WA","Truck","9","0","9","20809","20818","0.04323181861850321836871937746"
"2022-06-30T00:00:00.000","Garfield","WA","Passenger","0","3","3","1325","1328","0.2259036144578313253012048193"
"2022-06-30T00:00:00.000","Garfield","WA","Truck","0","0","0","979","979","0"
"2022-06-30T00:00:00.000","Grant","WA","Passenger","180","105","285","66519","66804","0.4266211604095563139931740614"
"2022-06-30T00:00:00.000","Grant","WA","Truck","9","0","9","27868","27877","0.03228467912616135165189941529"
"2022-06-30T00:00:00.000","Grays Harbor","WA","Passenger","225","168","393","48884","49277","0.7975323173082776954765915133"
"2022-06-30T00:00:00.000","Grays Harbor","WA","Truck","10","0","10","21199","21209","0.04714979489839219199396482625"
"2022-06-30T00:00:00.000","Island","WA","Truck","20","0","20","21362","21382","0.09353661958656814142736881489"
"2022-06-30T00:00:00.000","Island","WA","Passenger","833","394","1227","61958","63185","1.941916594128353248397562713"
"2022-06-30T00:00:00.000","Jefferson","WA","Truck","7","0","7","9436","9443","0.07412898443291326908821349148"
"2022-06-30T00:00:00.000","Jefferson","WA","Passenger","441","225","666","24529","25195","2.643381623337963881722564001"
"2022-06-30T00:00:00.000","King","WA","Passenger","41002","11544","52546","1345653","1398199","3.758120267572784703751039730"
"2022-06-30T00:00:00.000","King","WA","Truck","287","1","288","180024","180312","0.1597231465459869559430320777"
"2022-06-30T00:00:00.000","Kitsap","WA","Passenger","2469","1095","3564","178491","182055","1.957650160665732882919996704"
"2022-06-30T00:00:00.000","Kitsap","WA","Truck","51","0","51","53580","53631","0.09509425518823068747552721374"
"2022-06-30T00:00:00.000","Kittitas","WA","Passenger","268","84","352","29598","29950","1.175292153589315525876460768"
"2022-06-30T00:00:00.000","Kittitas","WA","Truck","7","0","7","14594","14601","0.04794192178617902883364153140"
"2022-06-30T00:00:00.000","Klickitat","WA","Passenger","106","56","162","15165","15327","1.056958308866705813270698767"
"2022-06-30T00:00:00.000","Klickitat","WA","Truck","2","0","2","8235","8237","0.02428068471530897171300230667"
"2022-06-30T00:00:00.000","Lewis","WA","Passenger","244","181","425","59476","59901","0.7095040149580140565266022270"
"2022-06-30T00:00:00.000","Lewis","WA","Truck","9","0","9","26315","26324","0.03418933292812642455553867193"
"2022-06-30T00:00:00.000","Lincoln","WA","Truck","0","0","0","4837","4837","0"
"2022-06-30T00:00:00.000","Lincoln","WA","Passenger","10","18","28","7695","7723","0.3625534118865725754240580085"
"2022-06-30T00:00:00.000","Mason","WA","Truck","17","0","17","20970","20987","0.08100252537284985943679420594"
"2022-06-30T00:00:00.000","Mason","WA","Passenger","329","185","514","47147","47661","1.078449885650741696565325948"
"2022-06-30T00:00:00.000","Okanogan","WA","Truck","4","0","4","16563","16567","0.02414438341280859540049495986"
"2022-06-30T00:00:00.000","Okanogan","WA","Passenger","85","51","136","26260","26396","0.5152295802394302166994999242"
"2022-06-30T00:00:00.000","Pacific","WA","Truck","2","0","2","7889","7891","0.02534533012292485109618552782"
"2022-06-30T00:00:00.000","Pacific","WA","Passenger","69","73","142","15848","15990","0.8880550343964978111319574734"
"2022-06-30T00:00:00.000","Pend Oreille","WA","Truck","1","0","1","5622","5623","0.01778410101369375778054419349"
"2022-06-30T00:00:00.000","Pend Oreille","WA","Passenger","17","11","28","9026","9054","0.3092555776452396730726750607"
"2022-06-30T00:00:00.000","Pierce","WA","Truck","107","0","107","141375","141482","0.07562799508064630129627797176"
"2022-06-30T00:00:00.000","Pierce","WA","Passenger","5261","2389","7650","544639","552289","1.385144371877766893782059755"
"2022-06-30T00:00:00.000","San Juan","WA","Truck","4","0","4","5955","5959","0.06712535660345695586507803323"
"2022-06-30T00:00:00.000","San Juan","WA","Passenger","509","153","662","14005","14667","4.513533783323106293038794573"
"2022-06-30T00:00:00.000","Skagit","WA","Truck","30","0","30","32199","32229","0.09308386856557758540444940892"
"2022-06-30T00:00:00.000","Skagit","WA","Passenger","802","357","1159","89762","90921","1.274733009975693184192870734"
"2022-06-30T00:00:00.000","Skamania","WA","Truck","0","0","0","3940","3940","0"
"2022-06-30T00:00:00.000","Skamania","WA","Passenger","76","47","123","8163","8286","1.484431571325126719768283852"
"2022-06-30T00:00:00.000","Snohomish","WA","Passenger","8494","2617","11111","531125","542236","2.049107768573093634506008454"
"2022-06-30T00:00:00.000","Snohomish","WA","Truck","121","0","121","123279","123400","0.09805510534846029173419773096"
"2022-06-30T00:00:00.000","Spokane","WA","Passenger","1641","876","2517","324431","326948","0.7698471928257704589108971457"
"2022-06-30T00:00:00.000","Spokane","WA","Truck","63","0","63","101916","101979","0.06177742476392198393786956138"
"2022-06-30T00:00:00.000","Stevens","WA","Passenger","70","56","126","30075","30201","0.4172047283202542962153571074"
"2022-06-30T00:00:00.000","Stevens","WA","Truck","3","0","3","18849","18852","0.01591343093570973901973265436"
"2022-06-30T00:00:00.000","Thurston","WA","Passenger","2264","1107","3371","194103","197474","1.707060169946423326615149336"
"2022-06-30T00:00:00.000","Thurston","WA","Truck","52","0","52","55381","55433","0.09380693810546064618548518031"
"2022-06-30T00:00:00.000","Wahkiakum","WA","Passenger","22","12","34","3064","3098","1.097482246610716591349257586"
"2022-06-30T00:00:00.000","Wahkiakum","WA","Truck","1","0","1","1803","1804","0.05543237250554323725055432373"
"2022-06-30T00:00:00.000","Walla Walla","WA","Passenger","173","105","278","35788","36066","0.7708090722564187877779626241"
"2022-06-30T00:00:00.000","Walla Walla","WA","Truck","7","0","7","13861","13868","0.05047591577732910297086818575"
"2022-06-30T00:00:00.000","Whatcom","WA","Truck","32","0","32","43168","43200","0.07407407407407407407407407407"
"2022-06-30T00:00:00.000","Whatcom","WA","Passenger","1866","760","2626","148411","151037","1.738646821639730662023212855"
"2022-06-30T00:00:00.000","Whitman","WA","Passenger","89","63","152","21968","22120","0.6871609403254972875226039783"
"2022-06-30T00:00:00.000","Whitman","WA","Truck","6","0","6","8542","8548","0.07019185774450163781001403837"
"2022-06-30T00:00:00.000","Yakima","WA","Truck","9","0","9","60994","61003","0.01475337278494500270478501057"
"2022-06-30T00:00:00.000","Yakima","WA","Passenger","348","203","551","166296","166847","0.3302426774230282833973640521"
"2022-06-30T00:00:00.000","Douglas","WI","Passenger","1","0","1","1","2","50.0"
"2022-06-30T00:00:00.000","Ozaukee","WI","Passenger","0","1","1","2","3","33.33333333333333333333333333"
"2022-06-30T00:00:00.000","Sheridan","WY","Passenger","1","0","1","7","8","12.500"
"2022-07-31T00:00:00.000","Anchorage","AK","Passenger","1","0","1","99","100","1.00"
"2022-07-31T00:00:00.000","Fairbanks North Star","AK","Passenger","0","1","1","65","66","1.515151515151515151515151515"
"2022-07-31T00:00:00.000","Juneau","AK","Passenger","0","1","1","24","25","4.00"
"2022-07-31T00:00:00.000","Montgomery","AL","Passenger","0","1","1","32","33","3.030303030303030303030303030"
"2022-07-31T00:00:00.000","Pulaski","AR","Passenger","1","0","1","24","25","4.00"
"2022-07-31T00:00:00.000","Maricopa","AZ","Passenger","4","2","6","604","610","0.9836065573770491803278688525"
"2022-07-31T00:00:00.000","Pinal","AZ","Passenger","1","0","1","81","82","1.219512195121951219512195122"
"2022-07-31T00:00:00.000","Alameda","CA","Passenger","3","0","3","148","151","1.986754966887417218543046358"
"2022-07-31T00:00:00.000","Contra Costa","CA","Passenger","0","6","6","267","273","2.197802197802197802197802198"
"2022-07-31T00:00:00.000","Kern","CA","Passenger","1","1","2","155","157","1.273885350318471337579617834"
"2022-07-31T00:00:00.000","Kings","CA","Passenger","1","0","1","281","282","0.3546099290780141843971631206"
"2022-07-31T00:00:00.000","Los Angeles","CA","Passenger","3","6","9","602","611","1.472995090016366612111292962"
"2022-07-31T00:00:00.000","Marin","CA","Passenger","0","1","1","27","28","3.571428571428571428571428571"
"2022-07-31T00:00:00.000","Monterey","CA","Passenger","1","1","2","109","111","1.801801801801801801801801802"
"2022-07-31T00:00:00.000","Orange","CA","Passenger","5","2","7","290","297","2.356902356902356902356902357"
"2022-07-31T00:00:00.000","Placer","CA","Passenger","1","0","1","50","51","1.960784313725490196078431373"
"2022-07-31T00:00:00.000","Riverside","CA","Passenger","7","1","8","367","375","2.133333333333333333333333333"
"2022-07-31T00:00:00.000","Sacramento","CA","Passenger","1","0","1","167","168","0.5952380952380952380952380952"
"2022-07-31T00:00:00.000","San Bernardino","CA","Passenger","1","1","2","275","277","0.7220216606498194945848375451"
"2022-07-31T00:00:00.000","San Diego","CA","Passenger","14","9","23","1997","2020","1.138613861386138613861386139"
"2022-07-31T00:00:00.000","San Joaquin","CA","Passenger","0","1","1","69","70","1.428571428571428571428571429"
"2022-07-31T00:00:00.000","Santa Barbara","CA","Passenger","1","0","1","59","60","1.666666666666666666666666667"
"2022-07-31T00:00:00.000","Santa Clara","CA","Passenger","5","1","6","156","162","3.703703703703703703703703704"
"2022-07-31T00:00:00.000","Santa Cruz","CA","Passenger","1","0","1","16","17","5.882352941176470588235294118"
"2022-07-31T00:00:00.000","Solano","CA","Passenger","1","0","1","151","152","0.6578947368421052631578947368"
"2022-07-31T00:00:00.000","Sonoma","CA","Passenger","0","1","1","65","66","1.515151515151515151515151515"
"2022-07-31T00:00:00.000","Ventura","CA","Passenger","2","1","3","209","212","1.415094339622641509433962264"
"2022-07-31T00:00:00.000","Arapahoe","CO","Passenger","0","1","1","69","70","1.428571428571428571428571429"
"2022-07-31T00:00:00.000","Boulder","CO","Passenger","1","0","1","20","21","4.761904761904761904761904762"
"2022-07-31T00:00:00.000","El Paso","CO","Passenger","2","1","3","493","496","0.6048387096774193548387096774"
"2022-07-31T00:00:00.000","Larimer","CO","Passenger","1","0","1","34","35","2.857142857142857142857142857"
"2022-07-31T00:00:00.000","Las Animas","CO","Passenger","1","0","1","0","1","100"
"2022-07-31T00:00:00.000","New London","CT","Passenger","1","4","5","186","191","2.617801047120418848167539267"
"2022-07-31T00:00:00.000","District of Columbia","DC","Passenger","3","2","5","163","168","2.976190476190476190476190476"
"2022-07-31T00:00:00.000","Kent","DE","Passenger","0","1","1","46","47","2.127659574468085106382978723"
"2022-07-31T00:00:00.000","New Castle","DE","Passenger","1","0","1","15","16","6.2500"
"2022-07-31T00:00:00.000","Duval","FL","Passenger","0","1","1","213","214","0.4672897196261682242990654206"
"2022-07-31T00:00:00.000","Hillsborough","FL","Passenger","0","1","1","97","98","1.020408163265306122448979592"
"2022-07-31T00:00:00.000","Lake","FL","Passenger","1","0","1","12","13","7.692307692307692307692307692"
"2022-07-31T00:00:00.000","Monroe","FL","Passenger","0","1","1","35","36","2.777777777777777777777777778"
"2022-07-31T00:00:00.000","Okaloosa","FL","Passenger","0","1","1","76","77","1.298701298701298701298701299"
"2022-07-31T00:00:00.000","Orange","FL","Passenger","1","0","1","61","62","1.612903225806451612903225806"
"2022-07-31T00:00:00.000","Palm Beach","FL","Passenger","1","0","1","35","36","2.777777777777777777777777778"
"2022-07-31T00:00:00.000","Sarasota","FL","Passenger","2","0","2","19","21","9.523809523809523809523809524"
"2022-07-31T00:00:00.000","Bartow","GA","Passenger","0","1","1","2","3","33.33333333333333333333333333"
"2022-07-31T00:00:00.000","Bryan","GA","Passenger","1","0","1","36","37","2.702702702702702702702702703"
"2022-07-31T00:00:00.000","Columbia","GA","Passenger","1","1","2","77","79","2.531645569620253164556962025"
"2022-07-31T00:00:00.000","DeKalb","GA","Passenger","1","0","1","33","34","2.941176470588235294117647059"
"2022-07-31T00:00:00.000","Houston","GA","Passenger","1","0","1","29","30","3.333333333333333333333333333"
"2022-07-31T00:00:00.000","Liberty","GA","Passenger","1","0","1","80","81","1.234567901234567901234567901"
"2022-07-31T00:00:00.000","Rockdale","GA","Passenger","1","0","1","5","6","16.66666666666666666666666667"
"2022-07-31T00:00:00.000","Honolulu","HI","Passenger","3","1","4","262","266","1.503759398496240601503759398"
"2022-07-31T00:00:00.000","Cook","IL","Passenger","1","0","1","136","137","0.7299270072992700729927007299"
"2022-07-31T00:00:00.000","Lake","IL","Passenger","3","0","3","128","131","2.290076335877862595419847328"
"2022-07-31T00:00:00.000","Rock Island","IL","Passenger","0","1","1","12","13","7.692307692307692307692307692"
"2022-07-31T00:00:00.000","St. Clair","IL","Passenger","2","0","2","105","107","1.869158878504672897196261682"
"2022-07-31T00:00:00.000","Hamilton","IN","Passenger","1","0","1","18","19","5.263157894736842105263157895"
"2022-07-31T00:00:00.000","Howard","IN","Passenger","0","1","1","5","6","16.66666666666666666666666667"
"2022-07-31T00:00:00.000","Geary","KS","Passenger","1","0","1","73","74","1.351351351351351351351351351"
"2022-07-31T00:00:00.000","Leavenworth","KS","Passenger","1","1","2","89","91","2.197802197802197802197802198"
"2022-07-31T00:00:00.000","Oldham","KY","Passenger","0","1","1","4","5","20.0"
"2022-07-31T00:00:00.000","Plaquemines","LA","Passenger","0","1","1","13","14","7.142857142857142857142857143"
"2022-07-31T00:00:00.000","Middlesex","MA","Passenger","2","1","3","66","69","4.347826086956521739130434783"
"2022-07-31T00:00:00.000","Anne Arundel","MD","Passenger","4","3","7","292","299","2.341137123745819397993311037"
"2022-07-31T00:00:00.000","Calvert","MD","Passenger","0","2","2","72","74","2.702702702702702702702702703"
"2022-07-31T00:00:00.000","Carroll","MD","Passenger","0","1","1","10","11","9.090909090909090909090909091"
"2022-07-31T00:00:00.000","Charles","MD","Passenger","0","1","1","50","51","1.960784313725490196078431373"
"2022-07-31T00:00:00.000","Frederick","MD","Passenger","2","0","2","62","64","3.12500"
"2022-07-31T00:00:00.000","Howard","MD","Passenger","0","1","1","51","52","1.923076923076923076923076923"
"2022-07-31T00:00:00.000","Montgomery","MD","Passenger","3","5","8","179","187","4.278074866310160427807486631"
"2022-07-31T00:00:00.000","Prince George's","MD","Passenger","2","0","2","100","102","1.960784313725490196078431373"
"2022-07-31T00:00:00.000","St. Mary's","MD","Truck","1","0","1","42","43","2.325581395348837209302325581"
"2022-07-31T00:00:00.000","St. Mary's","MD","Passenger","1","0","1","149","150","0.6666666666666666666666666667"
"2022-07-31T00:00:00.000","Washington","MD","Passenger","1","0","1","11","12","8.333333333333333333333333333"
"2022-07-31T00:00:00.000","Penobscot","ME","Passenger","0","1","1","8","9","11.11111111111111111111111111"
"2022-07-31T00:00:00.000","Kanabec","MN","Passenger","1","0","1","0","1","100"
"2022-07-31T00:00:00.000","Greene","MO","Passenger","0","1","1","12","13","7.692307692307692307692307692"
"2022-07-31T00:00:00.000","Platte","MO","Passenger","1","0","1","14","15","6.666666666666666666666666667"
"2022-07-31T00:00:00.000","Ray","MO","Passenger","0","1","1","0","1","100"
"2022-07-31T00:00:00.000","St. Louis","MO","Passenger","1","0","1","57","58","1.724137931034482758620689655"
"2022-07-31T00:00:00.000","Harrison","MS","Passenger","1","0","1","35","36","2.777777777777777777777777778"
"2022-07-31T00:00:00.000","Glacier","MT","Passenger","0","1","1","4","5","20.0"
"2022-07-31T00:00:00.000","Cumberland","NC","Truck","1","0","1","74","75","1.333333333333333333333333333"
"2022-07-31T00:00:00.000","Cumberland","NC","Passenger","0","2","2","321","323","0.6191950464396284829721362229"
"2022-07-31T00:00:00.000","Hoke","NC","Passenger","1","0","1","59","60","1.666666666666666666666666667"
"2022-07-31T00:00:00.000","Mecklenburg","NC","Passenger","1","0","1","44","45","2.222222222222222222222222222"
"2022-07-31T00:00:00.000","Moore","NC","Passenger","0","1","1","108","109","0.9174311926605504587155963303"
"2022-07-31T00:00:00.000","Onslow","NC","Passenger","0","1","1","137","138","0.7246376811594202898550724638"
"2022-07-31T00:00:00.000","Wake","NC","Passenger","1","0","1","57","58","1.724137931034482758620689655"
"2022-07-31T00:00:00.000","Wayne","NC","Passenger","1","0","1","24","25","4.00"
"2022-07-31T00:00:00.000","Williams","ND","Passenger","0","1","1","5","6","16.66666666666666666666666667"
"2022-07-31T00:00:00.000","Douglas","NE","Passenger","1","2","3","37","40","7.500"
"2022-07-31T00:00:00.000","Sarpy","NE","Passenger","1","0","1","43","44","2.272727272727272727272727273"
"2022-07-31T00:00:00.000","Carroll","NH","Passenger","0","1","1","3","4","25.00"
"2022-07-31T00:00:00.000","Burlington","NJ","Passenger","0","2","2","103","105","1.904761904761904761904761905"
"2022-07-31T00:00:00.000","Camden","NJ","Passenger","0","1","1","7","8","12.500"
"2022-07-31T00:00:00.000","Hudson","NJ","Truck","1","0","1","9","10","10.0"
"2022-07-31T00:00:00.000","Hudson","NJ","Passenger","1","0","1","75","76","1.315789473684210526315789474"
"2022-07-31T00:00:00.000","Chaves","NM","Passenger","1","0","1","2","3","33.33333333333333333333333333"
"2022-07-31T00:00:00.000","Clark","NV","Passenger","5","4","9","429","438","2.054794520547945205479452055"
"2022-07-31T00:00:00.000","Jefferson","NY","Passenger","0","1","1","177","178","0.5617977528089887640449438202"
"2022-07-31T00:00:00.000","Queens","NY","Passenger","1","0","1","28","29","3.448275862068965517241379310"
"2022-07-31T00:00:00.000","Saratoga","NY","Passenger","1","0","1","35","36","2.777777777777777777777777778"
"2022-07-31T00:00:00.000","Hamilton","OH","Passenger","1","0","1","22","23","4.347826086956521739130434783"
"2022-07-31T00:00:00.000","Rogers","OK","Passenger","1","0","1","1","2","50.0"
"2022-07-31T00:00:00.000","Clackamas","OR","Passenger","2","0","2","112","114","1.754385964912280701754385965"
"2022-07-31T00:00:00.000","Douglas","OR","Passenger","1","0","1","23","24","4.166666666666666666666666667"
"2022-07-31T00:00:00.000","Lincoln","OR","Passenger","0","1","1","22","23","4.347826086956521739130434783"
"2022-07-31T00:00:00.000","Multnomah","OR","Passenger","0","2","2","401","403","0.4962779156327543424317617866"
"2022-07-31T00:00:00.000","Allegheny","PA","Passenger","1","1","2","40","42","4.761904761904761904761904762"
"2022-07-31T00:00:00.000","Cumberland","PA","Passenger","1","0","1","34","35","2.857142857142857142857142857"
"2022-07-31T00:00:00.000","Montgomery","PA","Passenger","1","0","1","12","13","7.692307692307692307692307692"
"2022-07-31T00:00:00.000","Philadelphia","PA","Passenger","1","0","1","28","29","3.448275862068965517241379310"
"2022-07-31T00:00:00.000","Newport","RI","Truck","1","0","1","9","10","10.0"
"2022-07-31T00:00:00.000","Newport","RI","Passenger","1","0","1","67","68","1.470588235294117647058823529"
"2022-07-31T00:00:00.000","Charleston","SC","Passenger","1","0","1","51","52","1.923076923076923076923076923"
"2022-07-31T00:00:00.000","Spartanburg","SC","Passenger","0","1","1","20","21","4.761904761904761904761904762"
"2022-07-31T00:00:00.000","Sumter","SC","Passenger","0","1","1","27","28","3.571428571428571428571428571"
"2022-07-31T00:00:00.000","Pennington","SD","Passenger","1","0","1","21","22","4.545454545454545454545454545"
"2022-07-31T00:00:00.000","Davidson","TN","Passenger","1","0","1","25","26","3.846153846153846153846153846"
"2022-07-31T00:00:00.000","Montgomery","TN","Passenger","2","0","2","152","154","1.298701298701298701298701299"
"2022-07-31T00:00:00.000","Tipton","TN","Passenger","1","0","1","10","11","9.090909090909090909090909091"
"2022-07-31T00:00:00.000","Bell","TX","Passenger","0","1","1","256","257","0.3891050583657587548638132296"
"2022-07-31T00:00:00.000","Bexar","TX","Passenger","5","2","7","369","376","1.861702127659574468085106383"
"2022-07-31T00:00:00.000","Coryell","TX","Passenger","1","0","1","77","78","1.282051282051282051282051282"
"2022-07-31T00:00:00.000","Denton","TX","Passenger","1","0","1","43","44","2.272727272727272727272727273"
"2022-07-31T00:00:00.000","El Paso","TX","Passenger","1","0","1","286","287","0.3484320557491289198606271777"
"2022-07-31T00:00:00.000","Galveston","TX","Passenger","0","1","1","14","15","6.666666666666666666666666667"
"2022-07-31T00:00:00.000","Harris","TX","Passenger","1","0","1","110","111","0.9009009009009009009009009009"
"2022-07-31T00:00:00.000","Hidalgo","TX","Passenger","0","1","1","51","52","1.923076923076923076923076923"
"2022-07-31T00:00:00.000","Nueces","TX","Passenger","1","0","1","45","46","2.173913043478260869565217391"
"2022-07-31T00:00:00.000","Tarrant","TX","Passenger","1","0","1","80","81","1.234567901234567901234567901"
"2022-07-31T00:00:00.000","Wichita","TX","Passenger","1","0","1","34","35","2.857142857142857142857142857"
"2022-07-31T00:00:00.000","Williamson","TX","Passenger","1","0","1","64","65","1.538461538461538461538461538"
"2022-07-31T00:00:00.000","Salt Lake","UT","Passenger","2","2","4","94","98","4.081632653061224489795918367"
"2022-07-31T00:00:00.000","Albemarle","VA","Passenger","1","0","1","15","16","6.2500"
"2022-07-31T00:00:00.000","Alexandria","VA","Passenger","5","1","6","113","119","5.042016806722689075630252101"
"2022-07-31T00:00:00.000","Chesapeake","VA","Passenger","1","3","4","309","313","1.277955271565495207667731629"
"2022-07-31T00:00:00.000","Danville","VA","Passenger","1","0","1","0","1","100"
"2022-07-31T00:00:00.000","Fairfax","VA","Passenger","5","3","8","558","566","1.413427561837455830388692580"
"2022-07-31T00:00:00.000","Goochland","VA","Passenger","2","0","2","64","66","3.030303030303030303030303030"
"2022-07-31T00:00:00.000","Loudoun","VA","Passenger","2","0","2","51","53","3.773584905660377358490566038"
"2022-07-31T00:00:00.000","Louisa","VA","Passenger","0","1","1","0","1","100"
"2022-07-31T00:00:00.000","Manassas","VA","Passenger","0","1","1","5","6","16.66666666666666666666666667"
"2022-07-31T00:00:00.000","Norfolk","VA","Passenger","1","1","2","259","261","0.7662835249042145593869731801"
"2022-07-31T00:00:00.000","Portsmouth","VA","Passenger","1","1","2","57","59","3.389830508474576271186440678"
"2022-07-31T00:00:00.000","Prince William","VA","Passenger","0","1","1","168","169","0.5917159763313609467455621302"
"2022-07-31T00:00:00.000","Prince William","VA","Truck","1","0","1","22","23","4.347826086956521739130434783"
"2022-07-31T00:00:00.000","Stafford","VA","Passenger","2","1","3","79","82","3.658536585365853658536585366"
"2022-07-31T00:00:00.000","Suffolk","VA","Passenger","1","0","1","95","96","1.041666666666666666666666667"
"2022-07-31T00:00:00.000","Virginia Beach","VA","Passenger","2","0","2","427","429","0.4662004662004662004662004662"
"2022-07-31T00:00:00.000","Adams","WA","Passenger","19","12","31","12813","12844","0.2413578324509498598567424478"
"2022-07-31T00:00:00.000","Adams","WA","Truck","2","0","2","5393","5395","0.03707136237256719184430027804"
"2022-07-31T00:00:00.000","Asotin","WA","Passenger","25","20","45","12606","12651","0.3557031064737965378230969884"
"2022-07-31T00:00:00.000","Asotin","WA","Truck","1","0","1","6648","6649","0.01503985561738607309369830050"
"2022-07-31T00:00:00.000","Benton","WA","Passenger","790","467","1257","134288","135545","0.9273672949942823416577520381"
"2022-07-31T00:00:00.000","Benton","WA","Truck","40","0","40","43138","43178","0.09263977025336977164296632544"
"2022-07-31T00:00:00.000","Chelan","WA","Passenger","484","124","608","53860","54468","1.116251744143350223984724976"
"2022-07-31T00:00:00.000","Chelan","WA","Truck","16","0","16","22858","22874","0.06994841304537903296318964763"
"2022-07-31T00:00:00.000","Clallam","WA","Passenger","439","252","691","49358","50049","1.380646965973346120801614418"
"2022-07-31T00:00:00.000","Clallam","WA","Truck","8","0","8","21719","21727","0.03682054586459244258296129240"
"2022-07-31T00:00:00.000","Clark","WA","Passenger","4315","1848","6163","313092","319255","1.930431786502952185556999890"
"2022-07-31T00:00:00.000","Clark","WA","Truck","79","0","79","81857","81936","0.09641671548525678578402655731"
"2022-07-31T00:00:00.000","Columbia","WA","Truck","2","0","2","1564","1566","0.1277139208173690932311621967"
"2022-07-31T00:00:00.000","Columbia","WA","Passenger","7","0","7","2408","2415","0.2898550724637681159420289855"
"2022-07-31T00:00:00.000","Cowlitz","WA","Truck","12","0","12","28259","28271","0.04244632308726256588023062502"
"2022-07-31T00:00:00.000","Cowlitz","WA","Passenger","363","180","543","69997","70540","0.7697760136092996881202154806"
"2022-07-31T00:00:00.000","Douglas","WA","Truck","6","0","6","12687","12693","0.04727014890096903805246986528"
"2022-07-31T00:00:00.000","Douglas","WA","Passenger","137","61","198","28227","28425","0.6965699208443271767810026385"
"2022-07-31T00:00:00.000","Ferry","WA","Passenger","21","4","25","4352","4377","0.5711674663011194882339501942"
"2022-07-31T00:00:00.000","Ferry","WA","Truck","1","0","1","3525","3526","0.02836074872376630743051616563"
"2022-07-31T00:00:00.000","Franklin","WA","Truck","10","0","10","20706","20716","0.04827186715582158717899208341"
"2022-07-31T00:00:00.000","Franklin","WA","Passenger","208","115","323","61395","61718","0.5233481318253993972584983311"
"2022-07-31T00:00:00.000","Garfield","WA","Passenger","1","3","4","1327","1331","0.3005259203606311044327573253"
"2022-07-31T00:00:00.000","Garfield","WA","Truck","0","0","0","965","965","0"
"2022-07-31T00:00:00.000","Grant","WA","Passenger","187","106","293","66153","66446","0.4409595761972127742828763206"
"2022-07-31T00:00:00.000","Grant","WA","Truck","9","0","9","27696","27705","0.03248511099079588521927449919"
"2022-07-31T00:00:00.000","Grays Harbor","WA","Truck","11","0","11","21038","21049","0.05225901468003230557271129270"
"2022-07-31T00:00:00.000","Grays Harbor","WA","Passenger","229","167","396","48604","49000","0.8081632653061224489795918367"
"2022-07-31T00:00:00.000","Island","WA","Truck","22","0","22","21253","21275","0.1034077555816686251468860165"
"2022-07-31T00:00:00.000","Island","WA","Passenger","846","395","1241","61709","62950","1.971405877680698967434471803"
"2022-07-31T00:00:00.000","Jefferson","WA","Passenger","448","227","675","24414","25089","2.690422097333492765753916059"
"2022-07-31T00:00:00.000","Jefferson","WA","Truck","8","0","8","9405","9413","0.08498884521406565388292786572"
"2022-07-31T00:00:00.000","King","WA","Truck","337","2","339","178883","179222","0.1891508854939683744183191796"
"2022-07-31T00:00:00.000","King","WA","Passenger","42105","11648","53753","1339546","1393299","3.857965878106565783798021817"
"2022-07-31T00:00:00.000","Kitsap","WA","Passenger","2536","1112","3648","177549","181197","2.013278365535853242603354360"
"2022-07-31T00:00:00.000","Kitsap","WA","Truck","59","0","59","53152","53211","0.1108793294619533555091992257"
"2022-07-31T00:00:00.000","Kittitas","WA","Truck","7","0","7","14504","14511","0.04823926676314520019295706705"
"2022-07-31T00:00:00.000","Kittitas","WA","Passenger","279","87","366","29428","29794","1.228435255420554474055178895"
"2022-07-31T00:00:00.000","Klickitat","WA","Truck","2","0","2","8193","8195","0.02440512507626601586333129957"
"2022-07-31T00:00:00.000","Klickitat","WA","Passenger","108","57","165","15050","15215","1.084456128820243181071311206"
"2022-07-31T00:00:00.000","Lewis","WA","Passenger","256","178","434","59214","59648","0.7276019313304721030042918455"
"2022-07-31T00:00:00.000","Lewis","WA","Truck","9","0","9","26126","26135","0.03443657929978955423761239717"
"2022-07-31T00:00:00.000","Lincoln","WA","Truck","0","0","0","4823","4823","0"
"2022-07-31T00:00:00.000","Lincoln","WA","Passenger","11","16","27","7673","7700","0.3506493506493506493506493506"
"2022-07-31T00:00:00.000","Mason","WA","Passenger","335","184","519","46787","47306","1.097112417029552276666807593"
"2022-07-31T00:00:00.000","Mason","WA","Truck","20","0","20","20794","20814","0.09608917075045642356106466801"
"2022-07-31T00:00:00.000","Okanogan","WA","Truck","4","0","4","16437","16441","0.02432942035156012408004379296"
"2022-07-31T00:00:00.000","Okanogan","WA","Passenger","90","50","140","26066","26206","0.5342288025642982523086316111"
"2022-07-31T00:00:00.000","Pacific","WA","Truck","2","0","2","7845","7847","0.02548744743213967121192812540"
"2022-07-31T00:00:00.000","Pacific","WA","Passenger","71","73","144","15758","15902","0.9055464721418689473022261351"
"2022-07-31T00:00:00.000","Pend Oreille","WA","Truck","1","0","1","5576","5577","0.01793078716155639232562309485"
"2022-07-31T00:00:00.000","Pend Oreille","WA","Passenger","19","12","31","8983","9014","0.3439094741513201686265808742"
"2022-07-31T00:00:00.000","Pierce","WA","Truck","121","0","121","140255","140376","0.08619707072434034307858893258"
"2022-07-31T00:00:00.000","Pierce","WA","Passenger","5434","2414","7848","540725","548573","1.430620901867208192893197441"
"2022-07-31T00:00:00.000","San Juan","WA","Truck","7","0","7","5910","5917","0.1183031941862430285617711678"
"2022-07-31T00:00:00.000","San Juan","WA","Passenger","515","154","669","13907","14576","4.589736553238199780461031833"
"2022-07-31T00:00:00.000","Skagit","WA","Passenger","831","365","1196","89177","90373","1.323404114060615449304548925"
"2022-07-31T00:00:00.000","Skagit","WA","Truck","32","0","32","32050","32082","0.09974440496228414687363630696"
"2022-07-31T00:00:00.000","Skamania","WA","Passenger","79","47","126","8083","8209","1.534900718723352418077719576"
"2022-07-31T00:00:00.000","Skamania","WA","Truck","0","0","0","3902","3902","0"
"2022-07-31T00:00:00.000","Snohomish","WA","Passenger","8790","2648","11438","528148","539586","2.119773307684039244902573454"
"2022-07-31T00:00:00.000","Snohomish","WA","Truck","135","0","135","122491","122626","0.1100908453345946210428457260"
"2022-07-31T00:00:00.000","Spokane","WA","Passenger","1714","894","2608","322709","325317","0.8016795925205261329718397747"
"2022-07-31T00:00:00.000","Spokane","WA","Truck","74","0","74","101365","101439","0.07295024596062658346395370617"
"2022-07-31T00:00:00.000","Stevens","WA","Passenger","74","56","130","29886","30016","0.4331023454157782515991471215"
"2022-07-31T00:00:00.000","Stevens","WA","Truck","4","0","4","18746","18750","0.02133333333333333333333333333"
"2022-07-31T00:00:00.000","Thurston","WA","Truck","54","0","54","55050","55104","0.09799651567944250871080139373"
"2022-07-31T00:00:00.000","Thurston","WA","Passenger","2324","1116","3440","192659","196099","1.754215982743410216268313454"
"2022-07-31T00:00:00.000","Wahkiakum","WA","Passenger","23","13","36","3047","3083","1.167693804735647096983457671"
"2022-07-31T00:00:00.000","Wahkiakum","WA","Truck","1","0","1","1792","1793","0.05577244841048522030117122142"
"2022-07-31T00:00:00.000","Walla Walla","WA","Passenger","176","102","278","35578","35856","0.7753235162873717090584560464"
"2022-07-31T00:00:00.000","Walla Walla","WA","Truck","7","0","7","13776","13783","0.05078720162519045200609446420"
"2022-07-31T00:00:00.000","Whatcom","WA","Truck","36","0","36","42890","42926","0.08386525648790942552299305782"
"2022-07-31T00:00:00.000","Whatcom","WA","Passenger","1908","774","2682","147690","150372","1.783576729710318410342350970"
"2022-07-31T00:00:00.000","Whitman","WA","Passenger","91","62","153","21829","21982","0.6960240196524429078336821035"
"2022-07-31T00:00:00.000","Whitman","WA","Truck","7","0","7","8511","8518","0.08217891523831885419112467715"
"2022-07-31T00:00:00.000","Yakima","WA","Passenger","365","209","574","165308","165882","0.3460291050264645953147418044"
"2022-07-31T00:00:00.000","Yakima","WA","Truck","9","0","9","60629","60638","0.01484217817210330156007783898"
"2022-07-31T00:00:00.000","Douglas","WI","Passenger","1","0","1","1","2","50.0"
"2022-07-31T00:00:00.000","Ozaukee","WI","Passenger","0","1","1","2","3","33.33333333333333333333333333"
"2022-07-31T00:00:00.000","Sheridan","WY","Passenger","1","0","1","7","8","12.500"
"2022-08-31T00:00:00.000","Anchorage","AK","Passenger","1","0","1","96","97","1.030927835051546391752577320"
"2022-08-31T00:00:00.000","Fairbanks North Star","AK","Passenger","0","1","1","62","63","1.587301587301587301587301587"
"2022-08-31T00:00:00.000","Juneau","AK","Passenger","0","1","1","23","24","4.166666666666666666666666667"
"2022-08-31T00:00:00.000","Montgomery","AL","Passenger","0","1","1","31","32","3.12500"
"2022-08-31T00:00:00.000","Pulaski","AR","Passenger","1","0","1","24","25","4.00"
"2022-08-31T00:00:00.000","Maricopa","AZ","Passenger","4","2","6","557","563","1.065719360568383658969804618"
"2022-08-31T00:00:00.000","Pinal","AZ","Passenger","1","0","1","74","75","1.333333333333333333333333333"
"2022-08-31T00:00:00.000","Alameda","CA","Passenger","3","0","3","144","147","2.040816326530612244897959184"
"2022-08-31T00:00:00.000","Contra Costa","CA","Passenger","0","6","6","255","261","2.298850574712643678160919540"
"2022-08-31T00:00:00.000","Kern","CA","Passenger","1","1","2","152","154","1.298701298701298701298701299"
"2022-08-31T00:00:00.000","Kings","CA","Passenger","1","0","1","273","274","0.3649635036496350364963503650"
"2022-08-31T00:00:00.000","Los Angeles","CA","Passenger","2","5","7","585","592","1.182432432432432432432432432"
"2022-08-31T00:00:00.000","Marin","CA","Passenger","0","1","1","27","28","3.571428571428571428571428571"
"2022-08-31T00:00:00.000","Monterey","CA","Passenger","1","1","2","107","109","1.834862385321100917431192661"
"2022-08-31T00:00:00.000","Orange","CA","Passenger","5","2","7","278","285","2.456140350877192982456140351"
"2022-08-31T00:00:00.000","Placer","CA","Passenger","1","0","1","49","50","2.00"
"2022-08-31T00:00:00.000","Riverside","CA","Passenger","6","1","7","350","357","1.960784313725490196078431373"
"2022-08-31T00:00:00.000","Sacramento","CA","Passenger","1","0","1","162","163","0.6134969325153374233128834356"
"2022-08-31T00:00:00.000","San Bernardino","CA","Passenger","1","1","2","262","264","0.7575757575757575757575757576"
"2022-08-31T00:00:00.000","San Diego","CA","Passenger","15","8","23","1940","1963","1.171676006113092205807437596"
"2022-08-31T00:00:00.000","San Joaquin","CA","Passenger","0","1","1","68","69","1.449275362318840579710144928"
"2022-08-31T00:00:00.000","Santa Barbara","CA","Passenger","1","0","1","57","58","1.724137931034482758620689655"
"2022-08-31T00:00:00.000","Santa Clara","CA","Passenger","5","1","6","151","157","3.821656050955414012738853503"
"2022-08-31T00:00:00.000","Santa Cruz","CA","Passenger","1","0","1","15","16","6.2500"
"2022-08-31T00:00:00.000","Solano","CA","Passenger","2","0","2","149","151","1.324503311258278145695364238"
"2022-08-31T00:00:00.000","Sonoma","CA","Passenger","0","1","1","60","61","1.639344262295081967213114754"
"2022-08-31T00:00:00.000","Ventura","CA","Passenger","2","1","3","204","207","1.449275362318840579710144928"
"2022-08-31T00:00:00.000","Arapahoe","CO","Passenger","0","1","1","64","65","1.538461538461538461538461538"
"2022-08-31T00:00:00.000","Boulder","CO","Passenger","1","0","1","19","20","5.00"
"2022-08-31T00:00:00.000","El Paso","CO","Passenger","3","1","4","476","480","0.8333333333333333333333333333"
"2022-08-31T00:00:00.000","Larimer","CO","Passenger","1","0","1","34","35","2.857142857142857142857142857"
"2022-08-31T00:00:00.000","Las Animas","CO","Passenger","1","0","1","0","1","100"
"2022-08-31T00:00:00.000","New London","CT","Passenger","1","4","5","185","190","2.631578947368421052631578947"
"2022-08-31T00:00:00.000","District of Columbia","DC","Passenger","3","2","5","161","166","3.012048192771084337349397590"
"2022-08-31T00:00:00.000","Kent","DE","Passenger","0","1","1","44","45","2.222222222222222222222222222"
"2022-08-31T00:00:00.000","New Castle","DE","Passenger","1","0","1","15","16","6.2500"
"2022-08-31T00:00:00.000","Duval","FL","Passenger","0","1","1","208","209","0.4784688995215311004784688995"
"2022-08-31T00:00:00.000","Hillsborough","FL","Passenger","0","1","1","94","95","1.052631578947368421052631579"
"2022-08-31T00:00:00.000","Lake","FL","Passenger","1","0","1","12","13","7.692307692307692307692307692"
"2022-08-31T00:00:00.000","Monroe","FL","Passenger","0","1","1","34","35","2.857142857142857142857142857"
"2022-08-31T00:00:00.000","Okaloosa","FL","Passenger","0","1","1","69","70","1.428571428571428571428571429"
"2022-08-31T00:00:00.000","Orange","FL","Passenger","1","0","1","57","58","1.724137931034482758620689655"
"2022-08-31T00:00:00.000","Palm Beach","FL","Passenger","1","0","1","33","34","2.941176470588235294117647059"
"2022-08-31T00:00:00.000","Sarasota","FL","Passenger","2","0","2","19","21","9.523809523809523809523809524"
"2022-08-31T00:00:00.000","Bartow","GA","Passenger","0","1","1","2","3","33.33333333333333333333333333"
"2022-08-31T00:00:00.000","Bryan","GA","Passenger","1","0","1","33","34","2.941176470588235294117647059"
"2022-08-31T00:00:00.000","Columbia","GA","Passenger","1","1","2","74","76","2.631578947368421052631578947"
"2022-08-31T00:00:00.000","DeKalb","GA","Passenger","1","0","1","31","32","3.12500"
"2022-08-31T00:00:00.000","Houston","GA","Passenger","1","0","1","29","30","3.333333333333333333333333333"
"2022-08-31T00:00:00.000","Rockdale","GA","Passenger","1","0","1","4","5","20.0"
"2022-08-31T00:00:00.000","Honolulu","HI","Passenger","2","1","3","255","258","1.162790697674418604651162791"
"2022-08-31T00:00:00.000","Kootenai","ID","Truck","1","0","1","27","28","3.571428571428571428571428571"
"2022-08-31T00:00:00.000","Cook","IL","Passenger","1","0","1","134","135","0.7407407407407407407407407407"
"2022-08-31T00:00:00.000","Lake","IL","Passenger","3","0","3","120","123","2.439024390243902439024390244"
"2022-08-31T00:00:00.000","Rock Island","IL","Passenger","0","1","1","13","14","7.142857142857142857142857143"
"2022-08-31T00:00:00.000","St. Clair","IL","Passenger","2","0","2","103","105","1.904761904761904761904761905"
"2022-08-31T00:00:00.000","Hamilton","IN","Passenger","1","0","1","17","18","5.555555555555555555555555556"
"2022-08-31T00:00:00.000","Geary","KS","Passenger","1","0","1","71","72","1.388888888888888888888888889"
"2022-08-31T00:00:00.000","Leavenworth","KS","Passenger","1","1","2","85","87","2.298850574712643678160919540"
"2022-08-31T00:00:00.000","Oldham","KY","Passenger","0","1","1","4","5","20.0"
"2022-08-31T00:00:00.000","Plaquemines","LA","Passenger","0","1","1","13","14","7.142857142857142857142857143"
"2022-08-31T00:00:00.000","Middlesex","MA","Passenger","2","1","3","60","63","4.761904761904761904761904762"
"2022-08-31T00:00:00.000","Anne Arundel","MD","Passenger","4","3","7","282","289","2.422145328719723183391003460"
"2022-08-31T00:00:00.000","Anne Arundel","MD","Truck","1","0","1","43","44","2.272727272727272727272727273"
"2022-08-31T00:00:00.000","Calvert","MD","Passenger","0","2","2","70","72","2.777777777777777777777777778"
"2022-08-31T00:00:00.000","Carroll","MD","Passenger","0","1","1","10","11","9.090909090909090909090909091"
"2022-08-31T00:00:00.000","Charles","MD","Passenger","0","1","1","47","48","2.083333333333333333333333333"
"2022-08-31T00:00:00.000","Frederick","MD","Passenger","2","0","2","59","61","3.278688524590163934426229508"
"2022-08-31T00:00:00.000","Howard","MD","Passenger","0","1","1","50","51","1.960784313725490196078431373"
"2022-08-31T00:00:00.000","Montgomery","MD","Passenger","3","5","8","170","178","4.494382022471910112359550562"
"2022-08-31T00:00:00.000","Prince George's","MD","Passenger","2","0","2","97","99","2.020202020202020202020202020"
"2022-08-31T00:00:00.000","St. Mary's","MD","Truck","1","0","1","41","42","2.380952380952380952380952381"
"2022-08-31T00:00:00.000","St. Mary's","MD","Passenger","1","0","1","144","145","0.6896551724137931034482758621"
"2022-08-31T00:00:00.000","Washington","MD","Passenger","1","0","1","11","12","8.333333333333333333333333333"
"2022-08-31T00:00:00.000","Penobscot","ME","Passenger","0","1","1","8","9","11.11111111111111111111111111"
"2022-08-31T00:00:00.000","Platte","MO","Passenger","1","0","1","14","15","6.666666666666666666666666667"
"2022-08-31T00:00:00.000","Ray","MO","Passenger","0","1","1","0","1","100"
"2022-08-31T00:00:00.000","St. Louis","MO","Passenger","1","0","1","54","55","1.818181818181818181818181818"
"2022-08-31T00:00:00.000","Harrison","MS","Passenger","1","0","1","32","33","3.030303030303030303030303030"
"2022-08-31T00:00:00.000","Cumberland","NC","Passenger","0","2","2","313","315","0.6349206349206349206349206349"
"2022-08-31T00:00:00.000","Cumberland","NC","Truck","1","0","1","71","72","1.388888888888888888888888889"
"2022-08-31T00:00:00.000","Hoke","NC","Passenger","1","0","1","57","58","1.724137931034482758620689655"
"2022-08-31T00:00:00.000","Mecklenburg","NC","Passenger","1","0","1","43","44","2.272727272727272727272727273"
"2022-08-31T00:00:00.000","Moore","NC","Passenger","0","1","1","104","105","0.9523809523809523809523809524"
"2022-08-31T00:00:00.000","Onslow","NC","Passenger","0","1","1","135","136","0.7352941176470588235294117647"
"2022-08-31T00:00:00.000","Wayne","NC","Passenger","1","0","1","24","25","4.00"
"2022-08-31T00:00:00.000","Williams","ND","Passenger","0","1","1","5","6","16.66666666666666666666666667"
"2022-08-31T00:00:00.000","Douglas","NE","Passenger","1","2","3","34","37","8.108108108108108108108108108"
"2022-08-31T00:00:00.000","Sarpy","NE","Passenger","1","0","1","40","41","2.439024390243902439024390244"
"2022-08-31T00:00:00.000","Carroll","NH","Passenger","0","1","1","3","4","25.00"
"2022-08-31T00:00:00.000","Burlington","NJ","Passenger","0","2","2","99","101","1.980198019801980198019801980"
"2022-08-31T00:00:00.000","Camden","NJ","Passenger","0","1","1","7","8","12.500"
"2022-08-31T00:00:00.000","Hudson","NJ","Truck","1","0","1","9","10","10.0"
"2022-08-31T00:00:00.000","Hudson","NJ","Passenger","1","0","1","74","75","1.333333333333333333333333333"
"2022-08-31T00:00:00.000","Chaves","NM","Passenger","1","0","1","2","3","33.33333333333333333333333333"
"2022-08-31T00:00:00.000","Clark","NV","Passenger","5","4","9","408","417","2.158273381294964028776978417"
"2022-08-31T00:00:00.000","Jefferson","NY","Passenger","0","1","1","173","174","0.5747126436781609195402298851"
"2022-08-31T00:00:00.000","Queens","NY","Passenger","1","0","1","27","28","3.571428571428571428571428571"
"2022-08-31T00:00:00.000","Saratoga","NY","Passenger","1","0","1","35","36","2.777777777777777777777777778"
"2022-08-31T00:00:00.000","Hamilton","OH","Passenger","1","0","1","22","23","4.347826086956521739130434783"
"2022-08-31T00:00:00.000","Jackson","OK","Passenger","0","1","1","25","26","3.846153846153846153846153846"
"2022-08-31T00:00:00.000","Rogers","OK","Passenger","1","0","1","1","2","50.0"
"2022-08-31T00:00:00.000","Clackamas","OR","Passenger","2","0","2","103","105","1.904761904761904761904761905"
"2022-08-31T00:00:00.000","Douglas","OR","Passenger","1","0","1","23","24","4.166666666666666666666666667"
"2022-08-31T00:00:00.000","Lincoln","OR","Passenger","0","1","1","21","22","4.545454545454545454545454545"
"2022-08-31T00:00:00.000","Multnomah","OR","Passenger","0","1","1","384","385","0.2597402597402597402597402597"
"2022-08-31T00:00:00.000","Allegheny","PA","Passenger","1","1","2","37","39","5.128205128205128205128205128"
"2022-08-31T00:00:00.000","Cumberland","PA","Passenger","1","0","1","33","34","2.941176470588235294117647059"
"2022-08-31T00:00:00.000","Montgomery","PA","Passenger","1","0","1","12","13","7.692307692307692307692307692"
"2022-08-31T00:00:00.000","Philadelphia","PA","Passenger","1","0","1","28","29","3.448275862068965517241379310"
"2022-08-31T00:00:00.000","Newport","RI","Truck","1","0","1","9","10","10.0"
"2022-08-31T00:00:00.000","Newport","RI","Passenger","1","0","1","68","69","1.449275362318840579710144928"
"2022-08-31T00:00:00.000","Charleston","SC","Passenger","1","0","1","49","50","2.00"
"2022-08-31T00:00:00.000","Spartanburg","SC","Passenger","0","1","1","18","19","5.263157894736842105263157895"
"2022-08-31T00:00:00.000","Sumter","SC","Passenger","1","1","2","27","29","6.896551724137931034482758621"
"2022-08-31T00:00:00.000","Pennington","SD","Passenger","1","0","1","20","21","4.761904761904761904761904762"
"2022-08-31T00:00:00.000","Montgomery","TN","Passenger","2","0","2","151","153","1.307189542483660130718954248"
"2022-08-31T00:00:00.000","Tipton","TN","Passenger","1","0","1","10","11","9.090909090909090909090909091"
"2022-08-31T00:00:00.000","Bell","TX","Passenger","0","1","1","248","249","0.4016064257028112449799196787"
"2022-08-31T00:00:00.000","Bexar","TX","Passenger","6","2","8","353","361","2.216066481994459833795013850"
"2022-08-31T00:00:00.000","Coryell","TX","Passenger","1","0","1","73","74","1.351351351351351351351351351"
"2022-08-31T00:00:00.000","Denton","TX","Passenger","1","0","1","40","41","2.439024390243902439024390244"
"2022-08-31T00:00:00.000","El Paso","TX","Passenger","1","0","1","276","277","0.3610108303249097472924187726"
"2022-08-31T00:00:00.000","Galveston","TX","Passenger","0","1","1","14","15","6.666666666666666666666666667"
"2022-08-31T00:00:00.000","Harris","TX","Passenger","1","0","1","103","104","0.9615384615384615384615384615"
"2022-08-31T00:00:00.000","Hidalgo","TX","Passenger","0","1","1","51","52","1.923076923076923076923076923"
"2022-08-31T00:00:00.000","Nueces","TX","Passenger","1","0","1","43","44","2.272727272727272727272727273"
"2022-08-31T00:00:00.000","Tarrant","TX","Passenger","1","0","1","79","80","1.2500"
"2022-08-31T00:00:00.000","Wichita","TX","Passenger","2","0","2","33","35","5.714285714285714285714285714"
"2022-08-31T00:00:00.000","Salt Lake","UT","Passenger","2","2","4","90","94","4.255319148936170212765957447"
"2022-08-31T00:00:00.000","Albemarle","VA","Passenger","1","0","1","15","16","6.2500"
"2022-08-31T00:00:00.000","Alexandria","VA","Passenger","5","1","6","108","114","5.263157894736842105263157895"
"2022-08-31T00:00:00.000","Chesapeake","VA","Passenger","1","3","4","299","303","1.320132013201320132013201320"
"2022-08-31T00:00:00.000","Danville","VA","Passenger","1","0","1","0","1","100"
"2022-08-31T00:00:00.000","Fairfax","VA","Passenger","5","3","8","551","559","1.431127012522361359570661896"
"2022-08-31T00:00:00.000","Goochland","VA","Passenger","1","0","1","51","52","1.923076923076923076923076923"
"2022-08-31T00:00:00.000","Loudoun","VA","Passenger","2","0","2","50","52","3.846153846153846153846153846"
"2022-08-31T00:00:00.000","Louisa","VA","Passenger","0","1","1","0","1","100"
"2022-08-31T00:00:00.000","Manassas","VA","Passenger","0","1","1","5","6","16.66666666666666666666666667"
"2022-08-31T00:00:00.000","Norfolk","VA","Passenger","1","1","2","254","256","0.7812500"
"2022-08-31T00:00:00.000","Portsmouth","VA","Passenger","1","1","2","57","59","3.389830508474576271186440678"
"2022-08-31T00:00:00.000","Prince William","VA","Truck","1","0","1","20","21","4.761904761904761904761904762"
"2022-08-31T00:00:00.000","Stafford","VA","Passenger","2","1","3","78","81","3.703703703703703703703703704"
"2022-08-31T00:00:00.000","Suffolk","VA","Passenger","1","0","1","94","95","1.052631578947368421052631579"
"2022-08-31T00:00:00.000","Virginia Beach","VA","Passenger","2","0","2","421","423","0.4728132387706855791962174941"
"2022-08-31T00:00:00.000","Adams","WA","Passenger","21","10","31","12735","12766","0.2428325238915870280432398559"
"2022-08-31T00:00:00.000","Adams","WA","Truck","2","0","2","5328","5330","0.03752345215759849906191369606"
"2022-08-31T00:00:00.000","Asotin","WA","Passenger","24","19","43","12497","12540","0.3429027113237639553429027113"
"2022-08-31T00:00:00.000","Asotin","WA","Truck","1","0","1","6615","6616","0.01511487303506650544135429262"
"2022-08-31T00:00:00.000","Benton","WA","Passenger","823","471","1294","133493","134787","0.9600332376267740954246329394"
"2022-08-31T00:00:00.000","Benton","WA","Truck","40","0","40","42777","42817","0.09342083751780834715183221618"
"2022-08-31T00:00:00.000","Chelan","WA","Truck","17","0","17","22685","22702","0.07488327019645846180953219981"
"2022-08-31T00:00:00.000","Chelan","WA","Passenger","487","133","620","53460","54080","1.146449704142011834319526627"
"2022-08-31T00:00:00.000","Clallam","WA","Passenger","440","251","691","49020","49711","1.390034398825209712136146929"
"2022-08-31T00:00:00.000","Clallam","WA","Truck","9","0","9","21595","21604","0.04165895204591742269950009258"
"2022-08-31T00:00:00.000","Clark","WA","Truck","85","0","85","81147","81232","0.1046385660823320858774867047"
"2022-08-31T00:00:00.000","Clark","WA","Passenger","4418","1891","6309","311105","317414","1.987624994486695608889336954"
"2022-08-31T00:00:00.000","Columbia","WA","Passenger","8","0","8","2397","2405","0.3326403326403326403326403326"
"2022-08-31T00:00:00.000","Columbia","WA","Truck","2","0","2","1549","1551","0.1289490651192778852353320438"
"2022-08-31T00:00:00.000","Cowlitz","WA","Truck","12","0","12","28055","28067","0.04275483664089500124701606869"
"2022-08-31T00:00:00.000","Cowlitz","WA","Passenger","364","181","545","69448","69993","0.7786492935007786492935007786"
"2022-08-31T00:00:00.000","Douglas","WA","Truck","6","0","6","12612","12618","0.04755111745126010461245839277"
"2022-08-31T00:00:00.000","Douglas","WA","Passenger","138","61","199","28034","28233","0.7048489356426876350370134240"
"2022-08-31T00:00:00.000","Ferry","WA","Passenger","20","4","24","4339","4363","0.5500802200320880128352051341"
"2022-08-31T00:00:00.000","Ferry","WA","Truck","1","0","1","3514","3515","0.02844950213371266002844950213"
"2022-08-31T00:00:00.000","Franklin","WA","Passenger","229","117","346","61031","61377","0.5637290841846294214445150464"
"2022-08-31T00:00:00.000","Franklin","WA","Truck","10","0","10","20597","20607","0.04852719949531712524870189741"
"2022-08-31T00:00:00.000","Garfield","WA","Truck","0","0","0","958","958","0"
"2022-08-31T00:00:00.000","Garfield","WA","Passenger","1","3","4","1317","1321","0.3028009084027252081756245269"
"2022-08-31T00:00:00.000","Grant","WA","Passenger","201","110","311","65786","66097","0.4705205985143047339516165635"
"2022-08-31T00:00:00.000","Grant","WA","Truck","11","0","11","27515","27526","0.03996221753978057109641793214"
"2022-08-31T00:00:00.000","Grays Harbor","WA","Passenger","230","168","398","48246","48644","0.8181892936436148343063892772"
"2022-08-31T00:00:00.000","Grays Harbor","WA","Truck","11","0","11","20882","20893","0.05264921265495620542765519552"
"2022-08-31T00:00:00.000","Island","WA","Truck","24","0","24","21109","21133","0.1135664600388018738465906402"
"2022-08-31T00:00:00.000","Island","WA","Passenger","866","393","1259","61387","62646","2.009705328352967467994764231"
"2022-08-31T00:00:00.000","Jefferson","WA","Passenger","457","231","688","24255","24943","2.758288898689010944954496251"
"2022-08-31T00:00:00.000","Jefferson","WA","Truck","9","0","9","9325","9334","0.09642168416541675594600385687"
"2022-08-31T00:00:00.000","King","WA","Passenger","43018","11800","54818","1331895","1386713","3.953089067456640270914024748"
"2022-08-31T00:00:00.000","King","WA","Truck","416","2","418","177433","177851","0.2350281977610471686973927614"
"2022-08-31T00:00:00.000","Kitsap","WA","Truck","63","0","63","52743","52806","0.1193046244744915350528349051"
"2022-08-31T00:00:00.000","Kitsap","WA","Passenger","2593","1132","3725","176340","180065","2.068697414822425235331685780"
"2022-08-31T00:00:00.000","Kittitas","WA","Passenger","285","89","374","29133","29507","1.267495848442742400108448843"
"2022-08-31T00:00:00.000","Kittitas","WA","Truck","8","0","8","14401","14409","0.05552085502116732597682004303"
"2022-08-31T00:00:00.000","Klickitat","WA","Truck","4","0","4","8131","8135","0.04917025199754148740012292563"
"2022-08-31T00:00:00.000","Klickitat","WA","Passenger","107","55","162","14949","15111","1.072066706372840976771888029"
"2022-08-31T00:00:00.000","Lewis","WA","Passenger","249","177","426","58865","59291","0.7184901587087416302642896898"
"2022-08-31T00:00:00.000","Lewis","WA","Truck","9","0","9","25892","25901","0.03474769313926103239257171538"
"2022-08-31T00:00:00.000","Lincoln","WA","Passenger","11","15","26","7606","7632","0.3406708595387840670859538784"
"2022-08-31T00:00:00.000","Lincoln","WA","Truck","0","0","0","4812","4812","0"
"2022-08-31T00:00:00.000","Mason","WA","Truck","20","0","20","20647","20667","0.09677263269947258915178787439"
"2022-08-31T00:00:00.000","Mason","WA","Passenger","343","184","527","46391","46918","1.123236284581610469329468434"
"2022-08-31T00:00:00.000","Okanogan","WA","Passenger","90","49","139","25890","26029","0.5340197472050405317146259941"
"2022-08-31T00:00:00.000","Okanogan","WA","Truck","4","0","4","16261","16265","0.02459268367660620965262834307"
"2022-08-31T00:00:00.000","Pacific","WA","Passenger","78","73","151","15648","15799","0.9557566934616114943983796443"
"2022-08-31T00:00:00.000","Pacific","WA","Truck","3","0","3","7792","7795","0.03848620910840282232200128287"
"2022-08-31T00:00:00.000","Pend Oreille","WA","Passenger","19","12","31","8915","8946","0.3465235859602056785155376705"
"2022-08-31T00:00:00.000","Pend Oreille","WA","Truck","1","0","1","5527","5528","0.01808972503617945007235890014"
"2022-08-31T00:00:00.000","Pierce","WA","Truck","134","0","134","138920","139054","0.09636544076401973334100421419"
"2022-08-31T00:00:00.000","Pierce","WA","Passenger","5595","2466","8061","536531","544592","1.480190674853835531921144637"
"2022-08-31T00:00:00.000","San Juan","WA","Passenger","523","156","679","13783","14462","4.695062923523717328170377541"
"2022-08-31T00:00:00.000","San Juan","WA","Truck","8","0","8","5870","5878","0.1361007145287512759441987070"
"2022-08-31T00:00:00.000","Skagit","WA","Truck","31","0","31","31772","31803","0.09747508096720435179071156809"
"2022-08-31T00:00:00.000","Skagit","WA","Passenger","871","368","1239","88631","89870","1.378658061644597752308890620"
"2022-08-31T00:00:00.000","Skamania","WA","Passenger","85","50","135","8001","8136","1.659292035398230088495575221"
"2022-08-31T00:00:00.000","Skamania","WA","Truck","0","0","0","3826","3826","0"
"2022-08-31T00:00:00.000","Snohomish","WA","Passenger","9030","2661","11691","524885","536576","2.178815302958015267175572519"
"2022-08-31T00:00:00.000","Snohomish","WA","Truck","154","0","154","121365","121519","0.1267291534657131806548770151"
"2022-08-31T00:00:00.000","Spokane","WA","Passenger","1772","909","2681","320734","323415","0.8289658797520213966575452592"
"2022-08-31T00:00:00.000","Spokane","WA","Truck","74","0","74","100756","100830","0.07339085589606267975800852921"
"2022-08-31T00:00:00.000","Stevens","WA","Truck","4","0","4","18640","18644","0.02145462347135807766573696632"
"2022-08-31T00:00:00.000","Stevens","WA","Passenger","77","58","135","29680","29815","0.4527922186818715411705517357"
"2022-08-31T00:00:00.000","Thurston","WA","Truck","61","0","61","54505","54566","0.1117912253051350657918850566"
"2022-08-31T00:00:00.000","Thurston","WA","Passenger","2404","1130","3534","191134","194668","1.815398524667639262744775721"
"2022-08-31T00:00:00.000","Wahkiakum","WA","Passenger","23","13","36","3031","3067","1.173785458102380176067818715"
"2022-08-31T00:00:00.000","Wahkiakum","WA","Truck","2","0","2","1776","1778","0.1124859392575928008998875141"
"2022-08-31T00:00:00.000","Walla Walla","WA","Truck","8","0","8","13688","13696","0.05841121495327102803738317757"
"2022-08-31T00:00:00.000","Walla Walla","WA","Passenger","179","107","286","35383","35669","0.8018167035801396170343996187"
"2022-08-31T00:00:00.000","Whatcom","WA","Passenger","1945","785","2730","146810","149540","1.825598502073023940082920958"
"2022-08-31T00:00:00.000","Whatcom","WA","Truck","37","0","37","42507","42544","0.08696878525761564497931553215"
"2022-08-31T00:00:00.000","Whitman","WA","Truck","7","0","7","8443","8450","0.08284023668639053254437869822"
"2022-08-31T00:00:00.000","Whitman","WA","Passenger","97","63","160","21703","21863","0.7318300324749576910762475415"
"2022-08-31T00:00:00.000","Yakima","WA","Truck","9","0","9","60123","60132","0.01496707244063061265216523648"
"2022-08-31T00:00:00.000","Yakima","WA","Passenger","371","215","586","163971","164557","0.3561076101290130471508352729"
"2022-08-31T00:00:00.000","Douglas","WI","Passenger","1","0","1","1","2","50.0"
"2022-08-31T00:00:00.000","Ozaukee","WI","Passenger","0","1","1","2","3","33.33333333333333333333333333"
"2022-08-31T00:00:00.000","Sheridan","WY","Passenger","1","0","1","6","7","14.28571428571428571428571429"
"2022-09-30T00:00:00.000","Anchorage","AK","Passenger","1","0","1","92","93","1.075268817204301075268817204"
"2022-09-30T00:00:00.000","Fairbanks North Star","AK","Passenger","0","1","1","59","60","1.666666666666666666666666667"
"2022-09-30T00:00:00.000","Juneau","AK","Passenger","0","1","1","23","24","4.166666666666666666666666667"
"2022-09-30T00:00:00.000","Montgomery","AL","Passenger","0","1","1","31","32","3.12500"
"2022-09-30T00:00:00.000","Pulaski","AR","Passenger","1","0","1","24","25","4.00"
"2022-09-30T00:00:00.000","Maricopa","AZ","Passenger","4","1","5","515","520","0.9615384615384615384615384615"
"2022-09-30T00:00:00.000","Pinal","AZ","Passenger","1","0","1","68","69","1.449275362318840579710144928"
"2022-09-30T00:00:00.000","Alameda","CA","Passenger","3","0","3","138","141","2.127659574468085106382978723"
"2022-09-30T00:00:00.000","Contra Costa","CA","Passenger","0","5","5","248","253","1.976284584980237154150197628"
"2022-09-30T00:00:00.000","Kern","CA","Passenger","2","1","3","151","154","1.948051948051948051948051948"
"2022-09-30T00:00:00.000","Kings","CA","Passenger","1","0","1","269","270","0.3703703703703703703703703704"
"2022-09-30T00:00:00.000","Los Angeles","CA","Passenger","2","4","6","554","560","1.071428571428571428571428571"
"2022-09-30T00:00:00.000","Marin","CA","Passenger","0","1","1","27","28","3.571428571428571428571428571"
"2022-09-30T00:00:00.000","Monterey","CA","Passenger","1","1","2","98","100","2.00"
"2022-09-30T00:00:00.000","Napa","CA","Passenger","0","1","1","8","9","11.11111111111111111111111111"
"2022-09-30T00:00:00.000","Orange","CA","Passenger","3","2","5","267","272","1.838235294117647058823529412"
"2022-09-30T00:00:00.000","Placer","CA","Passenger","1","0","1","46","47","2.127659574468085106382978723"
"2022-09-30T00:00:00.000","Riverside","CA","Passenger","6","0","6","349","355","1.690140845070422535211267606"
"2022-09-30T00:00:00.000","Sacramento","CA","Passenger","1","0","1","159","160","0.62500"
"2022-09-30T00:00:00.000","San Bernardino","CA","Passenger","1","1","2","253","255","0.7843137254901960784313725490"
"2022-09-30T00:00:00.000","San Diego","CA","Passenger","14","8","22","1879","1901","1.157285639137296159915833772"
"2022-09-30T00:00:00.000","Santa Barbara","CA","Passenger","1","0","1","57","58","1.724137931034482758620689655"
"2022-09-30T00:00:00.000","Santa Clara","CA","Passenger","5","1","6","142","148","4.054054054054054054054054054"
"2022-09-30T00:00:00.000","Santa Cruz","CA","Passenger","1","0","1","14","15","6.666666666666666666666666667"
"2022-09-30T00:00:00.000","Solano","CA","Passenger","2","0","2","147","149","1.342281879194630872483221477"
"2022-09-30T00:00:00.000","Sonoma","CA","Passenger","0","1","1","56","57","1.754385964912280701754385965"
"2022-09-30T00:00:00.000","Ventura","CA","Passenger","2","1","3","199","202","1.485148514851485148514851485"
"2022-09-30T00:00:00.000","Arapahoe","CO","Passenger","0","1","1","61","62","1.612903225806451612903225806"
"2022-09-30T00:00:00.000","Boulder","CO","Passenger","1","0","1","20","21","4.761904761904761904761904762"
"2022-09-30T00:00:00.000","El Paso","CO","Passenger","3","1","4","456","460","0.8695652173913043478260869565"
"2022-09-30T00:00:00.000","Larimer","CO","Passenger","1","0","1","30","31","3.225806451612903225806451613"
"2022-09-30T00:00:00.000","Las Animas","CO","Passenger","1","0","1","0","1","100"
"2022-09-30T00:00:00.000","New London","CT","Passenger","1","3","4","182","186","2.150537634408602150537634409"
"2022-09-30T00:00:00.000","District of Columbia","DC","Passenger","3","2","5","157","162","3.086419753086419753086419753"
"2022-09-30T00:00:00.000","Kent","DE","Passenger","0","1","1","43","44","2.272727272727272727272727273"
"2022-09-30T00:00:00.000","New Castle","DE","Passenger","1","0","1","14","15","6.666666666666666666666666667"
"2022-09-30T00:00:00.000","Duval","FL","Passenger","0","1","1","201","202","0.4950495049504950495049504950"
"2022-09-30T00:00:00.000","Hillsborough","FL","Passenger","0","1","1","93","94","1.063829787234042553191489362"
"2022-09-30T00:00:00.000","Lake","FL","Passenger","1","0","1","11","12","8.333333333333333333333333333"
"2022-09-30T00:00:00.000","Monroe","FL","Passenger","0","1","1","33","34","2.941176470588235294117647059"
"2022-09-30T00:00:00.000","Okaloosa","FL","Passenger","0","1","1","68","69","1.449275362318840579710144928"
"2022-09-30T00:00:00.000","Palm Beach","FL","Passenger","1","0","1","33","34","2.941176470588235294117647059"
"2022-09-30T00:00:00.000","Sarasota","FL","Passenger","1","0","1","16","17","5.882352941176470588235294118"
"2022-09-30T00:00:00.000","Bartow","GA","Passenger","0","1","1","2","3","33.33333333333333333333333333"
"2022-09-30T00:00:00.000","Bryan","GA","Passenger","1","0","1","34","35","2.857142857142857142857142857"
"2022-09-30T00:00:00.000","Columbia","GA","Passenger","1","1","2","73","75","2.666666666666666666666666667"
"2022-09-30T00:00:00.000","DeKalb","GA","Passenger","1","0","1","30","31","3.225806451612903225806451613"
"2022-09-30T00:00:00.000","Houston","GA","Passenger","1","0","1","28","29","3.448275862068965517241379310"
"2022-09-30T00:00:00.000","Rockdale","GA","Passenger","1","0","1","4","5","20.0"
"2022-09-30T00:00:00.000","Honolulu","HI","Passenger","2","1","3","243","246","1.219512195121951219512195122"
"2022-09-30T00:00:00.000","Kootenai","ID","Truck","1","0","1","27","28","3.571428571428571428571428571"
"2022-09-30T00:00:00.000","Cook","IL","Passenger","1","0","1","124","125","0.800"
"2022-09-30T00:00:00.000","Lake","IL","Passenger","3","0","3","117","120","2.500"
"2022-09-30T00:00:00.000","Rock Island","IL","Passenger","0","1","1","13","14","7.142857142857142857142857143"
"2022-09-30T00:00:00.000","St. Clair","IL","Passenger","2","0","2","103","105","1.904761904761904761904761905"
"2022-09-30T00:00:00.000","Geary","KS","Passenger","1","0","1","70","71","1.408450704225352112676056338"
"2022-09-30T00:00:00.000","Leavenworth","KS","Passenger","1","1","2","85","87","2.298850574712643678160919540"
"2022-09-30T00:00:00.000","Oldham","KY","Passenger","0","1","1","4","5","20.0"
"2022-09-30T00:00:00.000","Plaquemines","LA","Passenger","0","1","1","13","14","7.142857142857142857142857143"
"2022-09-30T00:00:00.000","Middlesex","MA","Passenger","2","1","3","58","61","4.918032786885245901639344262"
"2022-09-30T00:00:00.000","Anne Arundel","MD","Passenger","4","3","7","271","278","2.517985611510791366906474820"
"2022-09-30T00:00:00.000","Anne Arundel","MD","Truck","1","0","1","42","43","2.325581395348837209302325581"
"2022-09-30T00:00:00.000","Calvert","MD","Passenger","0","2","2","68","70","2.857142857142857142857142857"
"2022-09-30T00:00:00.000","Carroll","MD","Passenger","0","1","1","10","11","9.090909090909090909090909091"
"2022-09-30T00:00:00.000","Charles","MD","Passenger","0","1","1","46","47","2.127659574468085106382978723"
"2022-09-30T00:00:00.000","Frederick","MD","Passenger","2","0","2","59","61","3.278688524590163934426229508"
"2022-09-30T00:00:00.000","Howard","MD","Passenger","0","1","1","50","51","1.960784313725490196078431373"
"2022-09-30T00:00:00.000","Montgomery","MD","Passenger","3","5","8","164","172","4.651162790697674418604651163"
"2022-09-30T00:00:00.000","Prince George's","MD","Passenger","2","0","2","96","98","2.040816326530612244897959184"
"2022-09-30T00:00:00.000","St. Mary's","MD","Passenger","1","0","1","141","142","0.7042253521126760563380281690"
"2022-09-30T00:00:00.000","St. Mary's","MD","Truck","1","0","1","40","41","2.439024390243902439024390244"
"2022-09-30T00:00:00.000","Washington","MD","Passenger","1","0","1","11","12","8.333333333333333333333333333"
"2022-09-30T00:00:00.000","Penobscot","ME","Passenger","0","1","1","8","9","11.11111111111111111111111111"
"2022-09-30T00:00:00.000","Platte","MO","Passenger","1","0","1","14","15","6.666666666666666666666666667"
"2022-09-30T00:00:00.000","Ray","MO","Passenger","0","1","1","0","1","100"
"2022-09-30T00:00:00.000","St. Louis","MO","Passenger","1","0","1","52","53","1.886792452830188679245283019"
"2022-09-30T00:00:00.000","Harrison","MS","Passenger","1","0","1","31","32","3.12500"
"2022-09-30T00:00:00.000","Cumberland","NC","Passenger","0","2","2","302","304","0.6578947368421052631578947368"
"2022-09-30T00:00:00.000","Cumberland","NC","Truck","1","0","1","70","71","1.408450704225352112676056338"
"2022-09-30T00:00:00.000","Hoke","NC","Passenger","1","0","1","54","55","1.818181818181818181818181818"
"2022-09-30T00:00:00.000","Mecklenburg","NC","Passenger","1","0","1","42","43","2.325581395348837209302325581"
"2022-09-30T00:00:00.000","Moore","NC","Passenger","0","1","1","104","105","0.9523809523809523809523809524"
"2022-09-30T00:00:00.000","Onslow","NC","Passenger","0","1","1","132","133","0.7518796992481203007518796992"
"2022-09-30T00:00:00.000","Wayne","NC","Passenger","1","0","1","22","23","4.347826086956521739130434783"
"2022-09-30T00:00:00.000","Williams","ND","Passenger","0","1","1","5","6","16.66666666666666666666666667"
"2022-09-30T00:00:00.000","Douglas","NE","Passenger","2","2","4","33","37","10.81081081081081081081081081"
"2022-09-30T00:00:00.000","Sarpy","NE","Passenger","1","0","1","40","41","2.439024390243902439024390244"
"2022-09-30T00:00:00.000","Carroll","NH","Passenger","0","1","1","3","4","25.00"
"2022-09-30T00:00:00.000","Burlington","NJ","Passenger","0","2","2","96","98","2.040816326530612244897959184"
"2022-09-30T00:00:00.000","Camden","NJ","Passenger","0","1","1","7","8","12.500"
"2022-09-30T00:00:00.000","Hudson","NJ","Truck","1","0","1","9","10","10.0"
"2022-09-30T00:00:00.000","Chaves","NM","Passenger","1","0","1","2","3","33.33333333333333333333333333"
"2022-09-30T00:00:00.000","Clark","NV","Passenger","5","4","9","391","400","2.2500"
"2022-09-30T00:00:00.000","Jefferson","NY","Passenger","0","1","1","170","171","0.5847953216374269005847953216"
"2022-09-30T00:00:00.000","Queens","NY","Passenger","1","0","1","24","25","4.00"
"2022-09-30T00:00:00.000","Saratoga","NY","Passenger","1","0","1","33","34","2.941176470588235294117647059"
"2022-09-30T00:00:00.000","Hamilton","OH","Passenger","1","0","1","22","23","4.347826086956521739130434783"
"2022-09-30T00:00:00.000","Jackson","OK","Passenger","0","1","1","22","23","4.347826086956521739130434783"
"2022-09-30T00:00:00.000","Clackamas","OR","Passenger","1","0","1","103","104","0.9615384615384615384615384615"
"2022-09-30T00:00:00.000","Douglas","OR","Passenger","1","0","1","22","23","4.347826086956521739130434783"
"2022-09-30T00:00:00.000","Lincoln","OR","Passenger","0","1","1","21","22","4.545454545454545454545454545"
"2022-09-30T00:00:00.000","Multnomah","OR","Passenger","0","1","1","362","363","0.2754820936639118457300275482"
"2022-09-30T00:00:00.000","Polk","OR","Passenger","0","1","1","15","16","6.2500"
"2022-09-30T00:00:00.000","Allegheny","PA","Passenger","1","1","2","36","38","5.263157894736842105263157895"
"2022-09-30T00:00:00.000","Cumberland","PA","Passenger","1","0","1","33","34","2.941176470588235294117647059"
"2022-09-30T00:00:00.000","Montgomery","PA","Passenger","1","0","1","12","13","7.692307692307692307692307692"
"2022-09-30T00:00:00.000","Philadelphia","PA","Passenger","1","0","1","29","30","3.333333333333333333333333333"
"2022-09-30T00:00:00.000","Newport","RI","Passenger","1","0","1","66","67","1.492537313432835820895522388"
"2022-09-30T00:00:00.000","Newport","RI","Truck","1","0","1","8","9","11.11111111111111111111111111"
"2022-09-30T00:00:00.000","Charleston","SC","Passenger","1","0","1","46","47","2.127659574468085106382978723"
"2022-09-30T00:00:00.000","Spartanburg","SC","Passenger","0","1","1","15","16","6.2500"
"2022-09-30T00:00:00.000","Sumter","SC","Passenger","1","1","2","26","28","7.142857142857142857142857143"
"2022-09-30T00:00:00.000","Pennington","SD","Passenger","1","0","1","21","22","4.545454545454545454545454545"
"2022-09-30T00:00:00.000","Montgomery","TN","Passenger","2","0","2","147","149","1.342281879194630872483221477"
"2022-09-30T00:00:00.000","Tipton","TN","Passenger","1","0","1","10","11","9.090909090909090909090909091"
"2022-09-30T00:00:00.000","Bell","TX","Passenger","0","1","1","242","243","0.4115226337448559670781893004"
"2022-09-30T00:00:00.000","Bexar","TX","Passenger","6","2","8","334","342","2.339181286549707602339181287"
"2022-09-30T00:00:00.000","Coryell","TX","Passenger","1","0","1","69","70","1.428571428571428571428571429"
"2022-09-30T00:00:00.000","Denton","TX","Passenger","1","0","1","40","41","2.439024390243902439024390244"
"2022-09-30T00:00:00.000","El Paso","TX","Passenger","1","0","1","265","266","0.3759398496240601503759398496"
"2022-09-30T00:00:00.000","Galveston","TX","Passenger","0","1","1","13","14","7.142857142857142857142857143"
"2022-09-30T00:00:00.000","Harris","TX","Passenger","1","0","1","102","103","0.9708737864077669902912621359"
"2022-09-30T00:00:00.000","Hidalgo","TX","Passenger","0","1","1","47","48","2.083333333333333333333333333"
"2022-09-30T00:00:00.000","Nueces","TX","Passenger","1","0","1","41","42","2.380952380952380952380952381"
"2022-09-30T00:00:00.000","Tarrant","TX","Passenger","1","0","1","71","72","1.388888888888888888888888889"
"2022-09-30T00:00:00.000","Wichita","TX","Passenger","2","0","2","31","33","6.060606060606060606060606061"
"2022-09-30T00:00:00.000","Salt Lake","UT","Passenger","2","2","4","86","90","4.444444444444444444444444444"
"2022-09-30T00:00:00.000","Alexandria","VA","Passenger","6","1","7","106","113","6.194690265486725663716814159"
"2022-09-30T00:00:00.000","Chesapeake","VA","Passenger","0","3","3","290","293","1.023890784982935153583617747"
"2022-09-30T00:00:00.000","Danville","VA","Passenger","1","0","1","0","1","100"
"2022-09-30T00:00:00.000","Fairfax","VA","Passenger","5","3","8","545","553","1.446654611211573236889692586"
"2022-09-30T00:00:00.000","Loudoun","VA","Passenger","2","0","2","50","52","3.846153846153846153846153846"
"2022-09-30T00:00:00.000","Louisa","VA","Passenger","0","1","1","0","1","100"
"2022-09-30T00:00:00.000","Manassas","VA","Passenger","0","1","1","5","6","16.66666666666666666666666667"
"2022-09-30T00:00:00.000","Norfolk","VA","Passenger","1","1","2","246","248","0.8064516129032258064516129032"
"2022-09-30T00:00:00.000","Portsmouth","VA","Passenger","1","1","2","56","58","3.448275862068965517241379310"
"2022-09-30T00:00:00.000","Prince William","VA","Truck","1","0","1","20","21","4.761904761904761904761904762"
"2022-09-30T00:00:00.000","Stafford","VA","Passenger","2","1","3","76","79","3.797468354430379746835443038"
"2022-09-30T00:00:00.000","Suffolk","VA","Passenger","1","0","1","92","93","1.075268817204301075268817204"
"2022-09-30T00:00:00.000","Virginia Beach","VA","Passenger","2","0","2","405","407","0.4914004914004914004914004914"
"2022-09-30T00:00:00.000","Adams","WA","Truck","3","0","3","5219","5222","0.05744925315970892378399080812"
"2022-09-30T00:00:00.000","Adams","WA","Passenger","22","11","33","12570","12603","0.2618424184717924303737205427"
"2022-09-30T00:00:00.000","Asotin","WA","Passenger","25","20","45","12323","12368","0.3638421733505821474773609314"
"2022-09-30T00:00:00.000","Asotin","WA","Truck","1","0","1","6538","6539","0.01529285823520415965743997553"
"2022-09-30T00:00:00.000","Benton","WA","Truck","38","0","38","42112","42150","0.09015421115065243179122182681"
"2022-09-30T00:00:00.000","Benton","WA","Passenger","832","471","1303","131926","133229","0.9780152969698789302629307433"
"2022-09-30T00:00:00.000","Chelan","WA","Passenger","488","133","621","52677","53298","1.165146909827760891590678825"
"2022-09-30T00:00:00.000","Chelan","WA","Truck","18","0","18","22359","22377","0.08043973723019171470706529025"
"2022-09-30T00:00:00.000","Clallam","WA","Passenger","443","253","696","48441","49137","1.416447890591611209475547958"
"2022-09-30T00:00:00.000","Clallam","WA","Truck","11","0","11","21325","21336","0.05155605549306336707911511061"
"2022-09-30T00:00:00.000","Clark","WA","Truck","91","0","91","80024","80115","0.1135867190913062472695500218"
"2022-09-30T00:00:00.000","Clark","WA","Passenger","4503","1906","6409","307230","313639","2.043432098686706691450999397"
"2022-09-30T00:00:00.000","Columbia","WA","Passenger","8","0","8","2368","2376","0.3367003367003367003367003367"
"2022-09-30T00:00:00.000","Columbia","WA","Truck","2","0","2","1529","1531","0.1306335728282168517308948400"
"2022-09-30T00:00:00.000","Cowlitz","WA","Passenger","378","186","564","68457","69021","0.8171426087712435345764332594"
"2022-09-30T00:00:00.000","Cowlitz","WA","Truck","13","0","13","27641","27654","0.04700947421711144861502856730"
"2022-09-30T00:00:00.000","Douglas","WA","Truck","6","0","6","12433","12439","0.04823538869684058204035694188"
"2022-09-30T00:00:00.000","Douglas","WA","Passenger","146","62","208","27680","27888","0.7458405048766494549627079748"
"2022-09-30T00:00:00.000","Ferry","WA","Truck","1","0","1","3501","3502","0.02855511136493432324386065106"
"2022-09-30T00:00:00.000","Ferry","WA","Passenger","22","4","26","4282","4308","0.6035283194057567316620241411"
"2022-09-30T00:00:00.000","Franklin","WA","Passenger","237","116","353","60053","60406","0.5843790351951792868258120054"
"2022-09-30T00:00:00.000","Franklin","WA","Truck","10","0","10","20264","20274","0.04932425766992206767288152313"
"2022-09-30T00:00:00.000","Garfield","WA","Truck","0","0","0","936","936","0"
"2022-09-30T00:00:00.000","Garfield","WA","Passenger","1","3","4","1302","1306","0.3062787136294027565084226646"
"2022-09-30T00:00:00.000","Grant","WA","Truck","12","0","12","27107","27119","0.04424941922637265385891810170"
"2022-09-30T00:00:00.000","Grant","WA","Passenger","202","111","313","64750","65063","0.4810721915681723867635983585"
"2022-09-30T00:00:00.000","Grays Harbor","WA","Passenger","231","170","401","47639","48040","0.8347210657785179017485428809"
"2022-09-30T00:00:00.000","Grays Harbor","WA","Truck","11","0","11","20586","20597","0.05340583580133029081905131815"
"2022-09-30T00:00:00.000","Island","WA","Passenger","872","394","1266","60594","61860","2.046556741028128031037827352"
"2022-09-30T00:00:00.000","Island","WA","Truck","25","0","25","20833","20858","0.1198580880237798446639179212"
"2022-09-30T00:00:00.000","Jefferson","WA","Truck","9","0","9","9187","9196","0.09786863853849499782514136581"
"2022-09-30T00:00:00.000","Jefferson","WA","Passenger","456","229","685","23950","24635","2.780596711995128881672417292"
"2022-09-30T00:00:00.000","King","WA","Truck","456","2","458","174955","175413","0.2610980942119455228517840753"
"2022-09-30T00:00:00.000","King","WA","Passenger","43048","11827","54875","1317558","1372433","3.998373691101860710140312860"
"2022-09-30T00:00:00.000","Kitsap","WA","Truck","64","0","64","52027","52091","0.1228619147261523103799120769"
"2022-09-30T00:00:00.000","Kitsap","WA","Passenger","2611","1140","3751","174270","178021","2.107054785671353379657456143"
"2022-09-30T00:00:00.000","Kittitas","WA","Passenger","285","91","376","28725","29101","1.292051819525102230163911893"
"2022-09-30T00:00:00.000","Kittitas","WA","Truck","9","0","9","14151","14160","0.06355932203389830508474576271"
"2022-09-30T00:00:00.000","Klickitat","WA","Passenger","108","54","162","14727","14889","1.088051581704614144670562160"
"2022-09-30T00:00:00.000","Klickitat","WA","Truck","4","0","4","8015","8019","0.04988153136301284449432597581"
"2022-09-30T00:00:00.000","Lewis","WA","Truck","10","0","10","25579","25589","0.03907929188323107585290554535"
"2022-09-30T00:00:00.000","Lewis","WA","Passenger","257","176","433","58208","58641","0.7383912279804232533551610648"
"2022-09-30T00:00:00.000","Lincoln","WA","Passenger","12","15","27","7542","7569","0.3567181926278240190249702735"
"2022-09-30T00:00:00.000","Lincoln","WA","Truck","0","0","0","4764","4764","0"
"2022-09-30T00:00:00.000","Mason","WA","Passenger","346","183","529","45739","46268","1.143338808679865133569637763"
"2022-09-30T00:00:00.000","Mason","WA","Truck","20","0","20","20375","20395","0.09806325079676391272370679088"
"2022-09-30T00:00:00.000","Okanogan","WA","Passenger","96","50","146","25507","25653","0.5691342143219116672513935992"
"2022-09-30T00:00:00.000","Okanogan","WA","Truck","4","0","4","15991","15995","0.02500781494216942794623319787"
"2022-09-30T00:00:00.000","Pacific","WA","Passenger","77","75","152","15469","15621","0.9730491005697458549388643493"
"2022-09-30T00:00:00.000","Pacific","WA","Truck","3","0","3","7710","7713","0.03889537145079735511474134578"
"2022-09-30T00:00:00.000","Pend Oreille","WA","Truck","1","0","1","5452","5453","0.01833852924995415367687511462"
"2022-09-30T00:00:00.000","Pend Oreille","WA","Passenger","19","12","31","8786","8817","0.3515935125326074628558466599"
"2022-09-30T00:00:00.000","Pierce","WA","Passenger","5639","2462","8101","528994","537095","1.508299276664277269384373342"
"2022-09-30T00:00:00.000","Pierce","WA","Truck","141","0","141","136652","136793","0.1030754497671664485755850080"
"2022-09-30T00:00:00.000","San Juan","WA","Passenger","522","155","677","13660","14337","4.722047848224872706981934854"
"2022-09-30T00:00:00.000","San Juan","WA","Truck","9","0","9","5794","5803","0.1550921936929174564880234362"
"2022-09-30T00:00:00.000","Skagit","WA","Passenger","877","365","1242","87370","88612","1.401616033945740983162551347"
"2022-09-30T00:00:00.000","Skagit","WA","Truck","31","0","31","31302","31333","0.09893722273641208949031372674"
"2022-09-30T00:00:00.000","Skamania","WA","Truck","0","0","0","3770","3770","0"
"2022-09-30T00:00:00.000","Skamania","WA","Passenger","85","51","136","7848","7984","1.703406813627254509018036072"
"2022-09-30T00:00:00.000","Snohomish","WA","Truck","170","0","170","119497","119667","0.1420608856242740270918465408"
"2022-09-30T00:00:00.000","Snohomish","WA","Passenger","9074","2657","11731","518752","530483","2.211380949059630563090617418"
"2022-09-30T00:00:00.000","Spokane","WA","Truck","77","0","77","99415","99492","0.07739315723877296667068709042"
"2022-09-30T00:00:00.000","Spokane","WA","Passenger","1775","903","2678","316902","319580","0.8379748419800988797797108705"
"2022-09-30T00:00:00.000","Stevens","WA","Truck","4","0","4","18345","18349","0.02179955310916126219412502044"
"2022-09-30T00:00:00.000","Stevens","WA","Passenger","79","57","136","29291","29427","0.4621606008087810514153668400"
"2022-09-30T00:00:00.000","Thurston","WA","Passenger","2435","1130","3565","188621","192186","1.854973827438002768151686387"
"2022-09-30T00:00:00.000","Thurston","WA","Truck","64","0","64","53659","53723","0.1191296092921095247845429332"
"2022-09-30T00:00:00.000","Wahkiakum","WA","Passenger","24","13","37","2991","3028","1.221928665785997357992073976"
"2022-09-30T00:00:00.000","Wahkiakum","WA","Truck","2","0","2","1753","1755","0.1139601139601139601139601140"
"2022-09-30T00:00:00.000","Walla Walla","WA","Passenger","186","106","292","34992","35284","0.8275705702301326380228998980"
"2022-09-30T00:00:00.000","Walla Walla","WA","Truck","8","0","8","13527","13535","0.05910602142593276690062800148"
"2022-09-30T00:00:00.000","Whatcom","WA","Passenger","1963","779","2742","144849","147591","1.857836859971136451409638799"
"2022-09-30T00:00:00.000","Whatcom","WA","Truck","37","0","37","41858","41895","0.08831602816565222580260174245"
"2022-09-30T00:00:00.000","Whitman","WA","Truck","7","0","7","8378","8385","0.08348240906380441264162194395"
"2022-09-30T00:00:00.000","Whitman","WA","Passenger","96","64","160","21408","21568","0.7418397626112759643916913947"
"2022-09-30T00:00:00.000","Yakima","WA","Truck","11","0","11","59153","59164","0.01859238726252450814684605503"
"2022-09-30T00:00:00.000","Yakima","WA","Passenger","378","216","594","161517","162111","0.3664156041231008383144882210"
"2022-09-30T00:00:00.000","Douglas","WI","Passenger","1","0","1","1","2","50.0"
"2022-09-30T00:00:00.000","Ozaukee","WI","Passenger","0","1","1","2","3","33.33333333333333333333333333"
"2022-09-30T00:00:00.000","Sheridan","WY","Passenger","1","0","1","5","6","16.66666666666666666666666667"
